Timestep,Iteration,Total Reward,Suboptimal Arms,Total Regret,Zeros Count,Ones Count
2,1,2.0,0,0.0,0,2
3,1,3.0,0,0.0,0,3
100,1,92.0,23,0.28,8,92
200,1,182.0,28,0.38,18,182
2000,1,1779.0,318,3.99,221,1779
10000,1,8916.0,558,14.54,1084,8916
20000,1,17864.0,884,30.59,2136,17864
40000,1,35782.0,1566,61.94,4218,35782
60000,1,53623.0,2343,93.29,6377,53623
80000,1,71530.0,3056,126.25,8470,71530
100000,1,89354.0,3713,158.08,10646,89354
200000,1,178750.0,7109,324.05,21250,178750
400000,1,357462.0,13751,638.59,42538,357462
600000,1,536306.0,20491,959.22,63694,536306
800000,1,715117.0,27221,1278.04,84883,715117
1000000,1,893985.0,33883,1599.33,106015,893985
2,2,2.0,0,0.0,0,2
3,2,3.0,0,0.0,0,3
100,2,81.0,50,4.75,19,81
200,2,169.0,52,4.75,31,169
2000,2,1777.0,115,7.41,223,1777
10000,2,8940.0,427,20.71,1060,8940
20000,2,17873.0,760,37.33,2127,17873
40000,2,35712.0,1387,65.45,4288,35712
60000,2,53602.0,2082,96.42,6398,53602
80000,2,71482.0,2758,126.73,8518,71482
100000,2,89402.0,3403,153.8,10598,89402
200000,2,178751.0,26221,320.72,21249,178751
400000,2,357411.0,79586,633.18,42589,357411
600000,2,536154.0,88041,951.24,63846,536154
800000,2,714833.0,111162,1272.43,85167,714833
1000000,2,893566.0,120631,1588.31,106434,893566
2,3,2.0,0,0.0,0,2
3,3,3.0,0,0.0,0,3
100,3,90.0,0,0.0,10,90
200,3,179.0,30,0.28,21,179
2000,3,1794.0,107,3.04,206,1794
10000,3,8971.0,354,14.92,1029,8971
20000,3,17908.0,720,31.06,2092,17908
40000,3,35731.0,1426,63.74,4269,35731
60000,3,53526.0,2078,93.57,6474,53526
80000,3,71338.0,2792,127.77,8662,71338
100000,3,89267.0,3475,160.45,10733,89267
200000,3,178498.0,6918,321.77,21502,178498
400000,3,357101.0,14371,633.75,42899,357101
600000,3,535928.0,20857,939.74,64072,535928
800000,3,714499.0,27713,1252.39,85501,714499
1000000,3,893241.0,34580,1561.33,106759,893241
2,4,2.0,0,0.0,0,2
3,4,3.0,0,0.0,0,3
100,4,92.0,22,0.0,8,92
200,4,180.0,76,0.09,20,180
2000,4,1764.0,178,4.08,236,1764
10000,4,8941.0,845,15.11,1059,8941
20000,4,17877.0,2030,30.59,2123,17877
40000,4,35751.0,21710,62.13,4249,35751
60000,4,53655.0,41411,93.76,6345,53655
80000,4,71575.0,61073,127.2,8425,71575
100000,4,89348.0,80746,157.13,10652,89348
200000,4,178875.0,179080,317.3,21125,178875
400000,4,357748.0,375710,634.22,42252,357748
600000,4,536411.0,572478,953.33,63589,536411
800000,4,714908.0,769177,1276.61,85092,714908
1000000,4,893665.0,965889,1597.81,106335,893665
2,5,2.0,0,0.0,0,2
3,5,3.0,0,0.0,0,3
100,5,86.0,2,0.19,14,86
200,5,178.0,60,0.47,22,178
2000,5,1784.0,290,3.61,216,1784
10000,5,8912.0,567,16.82,1088,8912
20000,5,17870.0,891,32.01,2130,17870
40000,5,35700.0,1541,62.98,4300,35700
60000,5,53579.0,2219,94.05,6421,53579
80000,5,71406.0,2882,125.59,8594,71406
100000,5,89371.0,3629,157.79,10629,89371
200000,5,178676.0,7457,308.28,21324,178676
400000,5,357478.0,161014,626.91,42522,357478
600000,5,536195.0,357619,949.34,63805,536195
800000,5,714876.0,554331,1266.73,85124,714876
1000000,5,893550.0,750989,1583.84,106450,893550
2,6,2.0,0,0.0,0,2
3,6,2.0,0,0.0,1,2
100,6,89.0,77,0.28,11,89
200,6,181.0,176,0.47,19,181
2000,6,1770.0,547,3.89,230,1770
10000,6,8929.0,808,16.15,1071,8929
20000,6,17867.0,1133,30.78,2133,17867
40000,6,35737.0,1822,62.51,4263,35737
60000,6,53589.0,2505,93.67,6411,53589
80000,6,71404.0,3124,123.5,8596,71404
100000,6,89251.0,3791,157.6,10749,89251
200000,6,178667.0,7169,317.3,21333,178667
400000,6,357598.0,19371,638.97,42402,357598
600000,6,536275.0,26116,951.71,63725,536275
800000,6,715083.0,33043,1270.53,84917,715083
1000000,6,893924.0,39685,1588.02,106076,893924
2,7,2.0,0,0.0,0,2
3,7,3.0,0,0.0,0,3
100,7,91.0,44,0.0,9,91
200,7,182.0,141,0.38,18,182
2000,7,1774.0,1824,3.32,226,1774
10000,7,8946.0,9650,17.2,1054,8946
20000,7,17886.0,19478,31.63,2114,17886
40000,7,35771.0,39128,61.27,4229,35771
60000,7,53602.0,58784,93.86,6398,53602
80000,7,71474.0,78450,125.87,8526,71474
100000,7,89343.0,98149,155.89,10657,89343
200000,7,178729.0,196489,312.84,21271,178729
400000,7,357372.0,393090,632.13,42628,357372
600000,7,536177.0,589813,947.82,63823,536177
800000,7,714827.0,786561,1263.12,85173,714827
1000000,7,893301.0,983276,1575.39,106699,893301
2,8,1.0,0,0.0,1,1
3,8,2.0,0,0.0,1,2
100,8,89.0,3,0.28,11,89
200,8,178.0,8,0.57,22,178
2000,8,1789.0,241,3.99,211,1789
10000,8,8927.0,8045,16.82,1073,8927
20000,8,17893.0,17870,31.35,2107,17893
40000,8,35796.0,37536,63.65,4204,35796
60000,8,53637.0,45505,93.1,6363,53637
80000,8,71492.0,62415,126.82,8508,71492
100000,8,89401.0,78303,157.32,10599,89401
200000,8,178838.0,176630,314.26,21162,178838
400000,8,357636.0,373321,628.71,42364,357636
600000,8,536385.0,569829,950.86,63615,536385
800000,8,714913.0,766489,1261.79,85087,714913
1000000,8,893704.0,963006,1575.77,106296,893704
2,9,0.0,0,0.0,2,0
3,9,1.0,0,0.0,2,1
100,9,85.0,5,0.28,15,85
200,9,175.0,9,0.57,25,175
2000,9,1786.0,69,3.8,214,1786
10000,9,8950.0,3888,16.53,1050,8950
20000,9,17885.0,4233,33.91,2115,17885
40000,9,35753.0,4893,64.79,4247,35753
60000,9,53651.0,5542,95.76,6349,53651
80000,9,71548.0,6253,128.91,8452,71548
100000,9,89390.0,6908,160.74,10610,89390
200000,9,178644.0,10224,317.68,21356,178644
400000,9,357175.0,18643,629.09,42825,357175
600000,9,535897.0,25290,937.18,64103,535897
800000,9,714584.0,31856,1243.65,85416,714584
1000000,9,893038.0,38515,1556.2,106962,893038
2,10,1.0,0,0.0,1,1
3,10,1.0,0,0.0,2,1
100,10,90.0,3,0.28,10,90
200,10,175.0,65,0.38,25,175
2000,10,1768.0,131,4.18,232,1768
10000,10,8896.0,403,18.15,1104,8896
20000,10,17827.0,754,36.19,2173,17827
40000,10,35682.0,1422,68.4,4318,35682
60000,10,53606.0,2056,98.8,6394,53606
80000,10,71511.0,2702,128.44,8489,71511
100000,10,89373.0,3391,161.97,10627,89373
200000,10,178874.0,6717,319.87,21126,178874
400000,10,357682.0,13438,639.35,42318,357682
600000,10,536420.0,20159,958.08,63580,536420
800000,10,715189.0,26685,1270.34,84811,715189
1000000,10,893862.0,33363,1589.83,106138,893862
2,11,1.0,0,0.0,1,1
3,11,2.0,0,0.0,1,2
100,11,92.0,32,2.18,8,92
200,11,180.0,44,2.47,20,180
2000,11,1797.0,105,5.41,203,1797
10000,11,8954.0,1022,17.01,1046,8954
20000,11,17878.0,1346,31.63,2122,17878
40000,11,35748.0,2013,65.74,4252,35748
60000,11,53565.0,2712,98.51,6435,53565
80000,11,71408.0,3423,131.95,8592,71408
100000,11,89383.0,4081,163.49,10617,89383
200000,11,178738.0,7425,321.77,21262,178738
400000,11,357519.0,14173,640.11,42481,357519
600000,11,536494.0,29079,951.33,63506,536494
800000,11,714912.0,35728,1265.69,85088,714912
1000000,11,893714.0,42203,1572.92,106286,893714
2,12,2.0,0,0.0,0,2
3,12,3.0,0,0.0,0,3
100,12,93.0,0,0.0,7,93
200,12,185.0,0,0.0,15,185
2000,12,1776.0,214,3.04,224,1776
10000,12,8929.0,470,15.11,1071,8929
20000,12,17905.0,808,30.97,2095,17905
40000,12,35701.0,1489,64.12,4299,35701
60000,12,53588.0,2135,95.28,6412,53588
80000,12,71477.0,2807,125.02,8523,71477
100000,12,89283.0,3482,157.79,10717,89283
200000,12,178618.0,6793,316.64,21382,178618
400000,12,357372.0,13461,636.6,42628,357372
600000,12,536231.0,20109,951.81,63769,536231
800000,12,714721.0,28853,1268.25,85279,714721
1000000,12,893589.0,35364,1573.01,106411,893589
2,13,2.0,0,0.0,0,2
3,13,3.0,0,0.0,0,3
100,13,85.0,69,1.04,15,85
200,13,175.0,88,1.04,25,175
2000,13,1790.0,141,3.51,210,1790
10000,13,8957.0,400,15.49,1043,8957
20000,13,17798.0,742,31.54,2202,17798
40000,13,35745.0,1389,62.41,4255,35745
60000,13,53582.0,2062,95.0,6418,53582
80000,13,71478.0,2729,127.96,8522,71478
100000,13,89373.0,3386,160.36,10627,89373
200000,13,178602.0,6664,315.21,21398,178602
400000,13,357338.0,14424,628.81,42662,357338
600000,13,536144.0,21050,944.3,63856,536144
800000,13,714922.0,27770,1258.37,85078,714922
1000000,13,893770.0,34512,1572.63,106230,893770
2,14,2.0,0,0.0,0,2
3,14,2.0,0,0.0,1,2
100,14,83.0,48,0.38,17,83
200,14,171.0,146,0.66,29,171
2000,14,1764.0,1917,3.99,236,1764
10000,14,8906.0,9771,15.3,1094,8906
20000,14,17775.0,19625,31.63,2225,17775
40000,14,35670.0,39286,64.5,4330,35670
60000,14,53425.0,58960,94.24,6575,53425
80000,14,71253.0,78491,123.21,8747,71253
100000,14,89091.0,98007,153.71,10909,89091
200000,14,178454.0,195745,310.84,21546,178454
400000,14,357197.0,218373,626.62,42803,357197
600000,14,535730.0,225172,947.34,64270,535730
800000,14,714705.0,231763,1259.32,85295,714705
1000000,14,893504.0,238439,1577.67,106496,893504
2,15,1.0,0,0.0,1,1
3,15,2.0,0,0.0,1,2
100,15,89.0,7,0.28,11,89
200,15,180.0,11,0.38,20,180
2000,15,1777.0,878,3.13,223,1777
10000,15,8881.0,7330,15.58,1119,8881
20000,15,17800.0,17170,30.59,2200,17800
40000,15,35611.0,36837,60.89,4389,35611
60000,15,53458.0,56503,92.53,6542,53458
80000,15,71293.0,76156,126.25,8707,71293
100000,15,89119.0,95834,159.5,10881,89119
200000,15,178449.0,194125,310.56,21551,178449
400000,15,356909.0,390846,624.25,43091,356909
600000,15,535868.0,575730,943.54,64132,535868
800000,15,714500.0,586456,1259.04,85500,714500
1000000,15,893225.0,593096,1574.34,106775,893225
2,16,2.0,0,0.0,0,2
3,16,3.0,0,0.0,0,3
100,16,83.0,5,0.47,17,83
200,16,169.0,12,0.76,31,169
2000,16,1787.0,67,4.08,213,1787
10000,16,8919.0,3887,16.63,1081,8919
20000,16,17865.0,4223,32.58,2135,17865
40000,16,35716.0,5007,65.93,4284,35716
60000,16,53606.0,5714,99.46,6394,53606
80000,16,71522.0,6330,131.0,8478,71522
100000,16,89369.0,7092,161.12,10631,89369
200000,16,178714.0,12671,318.16,21286,178714
400000,16,357294.0,23999,633.56,42706,357294
600000,16,536087.0,30586,937.94,63913,536087
800000,16,714922.0,46654,1259.04,85078,714922
1000000,16,893418.0,53254,1578.14,106582,893418
2,17,2.0,0,0.0,0,2
3,17,3.0,0,0.0,0,3
100,17,96.0,9,0.76,4,96
200,17,183.0,29,0.95,17,183
2000,17,1798.0,180,3.23,202,1798
10000,17,8956.0,441,15.2,1044,8956
20000,17,17914.0,752,29.16,2086,17914
40000,17,35815.0,1440,63.93,4185,35815
60000,17,53764.0,2102,96.23,6236,53764
80000,17,71716.0,2760,127.49,8284,71716
100000,17,89541.0,3420,160.07,10459,89541
200000,17,178804.0,6833,320.06,21196,178804
400000,17,357700.0,13542,637.07,42300,357700
600000,17,536473.0,20241,959.41,63527,536473
800000,17,715251.0,26805,1270.82,84749,715251
1000000,17,893821.0,33499,1593.06,106179,893821
2,18,2.0,0,0.0,0,2
3,18,3.0,0,0.0,0,3
100,18,89.0,57,0.76,11,89
200,18,175.0,71,1.99,25,175
2000,18,1772.0,174,6.74,228,1772
10000,18,8933.0,430,18.24,1067,8933
20000,18,17846.0,749,33.25,2154,17846
40000,18,35785.0,1398,62.89,4215,35785
60000,18,53651.0,2077,93.38,6349,53651
80000,18,71531.0,2775,125.02,8469,71531
100000,18,89314.0,4218,154.85,10686,89314
200000,18,178541.0,16306,301.34,21459,178541
400000,18,357207.0,38396,620.92,42793,357207
600000,18,535789.0,133667,935.47,64211,535789
800000,18,714620.0,140338,1250.3,85380,714620
1000000,18,893244.0,147150,1578.14,106756,893244
2,19,1.0,0,0.0,1,1
3,19,1.0,0,0.0,2,1
100,19,92.0,83,0.0,8,92
200,19,187.0,182,0.95,13,187
2000,19,1776.0,1951,4.56,224,1776
10000,19,8941.0,9295,20.42,1059,8941
20000,19,17859.0,19047,34.48,2141,17859
40000,19,35702.0,38713,65.93,4298,35702
60000,19,53518.0,58369,98.7,6482,53518
80000,19,71370.0,78022,130.24,8630,71370
100000,19,89226.0,97637,160.64,10774,89226
200000,19,178592.0,195979,312.27,21408,178592
400000,19,357166.0,392584,628.52,42834,357166
600000,19,535768.0,589194,952.76,64232,535768
800000,19,714299.0,785851,1273.0,85701,714299
1000000,19,892875.0,972458,1587.74,107125,892875
2,20,2.0,0,0.0,0,2
3,20,3.0,0,0.0,0,3
100,20,92.0,2,0.19,8,92
200,20,178.0,10,0.47,22,178
2000,20,1790.0,65,3.13,210,1790
10000,20,8911.0,491,15.96,1089,8911
20000,20,17850.0,1355,30.02,2150,17850
40000,20,35681.0,2051,60.61,4319,35681
60000,20,53556.0,2756,94.24,6444,53556
80000,20,71518.0,3429,126.54,8482,71518
100000,20,89358.0,4452,158.74,10642,89358
200000,20,178846.0,8397,316.54,21154,178846
400000,20,357592.0,16790,626.91,42408,357592
600000,20,536325.0,55729,941.55,63675,536325
800000,20,715195.0,62340,1252.48,84805,715195
1000000,20,893810.0,114395,1573.58,106190,893810
2,21,2.0,0,0.0,0,2
3,21,3.0,0,0.0,0,3
100,21,87.0,7,0.47,13,87
200,21,179.0,9,0.47,21,179
2000,21,1810.0,292,3.7,190,1810
10000,21,8964.0,574,16.25,1036,8964
20000,21,17952.0,890,30.78,2048,17952
40000,21,35798.0,1502,60.61,4202,35798
60000,21,53696.0,2152,90.91,6304,53696
80000,21,71565.0,2813,122.07,8435,71565
100000,21,89395.0,3501,153.71,10605,89395
200000,21,178696.0,6801,307.8,21304,178696
400000,21,357242.0,13504,625.67,42758,357242
600000,21,536042.0,20758,937.94,63958,536042
800000,21,715102.0,30809,1246.59,84898,715102
1000000,21,893611.0,114925,1559.71,106389,893611
2,22,1.0,0,0.0,1,1
3,22,2.0,0,0.0,1,2
100,22,79.0,93,8.83,21,79
200,22,156.0,190,18.05,44,156
2000,22,1767.0,1935,24.03,233,1767
10000,22,8902.0,9752,38.38,1098,8902
20000,22,17860.0,19536,53.77,2140,17860
40000,22,35771.0,39202,84.36,4229,35771
60000,22,53592.0,58833,115.99,6408,53592
80000,22,71486.0,78516,146.3,8514,71486
100000,22,89330.0,92919,178.88,10670,89330
200000,22,178700.0,96301,342.76,21300,178700
400000,22,357199.0,114514,655.41,42801,357199
600000,22,535940.0,311165,982.87,64060,535940
800000,22,714680.0,507815,1298.18,85320,714680
1000000,22,893496.0,704571,1615.95,106504,893496
2,23,2.0,0,0.0,0,2
3,23,3.0,0,0.0,0,3
100,23,88.0,11,0.38,12,88
200,23,181.0,14,0.47,19,181
2000,23,1783.0,136,3.42,217,1783
10000,23,8852.0,447,18.62,1148,8852
20000,23,17760.0,800,31.92,2240,17760
40000,23,35629.0,1479,62.03,4371,35629
60000,23,53480.0,3567,95.19,6520,53480
80000,23,71356.0,7026,126.06,8644,71356
100000,23,89272.0,7727,159.79,10728,89272
200000,23,178465.0,59983,320.91,21535,178465
400000,23,356917.0,66640,630.9,43083,356917
600000,23,535672.0,73422,952.28,64328,535672
800000,23,714183.0,80066,1268.25,85817,714183
1000000,23,892981.0,86692,1579.38,107019,892981
2,24,2.0,0,0.0,0,2
3,24,3.0,1,0.09,0,3
100,24,89.0,21,0.28,11,89
200,24,179.0,23,0.38,21,179
2000,24,1777.0,104,3.89,223,1777
10000,24,8908.0,412,17.67,1092,8908
20000,24,17856.0,805,34.2,2144,17856
40000,24,35738.0,1467,64.69,4262,35738
60000,24,53615.0,2078,94.33,6385,53615
80000,24,71530.0,2705,123.4,8470,71530
100000,24,89417.0,3360,154.09,10583,89417
200000,24,178605.0,6699,313.31,21395,178605
400000,24,357249.0,13358,629.09,42751,357249
600000,24,535645.0,20038,954.85,64355,535645
800000,24,714447.0,26709,1269.49,85553,714447
1000000,24,893165.0,33370,1588.97,106835,893165
2,25,1.0,0,0.0,1,1
3,25,2.0,0,0.0,1,2
100,25,85.0,3,0.28,15,85
200,25,175.0,100,0.57,25,175
2000,25,1787.0,1880,3.42,213,1787
10000,25,8959.0,8839,16.34,1041,8959
20000,25,17898.0,18671,34.1,2102,17898
40000,25,35764.0,38343,65.36,4236,35764
60000,25,53665.0,57991,92.24,6335,53665
80000,25,71529.0,77656,122.93,8471,71529
100000,25,89367.0,97194,155.42,10633,89367
200000,25,178918.0,195525,314.74,21082,178918
400000,25,357441.0,392137,623.87,42559,357441
600000,25,535927.0,517457,940.98,64073,535927
800000,25,714647.0,714225,1264.26,85353,714647
1000000,25,893504.0,910953,1581.28,106496,893504
2,26,2.0,0,0.0,0,2
3,26,3.0,0,0.0,0,3
100,26,88.0,67,1.23,12,88
200,26,182.0,166,1.42,18,182
2000,26,1776.0,1930,4.65,224,1776
10000,26,8911.0,9812,17.39,1089,8911
20000,26,17869.0,19664,31.35,2131,17869
40000,26,35686.0,39325,63.17,4314,35686
60000,26,53525.0,58985,96.04,6475,53525
80000,26,71423.0,78645,126.63,8577,71423
100000,26,89379.0,98273,156.37,10621,89379
200000,26,178706.0,196635,319.01,21294,178706
400000,26,357386.0,393293,631.18,42614,357386
600000,26,535970.0,589905,952.76,64030,535970
800000,26,714640.0,786640,1268.06,85360,714640
1000000,26,893507.0,983312,1587.45,106493,893507
2,27,1.0,0,0.0,1,1
3,27,1.0,1,0.09,2,1
100,27,90.0,9,0.19,10,90
200,27,182.0,9,0.19,18,182
2000,27,1793.0,662,4.08,207,1793
10000,27,8924.0,7053,18.15,1076,8924
20000,27,17916.0,16892,33.25,2084,17916
40000,27,35786.0,36572,63.08,4214,35786
60000,27,53675.0,56241,91.48,6325,53675
80000,27,71482.0,75917,125.59,8518,71482
100000,27,89468.0,95592,155.7,10532,89468
200000,27,178812.0,193908,317.3,21188,178812
400000,27,357391.0,390466,636.5,42609,357391
600000,27,536115.0,587032,954.56,63885,536115
800000,27,714691.0,783681,1279.46,85309,714691
1000000,27,893305.0,967736,1592.96,106695,893305
2,28,1.0,0,0.0,1,1
3,28,2.0,0,0.0,1,2
100,28,88.0,11,0.38,12,88
200,28,179.0,15,0.66,21,179
2000,28,1803.0,88,4.18,197,1803
10000,28,8934.0,2542,16.72,1066,8934
20000,28,17903.0,2864,33.53,2097,17903
40000,28,35781.0,3499,64.12,4219,35781
60000,28,53623.0,4175,95.85,6377,53623
80000,28,71529.0,4849,128.15,8471,71529
100000,28,89389.0,5492,158.84,10611,89389
200000,28,178823.0,8810,315.02,21177,178823
400000,28,357404.0,15528,627.48,42596,357404
600000,28,536137.0,22387,956.08,63863,536137
800000,28,714859.0,30798,1285.83,85141,714859
1000000,28,893541.0,53050,1604.55,106459,893541
2,29,2.0,0,0.0,0,2
3,29,3.0,0,0.0,0,3
100,29,89.0,40,1.61,11,89
200,29,181.0,138,1.71,19,181
2000,29,1793.0,1914,4.27,207,1793
10000,29,8925.0,9283,18.62,1075,8925
20000,29,17870.0,19099,34.67,2130,17870
40000,29,35775.0,38733,65.83,4225,35775
60000,29,53659.0,58327,94.43,6341,53659
80000,29,71564.0,77984,124.16,8436,71564
100000,29,89427.0,97645,157.32,10573,89427
200000,29,178748.0,194944,313.31,21252,178748
400000,29,357675.0,391569,626.24,42325,357675
600000,29,536548.0,588221,943.26,63452,536548
800000,29,715406.0,784926,1246.5,84594,715406
1000000,29,893961.0,981594,1560.09,106039,893961
2,30,2.0,0,0.0,0,2
3,30,3.0,0,0.0,0,3
100,30,89.0,93,0.57,11,89
200,30,180.0,193,0.66,20,180
2000,30,1791.0,1968,4.08,209,1791
10000,30,8932.0,9831,15.96,1068,8932
20000,30,17874.0,19661,32.39,2126,17874
40000,30,35756.0,39343,66.5,4244,35756
60000,30,53578.0,58981,96.61,6422,53578
80000,30,71398.0,78643,126.63,8602,71398
100000,30,89242.0,93503,157.41,10758,89242
200000,30,178590.0,176763,312.36,21410,178590
400000,30,357243.0,369783,627.86,42757,357243
600000,30,536024.0,418367,951.43,63976,536024
800000,30,714658.0,424960,1257.14,85342,714658
1000000,30,893396.0,431711,1575.2,106604,893396
2,31,2.0,0,0.0,0,2
3,31,3.0,0,0.0,0,3
100,31,95.0,5,0.0,5,95
200,31,185.0,14,0.57,15,185
2000,31,1789.0,97,2.75,211,1789
10000,31,8907.0,353,15.2,1093,8907
20000,31,17802.0,685,31.25,2198,17802
40000,31,35657.0,1327,60.42,4343,35657
60000,31,53562.0,1991,92.53,6438,53562
80000,31,71506.0,2625,121.22,8494,71506
100000,31,89424.0,3254,152.0,10576,89424
200000,31,178746.0,6656,312.27,21254,178746
400000,31,357323.0,13369,633.27,42677,357323
600000,31,536058.0,19994,948.01,63942,536058
800000,31,714780.0,26691,1268.54,85220,714780
1000000,31,893320.0,33491,1580.23,106680,893320
2,32,2.0,0,0.0,0,2
3,32,3.0,0,0.0,0,3
100,32,92.0,47,0.0,8,92
200,32,179.0,62,0.0,21,179
2000,32,1770.0,134,4.18,230,1770
10000,32,8906.0,382,15.49,1094,8906
20000,32,17850.0,721,32.11,2150,17850
40000,32,35688.0,1378,64.31,4312,35688
60000,32,53528.0,2350,93.95,6472,53528
80000,32,71372.0,3114,124.64,8628,71372
100000,32,89188.0,4323,153.52,10812,89188
200000,32,178530.0,7670,306.57,21470,178530
400000,32,357345.0,14272,615.6,42655,357345
600000,32,536103.0,20748,922.64,63897,536103
800000,32,714885.0,27455,1237.28,85115,714885
1000000,32,893416.0,34018,1550.78,106584,893416
2,33,2.0,0,0.0,0,2
3,33,3.0,0,0.0,0,3
100,33,90.0,94,0.85,10,90
200,33,180.0,194,0.95,20,180
2000,33,1808.0,1972,3.89,192,1808
10000,33,8927.0,9840,16.44,1073,8927
20000,33,17852.0,18666,30.87,2148,17852
40000,33,35751.0,38317,61.37,4249,35751
60000,33,53683.0,57993,93.48,6317,53683
80000,33,71498.0,77589,125.3,8502,71498
100000,33,89414.0,79453,157.03,10586,89414
200000,33,178800.0,82848,317.78,21200,178800
400000,33,357607.0,89516,637.07,42393,357607
600000,33,536392.0,96100,950.76,63608,536392
800000,33,715039.0,103096,1268.73,84961,715039
1000000,33,893821.0,109712,1577.57,106179,893821
2,34,2.0,0,0.0,0,2
3,34,3.0,0,0.0,0,3
100,34,86.0,9,0.47,14,86
200,34,177.0,12,0.76,23,177
2000,34,1771.0,63,3.42,229,1771
10000,34,8983.0,320,14.92,1017,8983
20000,34,17865.0,720,32.58,2135,17865
40000,34,35789.0,1422,68.02,4211,35789
60000,34,53628.0,2093,100.13,6372,53628
80000,34,71519.0,2745,129.67,8481,71519
100000,34,89350.0,3425,162.07,10650,89350
200000,34,178733.0,6752,319.77,21267,178733
400000,34,357749.0,13435,636.31,42251,357749
600000,34,536500.0,20046,951.81,63500,536500
800000,34,715308.0,27056,1269.68,84692,715308
1000000,34,894147.0,34899,1580.52,105853,894147
2,35,1.0,0,0.0,1,1
3,35,2.0,0,0.0,1,2
100,35,92.0,49,0.28,8,92
200,35,183.0,148,0.47,17,183
2000,35,1781.0,1924,3.7,219,1781
10000,35,8985.0,9809,13.87,1015,8985
20000,35,17937.0,19631,29.73,2063,17937
40000,35,35806.0,39308,60.32,4194,35806
60000,35,53653.0,58950,90.44,6347,53653
80000,35,71517.0,78641,123.4,8483,71517
100000,35,89363.0,98283,155.04,10637,89363
200000,35,178623.0,196647,314.55,21377,178623
400000,35,357414.0,393334,638.69,42586,357414
600000,35,535945.0,590010,958.08,64055,535945
800000,35,714690.0,786673,1263.31,85310,714690
1000000,35,893540.0,983358,1576.53,106460,893540
2,36,1.0,0,0.0,1,1
3,36,1.0,0,0.0,2,1
100,36,92.0,22,1.71,8,92
200,36,174.0,28,2.09,26,174
2000,36,1798.0,107,6.27,202,1798
10000,36,8967.0,401,19.0,1033,8967
20000,36,17875.0,723,36.0,2125,17875
40000,36,35899.0,1360,64.69,4101,35899
60000,36,53896.0,2030,97.66,6104,53896
80000,36,71794.0,2704,129.77,8206,71794
100000,36,89666.0,3347,159.5,10334,89666
200000,36,178989.0,11537,324.05,21011,178989
400000,36,357538.0,18215,637.93,42462,357538
600000,36,536458.0,24923,952.28,63542,536458
800000,36,715273.0,31637,1269.39,84727,715273
1000000,36,893898.0,38328,1581.66,106102,893898
2,37,2.0,0,0.0,0,2
3,37,3.0,0,0.0,0,3
100,37,87.0,3,0.0,13,87
200,37,179.0,18,1.42,21,179
2000,37,1792.0,70,3.99,208,1792
10000,37,8923.0,3312,17.2,1077,8923
20000,37,17841.0,3613,30.02,2159,17841
40000,37,35781.0,4276,61.27,4219,35781
60000,37,53607.0,4947,93.48,6393,53607
80000,37,71535.0,5604,122.93,8465,71535
100000,37,89357.0,6317,156.08,10643,89357
200000,37,178579.0,9640,315.21,21421,178579
400000,37,357085.0,20018,646.38,42915,357085
600000,37,535655.0,26617,960.74,64345,535655
800000,37,714202.0,33418,1278.51,85798,714202
1000000,37,892858.0,40056,1593.06,107142,892858
2,38,2.0,0,0.0,0,2
3,38,2.0,0,0.0,1,2
100,38,91.0,0,0.0,9,91
200,38,184.0,18,0.66,16,184
2000,38,1802.0,82,3.8,198,1802
10000,38,8921.0,571,15.68,1079,8921
20000,38,17819.0,914,31.82,2181,17819
40000,38,35683.0,1542,62.7,4317,35683
60000,38,53581.0,2260,92.34,6419,53581
80000,38,71413.0,2996,127.77,8587,71413
100000,38,89214.0,3866,159.5,10786,89214
200000,38,178406.0,7324,319.58,21594,178406
400000,38,357257.0,14931,640.68,42743,357257
600000,38,535935.0,23164,952.95,64065,535935
800000,38,714632.0,64525,1268.06,85368,714632
1000000,38,893073.0,132962,1587.93,106927,893073
2,39,1.0,0,0.0,1,1
3,39,2.0,0,0.0,1,2
100,39,93.0,8,0.28,7,93
200,39,182.0,11,0.38,18,182
2000,39,1813.0,71,3.04,187,1813
10000,39,8920.0,322,15.39,1080,8920
20000,39,17878.0,3724,31.25,2122,17878
40000,39,35745.0,4414,61.94,4255,35745
60000,39,53588.0,11496,96.8,6412,53588
80000,39,71475.0,12106,126.25,8525,71475
100000,39,89377.0,12736,156.08,10623,89377
200000,39,178761.0,62209,313.69,21239,178761
400000,39,357354.0,166128,639.35,42646,357354
600000,39,536003.0,172731,961.12,63997,536003
800000,39,714660.0,179236,1267.02,85340,714660
1000000,39,893303.0,186038,1591.25,106697,893303
2,40,2.0,0,0.0,0,2
3,40,3.0,0,0.0,0,3
100,40,83.0,9,0.66,17,83
200,40,172.0,11,0.85,28,172
2000,40,1792.0,63,3.8,208,1792
10000,40,8955.0,323,15.39,1045,8955
20000,40,17896.0,633,29.16,2104,17896
40000,40,35751.0,1338,63.36,4249,35751
60000,40,53667.0,2024,96.33,6333,53667
80000,40,71562.0,2846,127.68,8438,71562
100000,40,89446.0,3479,159.03,10554,89446
200000,40,178844.0,23560,318.16,21156,178844
400000,40,357263.0,52268,637.93,42737,357263
600000,40,536117.0,63219,958.74,63883,536117
800000,40,714983.0,69888,1272.24,85017,714983
1000000,40,893820.0,76433,1586.12,106180,893820
2,41,2.0,0,0.0,0,2
3,41,3.0,0,0.0,0,3
100,41,86.0,4,0.38,14,86
200,41,173.0,13,0.66,27,173
2000,41,1762.0,61,2.94,238,1762
10000,41,8841.0,348,16.82,1159,8841
20000,41,17800.0,776,33.15,2200,17800
40000,41,35747.0,13790,62.41,4253,35747
60000,41,53607.0,33402,93.57,6393,53607
80000,41,71490.0,53075,125.59,8510,71490
100000,41,89414.0,72736,156.56,10586,89414
200000,41,178590.0,171161,316.26,21410,178590
400000,41,357203.0,367561,635.46,42797,357203
600000,41,535951.0,564130,951.81,64049,535951
800000,41,714676.0,760723,1268.82,85324,714676
1000000,41,893352.0,957299,1583.37,106648,893352
2,42,2.0,0,0.0,0,2
3,42,3.0,0,0.0,0,3
100,42,89.0,55,0.38,11,89
200,42,183.0,153,0.47,17,183
2000,42,1785.0,1820,3.32,215,1785
10000,42,8948.0,3403,17.77,1052,8948
20000,42,17881.0,3825,34.67,2119,17881
40000,42,35731.0,4484,65.93,4269,35731
60000,42,53570.0,5107,94.33,6430,53570
80000,42,71444.0,5821,127.11,8556,71444
100000,42,89303.0,6422,156.94,10697,89303
200000,42,178608.0,10615,318.54,21392,178608
400000,42,357220.0,17241,628.43,42780,357220
600000,42,535908.0,29500,951.14,64092,535908
800000,42,714625.0,36282,1268.16,85375,714625
1000000,42,893198.0,115992,1588.12,106802,893198
2,43,2.0,0,0.0,0,2
3,43,3.0,0,0.0,0,3
100,43,90.0,9,0.76,10,90
200,43,175.0,15,1.14,25,175
2000,43,1795.0,85,2.85,205,1795
10000,43,8963.0,318,14.63,1037,8963
20000,43,17922.0,651,29.26,2078,17922
40000,43,35831.0,1280,60.32,4169,35831
60000,43,53686.0,2007,93.19,6314,53686
80000,43,71489.0,3361,122.93,8511,71489
100000,43,89362.0,8236,152.47,10638,89362
200000,43,178744.0,17633,306.66,21256,178744
400000,43,357348.0,24557,626.43,42652,357348
600000,43,536204.0,31211,936.13,63796,536204
800000,43,715019.0,37775,1248.21,84981,715019
1000000,43,893691.0,44415,1567.6,106309,893691
2,44,2.0,0,0.0,0,2
3,44,3.0,0,0.0,0,3
100,44,89.0,1,0.09,11,89
200,44,179.0,4,0.28,21,179
2000,44,1792.0,56,1.99,208,1792
10000,44,8945.0,630,13.11,1055,8945
20000,44,17850.0,943,28.78,2150,17850
40000,44,35655.0,1619,61.65,4345,35655
60000,44,53475.0,2292,95.19,6525,53475
80000,44,71298.0,2933,127.3,8702,71298
100000,44,89179.0,3553,158.46,10821,89179
200000,44,178357.0,6871,318.92,21643,178357
400000,44,357023.0,13541,633.84,42977,357023
600000,44,535664.0,20200,955.99,64336,535664
800000,44,714359.0,26859,1265.31,85641,714359
1000000,44,893174.0,33557,1580.71,106826,893174
2,45,2.0,0,0.0,0,2
3,45,3.0,0,0.0,0,3
100,45,85.0,77,0.66,15,85
200,45,173.0,176,0.66,27,173
2000,45,1764.0,1944,2.75,236,1764
10000,45,8921.0,9805,17.1,1079,8921
20000,45,17887.0,19658,33.34,2113,17887
40000,45,35765.0,39351,64.79,4235,35765
60000,45,53508.0,59009,95.28,6492,53508
80000,45,71457.0,78711,123.69,8543,71457
100000,45,89328.0,98392,153.23,10672,89328
200000,45,178697.0,196732,305.33,21303,178697
400000,45,357577.0,208557,625.01,42423,357577
600000,45,536268.0,215209,946.11,63732,536268
800000,45,715053.0,222070,1270.82,84947,715053
1000000,45,893718.0,228688,1580.61,106282,893718
2,46,1.0,0,0.0,1,1
3,46,2.0,0,0.0,1,2
100,46,94.0,0,0.0,6,94
200,46,184.0,11,0.28,16,184
2000,46,1809.0,81,3.32,191,1809
10000,46,8920.0,554,15.39,1080,8920
20000,46,17882.0,882,31.16,2118,17882
40000,46,35752.0,2535,66.69,4248,35752
60000,46,53603.0,3169,96.61,6397,53603
80000,46,71434.0,3852,131.0,8566,71434
100000,46,89189.0,4514,161.4,10811,89189
200000,46,178393.0,7772,320.72,21607,178393
400000,46,357257.0,16584,634.13,42743,357257
600000,46,536181.0,23380,948.29,63819,536181
800000,46,714558.0,30021,1260.65,85442,714558
1000000,46,893442.0,36664,1573.77,106558,893442
2,47,2.0,0,0.0,0,2
3,47,3.0,0,0.0,0,3
100,47,87.0,9,0.09,13,87
200,47,175.0,14,0.19,25,175
2000,47,1784.0,149,3.51,216,1784
10000,47,8851.0,453,14.92,1149,8851
20000,47,17771.0,776,30.21,2229,17771
40000,47,35571.0,1422,62.13,4429,35571
60000,47,53439.0,2126,95.0,6561,53439
80000,47,71315.0,2840,129.48,8685,71315
100000,47,89177.0,3533,163.21,10823,89177
200000,47,178550.0,7848,323.19,21450,178550
400000,47,357433.0,25812,642.96,42567,357433
600000,47,536181.0,32276,950.1,63819,536181
800000,47,714844.0,38927,1262.46,85156,714844
1000000,47,893732.0,45540,1580.04,106268,893732
2,48,1.0,0,0.0,1,1
3,48,2.0,0,0.0,1,2
100,48,89.0,10,0.28,11,89
200,48,182.0,14,0.47,18,182
2000,48,1800.0,440,3.8,200,1800
10000,48,8975.0,816,16.82,1025,8975
20000,48,17943.0,1824,33.15,2057,17943
40000,48,35807.0,2651,66.31,4193,35807
60000,48,53621.0,7772,97.47,6379,53621
80000,48,71500.0,27419,123.78,8500,71500
100000,48,89372.0,41929,153.14,10628,89372
200000,48,178566.0,140216,308.94,21434,178566
400000,48,357262.0,335370,625.39,42738,357262
600000,48,535957.0,531990,938.13,64043,535957
800000,48,714621.0,728767,1265.59,85379,714621
1000000,48,893371.0,925523,1582.42,106629,893371
2,49,2.0,0,0.0,0,2
3,49,3.0,0,0.0,0,3
100,49,93.0,5,0.47,7,93
200,49,182.0,9,0.66,18,182
2000,49,1777.0,71,3.42,223,1777
10000,49,8900.0,340,17.01,1100,8900
20000,49,17904.0,7255,32.3,2096,17904
40000,49,35751.0,26921,65.93,4249,35751
60000,49,53660.0,46578,95.85,6340,53660
80000,49,71555.0,66277,128.53,8445,71555
100000,49,89495.0,85949,159.03,10505,89495
200000,49,178846.0,184261,316.07,21154,178846
400000,49,357656.0,380921,635.55,42344,357656
600000,49,536526.0,577649,949.05,63474,536526
800000,49,715264.0,774295,1268.92,84736,715264
1000000,49,893749.0,966366,1583.75,106251,893749
2,50,2.0,0,0.0,0,2
3,50,3.0,0,0.0,0,3
100,50,86.0,3,0.28,14,86
200,50,176.0,6,0.38,24,176
2000,50,1786.0,84,5.03,214,1786
10000,50,8919.0,361,18.81,1081,8919
20000,50,17816.0,653,31.82,2184,17816
40000,50,35677.0,1332,63.65,4323,35677
60000,50,53498.0,2012,95.66,6502,53498
80000,50,71347.0,2688,127.49,8653,71347
100000,50,89209.0,3364,160.83,10791,89209
200000,50,178595.0,6769,321.29,21405,178595
400000,50,357184.0,13456,634.98,42816,357184
600000,50,535748.0,19985,940.5,64252,535748
800000,50,714324.0,26706,1266.07,85676,714324
1000000,50,892871.0,33390,1587.93,107129,892871
2,51,2.0,0,0.0,0,2
3,51,3.0,0,0.0,0,3
100,51,88.0,1,0.09,12,88
200,51,179.0,4,0.38,21,179
2000,51,1800.0,59,2.37,200,1800
10000,51,8950.0,315,15.77,1050,8950
20000,51,17865.0,3535,32.77,2135,17865
40000,51,35718.0,4218,67.35,4282,35718
60000,51,53573.0,4907,101.27,6427,53573
80000,51,71467.0,5680,136.23,8533,71467
100000,51,89376.0,6313,167.2,10624,89376
200000,51,178788.0,9711,329.18,21212,178788
400000,51,357291.0,16342,643.91,42709,357291
600000,51,536147.0,22980,961.12,63853,536147
800000,51,715084.0,29680,1277.09,84916,715084
1000000,51,893666.0,36603,1600.56,106334,893666
2,52,1.0,0,0.0,1,1
3,52,2.0,0,0.0,1,2
100,52,88.0,6,0.38,12,88
200,52,174.0,8,0.38,26,174
2000,52,1786.0,1057,3.23,214,1786
10000,52,8891.0,7305,15.11,1109,8891
20000,52,17841.0,17140,30.4,2159,17841
40000,52,35705.0,36808,58.99,4295,35705
60000,52,53609.0,56493,91.67,6391,53609
80000,52,71542.0,76159,123.5,8458,71542
100000,52,89469.0,95817,155.8,10531,89469
200000,52,178948.0,194127,313.98,21052,178948
400000,52,357549.0,376750,648.09,42451,357549
600000,52,536257.0,573391,963.97,63743,536257
800000,52,714613.0,756351,1281.17,85387,714613
1000000,52,893050.0,948946,1600.18,106950,893050
2,53,2.0,0,0.0,0,2
3,53,3.0,0,0.0,0,3
100,53,89.0,8,0.0,11,89
200,53,179.0,13,0.38,21,179
2000,53,1805.0,1465,3.51,195,1805
10000,53,8963.0,9331,16.44,1037,8963
20000,53,17923.0,19147,32.2,2077,17923
40000,53,35773.0,33809,60.42,4227,35773
60000,53,53634.0,53408,91.2,6366,53634
80000,53,71440.0,73048,119.79,8560,71440
100000,53,89330.0,92716,151.14,10670,89330
200000,53,178672.0,188365,309.42,21328,178672
400000,53,357142.0,385043,640.02,42858,357142
600000,53,535540.0,581708,955.42,64460,535540
800000,53,714425.0,778323,1280.51,85575,714425
1000000,53,893063.0,975080,1600.94,106937,893063
2,54,2.0,0,0.0,0,2
3,54,3.0,0,0.0,0,3
100,54,87.0,20,0.38,13,87
200,54,181.0,25,0.66,19,181
2000,54,1783.0,73,3.23,217,1783
10000,54,8928.0,360,16.25,1072,8928
20000,54,17903.0,682,30.97,2097,17903
40000,54,35828.0,1338,61.46,4172,35828
60000,54,53706.0,1989,92.24,6294,53706
80000,54,71627.0,8447,122.45,8373,71627
100000,54,89459.0,10825,155.04,10541,89459
200000,54,178715.0,24823,315.97,21285,178715
400000,54,357329.0,35570,628.9,42671,357329
600000,54,536108.0,42148,944.3,63892,536108
800000,54,714612.0,48742,1252.29,85388,714612
1000000,54,893287.0,55495,1571.11,106713,893287
2,55,2.0,0,0.0,0,2
3,55,3.0,1,0.09,0,3
100,55,89.0,96,0.66,11,89
200,55,175.0,193,0.76,25,175
2000,55,1799.0,1956,3.7,201,1799
10000,55,8973.0,9838,18.05,1027,8973
20000,55,17907.0,19651,34.29,2093,17907
40000,55,35743.0,39334,64.88,4257,35743
60000,55,53579.0,58998,95.66,6421,53579
80000,55,71572.0,78670,126.63,8428,71572
100000,55,89497.0,98357,156.94,10503,89497
200000,55,178839.0,193308,314.36,21161,178839
400000,55,357318.0,390094,636.98,42682,357318
600000,55,535684.0,586804,951.71,64316,535684
800000,55,714281.0,783470,1265.97,85719,714281
1000000,55,893047.0,980159,1576.53,106953,893047
2,56,2.0,0,0.0,0,2
3,56,3.0,0,0.0,0,3
100,56,86.0,31,0.09,14,86
200,56,179.0,33,0.19,21,179
2000,56,1790.0,307,3.32,210,1790
10000,56,8922.0,601,15.49,1078,8922
20000,56,17842.0,922,29.45,2158,17842
40000,56,35690.0,1637,63.27,4310,35690
60000,56,53612.0,2317,95.57,6388,53612
80000,56,71431.0,2998,126.54,8569,71431
100000,56,89347.0,3640,156.56,10653,89347
200000,56,178522.0,10838,310.94,21478,178522
400000,56,357216.0,18287,627.29,42784,357216
600000,56,535859.0,25009,951.43,64141,535859
800000,56,714645.0,31665,1266.92,85355,714645
1000000,56,893308.0,38300,1579.28,106692,893308
2,57,1.0,0,0.0,1,1
3,57,2.0,0,0.0,1,2
100,57,83.0,68,0.09,17,83
200,57,175.0,166,0.28,25,175
2000,57,1792.0,1940,3.42,208,1792
10000,57,8963.0,9793,14.16,1037,8963
20000,57,17887.0,19639,31.92,2113,17887
40000,57,35723.0,39331,62.13,4277,35723
60000,57,53562.0,58989,97.28,6438,53562
80000,57,71460.0,78656,130.62,8540,71460
100000,57,89340.0,98319,161.5,10660,89340
200000,57,178621.0,196664,319.77,21379,178621
400000,57,357267.0,393253,633.75,42733,357267
600000,57,535947.0,589870,949.72,64053,535947
800000,57,714607.0,786467,1264.45,85393,714607
1000000,57,893332.0,983027,1581.85,106668,893332
2,58,1.0,1,0.09,1,1
3,58,2.0,2,0.19,1,2
100,58,90.0,97,1.23,10,90
200,58,178.0,194,1.42,22,178
2000,58,1771.0,1922,4.27,229,1771
10000,58,8962.0,9763,18.05,1038,8962
20000,58,17933.0,16066,33.06,2067,17933
40000,58,35833.0,34232,63.46,4167,35833
60000,58,53656.0,53920,92.81,6344,53656
80000,58,71494.0,73618,124.92,8506,71494
100000,58,89406.0,93288,159.22,10594,89406
200000,58,178720.0,191593,317.02,21280,178720
400000,58,357492.0,315775,629.28,42508,357492
600000,58,536313.0,322503,948.96,63687,536313
800000,58,714883.0,329123,1263.98,85117,714883
1000000,58,893575.0,335682,1576.15,106425,893575
2,59,2.0,0,0.0,0,2
3,59,3.0,0,0.0,0,3
100,59,89.0,9,0.85,11,89
200,59,175.0,17,1.33,25,175
2000,59,1786.0,107,6.17,214,1786
10000,59,8932.0,373,19.85,1068,8932
20000,59,17804.0,878,34.67,2196,17804
40000,59,35692.0,1516,63.93,4308,35692
60000,59,53589.0,2165,95.57,6411,53589
80000,59,71417.0,3033,127.11,8583,71417
100000,59,89337.0,3657,157.79,10663,89337
200000,59,178687.0,10664,313.88,21313,178687
400000,59,357556.0,20254,630.9,42444,357556
600000,59,536113.0,26980,956.18,63887,536113
800000,59,714824.0,46981,1263.88,85176,714824
1000000,59,893596.0,53507,1573.01,106404,893596
2,60,2.0,0,0.0,0,2
3,60,2.0,0,0.0,1,2
100,60,92.0,56,0.47,8,92
200,60,182.0,155,0.66,18,182
2000,60,1810.0,1919,3.8,190,1810
10000,60,8943.0,9791,16.72,1057,8943
20000,60,17882.0,19609,33.34,2118,17882
40000,60,35805.0,39315,68.49,4195,35805
60000,60,53663.0,58924,97.94,6337,53663
80000,60,71437.0,78606,130.62,8563,71437
100000,60,89332.0,98282,162.45,10668,89332
200000,60,178668.0,193617,318.06,21332,178668
400000,60,357355.0,386359,636.5,42645,357355
600000,60,536054.0,583040,941.64,63946,536054
800000,60,714894.0,779717,1255.81,85106,714894
1000000,60,893263.0,976347,1572.44,106737,893263
2,61,2.0,0,0.0,0,2
3,61,3.0,0,0.0,0,3
100,61,87.0,6,0.0,13,87
200,61,171.0,16,0.95,29,171
2000,61,1797.0,84,3.89,203,1797
10000,61,8939.0,483,17.77,1061,8939
20000,61,17870.0,800,34.1,2130,17870
40000,61,35698.0,1459,65.55,4302,35698
60000,61,53602.0,2182,101.65,6398,53602
80000,61,71503.0,2832,133.85,8497,71503
100000,61,89375.0,3540,167.86,10625,89375
200000,61,178790.0,6863,330.32,21210,178790
400000,61,357712.0,13595,652.94,42288,357712
600000,61,536318.0,20297,972.61,63682,536318
800000,61,715063.0,31427,1285.54,84937,715063
1000000,61,893715.0,39103,1593.63,106285,893715
2,62,2.0,0,0.0,0,2
3,62,3.0,0,0.0,0,3
100,62,93.0,25,1.71,7,93
200,62,177.0,27,1.9,23,177
2000,62,1792.0,89,4.94,208,1792
10000,62,8895.0,366,17.86,1105,8895
20000,62,17797.0,716,34.01,2203,17797
40000,62,35697.0,1393,64.12,4303,35697
60000,62,53568.0,2100,98.13,6432,53568
80000,62,71493.0,3036,130.72,8507,71493
100000,62,89380.0,4672,162.16,10620,89380
200000,62,178790.0,8043,323.48,21210,178790
400000,62,357500.0,14731,632.89,42500,357500
600000,62,536306.0,21478,954.66,63694,536306
800000,62,714936.0,28175,1269.01,85064,714936
1000000,62,893711.0,35169,1599.23,106289,893711
2,63,2.0,0,0.0,0,2
3,63,3.0,0,0.0,0,3
100,63,88.0,68,0.19,12,88
200,63,172.0,113,0.47,28,172
2000,63,1782.0,183,3.51,218,1782
10000,63,8941.0,425,14.44,1059,8941
20000,63,17877.0,757,28.69,2123,17877
40000,63,35808.0,1439,60.7,4192,35808
60000,63,53633.0,2095,91.39,6367,53633
80000,63,71500.0,2713,119.13,8500,71500
100000,63,89306.0,3377,150.67,10694,89306
200000,63,178740.0,6708,305.9,21260,178740
400000,63,357623.0,13370,617.79,42377,357623
600000,63,536249.0,20123,937.46,63751,536249
800000,63,714780.0,26805,1255.14,85220,714780
1000000,63,893525.0,33438,1569.59,106475,893525
2,64,2.0,0,0.0,0,2
3,64,3.0,0,0.0,0,3
100,64,85.0,5,0.47,15,85
200,64,173.0,10,0.57,27,173
2000,64,1781.0,101,4.27,219,1781
10000,64,8903.0,387,18.05,1097,8903
20000,64,17771.0,734,34.29,2229,17771
40000,64,35652.0,2020,63.65,4348,35652
60000,64,53545.0,2725,96.99,6455,53545
80000,64,71345.0,3372,127.3,8655,71345
100000,64,89196.0,4047,157.89,10804,89196
200000,64,178641.0,7338,313.88,21359,178641
400000,64,357466.0,14172,633.08,42534,357466
600000,64,536035.0,20804,953.23,63965,536035
800000,64,714681.0,27496,1267.4,85319,714681
1000000,64,893135.0,36641,1590.97,106865,893135
2,65,2.0,0,0.0,0,2
3,65,3.0,0,0.0,0,3
100,65,88.0,75,5.6,12,88
200,65,181.0,119,8.07,19,181
2000,65,1799.0,433,11.69,201,1799
10000,65,8969.0,694,23.27,1031,8969
20000,65,17844.0,1028,39.04,2156,17844
40000,65,35738.0,1733,72.77,4262,35738
60000,65,53565.0,2429,104.69,6435,53565
80000,65,71445.0,3137,138.7,8555,71445
100000,65,89271.0,4375,168.91,10729,89271
200000,65,178738.0,7620,326.8,21262,178738
400000,65,357285.0,14213,643.25,42715,357285
600000,65,536088.0,20957,963.59,63912,536088
800000,65,714816.0,34952,1276.8,85184,714816
1000000,65,893450.0,43731,1595.91,106550,893450
2,66,1.0,0,0.0,1,1
3,66,1.0,0,0.0,2,1
100,66,85.0,5,0.0,15,85
200,66,173.0,47,0.85,27,173
2000,66,1794.0,1814,4.84,206,1794
10000,66,8973.0,9696,17.67,1027,8973
20000,66,17987.0,19538,33.91,2013,17987
40000,66,35789.0,39194,66.31,4211,35789
60000,66,53692.0,58856,98.42,6308,53692
80000,66,71507.0,78567,132.52,8493,71507
100000,66,89398.0,98246,165.49,10602,89398
200000,66,178712.0,195717,320.91,21288,178712
400000,66,357574.0,388076,635.74,42426,357574
600000,66,536034.0,584524,952.47,63966,536034
800000,66,715066.0,780933,1259.8,84934,715066
1000000,66,893972.0,977558,1584.22,106028,893972
2,67,2.0,0,0.0,0,2
3,67,3.0,0,0.0,0,3
100,67,84.0,56,5.13,16,84
200,67,172.0,73,6.55,28,172
2000,67,1792.0,149,9.31,208,1792
10000,67,8952.0,726,20.9,1048,8952
20000,67,17891.0,2719,36.19,2109,17891
40000,67,35749.0,5103,66.88,4251,35749
60000,67,53634.0,5864,98.13,6366,53634
80000,67,71577.0,6528,131.38,8423,71577
100000,67,89504.0,7212,165.11,10496,89504
200000,67,178866.0,10659,327.18,21134,178866
400000,67,357417.0,17370,644.1,42583,357417
600000,67,536265.0,23977,957.13,63735,536265
800000,67,714902.0,30641,1279.65,85098,714902
1000000,67,893532.0,37247,1599.23,106468,893532
2,68,2.0,0,0.0,0,2
3,68,3.0,0,0.0,0,3
100,68,85.0,5,0.28,15,85
200,68,174.0,6,0.38,26,174
2000,68,1793.0,68,3.61,207,1793
10000,68,8919.0,682,17.1,1081,8919
20000,68,17794.0,1000,34.39,2206,17794
40000,68,35666.0,1643,63.93,4334,35666
60000,68,53478.0,2305,95.38,6522,53478
80000,68,71340.0,18631,124.73,8660,71340
100000,68,89156.0,33100,152.09,10844,89156
200000,68,178641.0,124659,311.89,21359,178641
400000,68,357292.0,321295,628.9,42708,357292
600000,68,536065.0,517983,950.95,63935,536065
800000,68,714611.0,714662,1274.9,85389,714611
1000000,68,893310.0,911305,1585.93,106690,893310
2,69,2.0,0,0.0,0,2
3,69,3.0,0,0.0,0,3
100,69,89.0,5,0.09,11,89
200,69,184.0,8,0.28,16,184
2000,69,1783.0,69,2.56,217,1783
10000,69,8920.0,373,19.47,1080,8920
20000,69,17854.0,819,35.05,2146,17854
40000,69,35668.0,1508,69.63,4332,35668
60000,69,53532.0,2425,103.55,6468,53532
80000,69,71330.0,3110,135.94,8670,71330
100000,69,89151.0,3753,167.1,10849,89151
200000,69,178465.0,7370,325.19,21535,178465
400000,69,357315.0,14179,650.47,42685,357315
600000,69,536100.0,20797,967.77,63900,536100
800000,69,714870.0,27472,1280.22,85130,714870
1000000,69,893375.0,34181,1599.99,106625,893375
2,70,2.0,0,0.0,0,2
3,70,3.0,0,0.0,0,3
100,70,87.0,6,0.47,13,87
200,70,180.0,10,0.57,20,180
2000,70,1784.0,78,2.94,216,1784
10000,70,8937.0,1310,14.82,1063,8937
20000,70,17884.0,7514,30.11,2116,17884
40000,70,35766.0,8189,62.22,4234,35766
60000,70,53661.0,8903,95.0,6339,53661
80000,70,71562.0,9572,127.68,8438,71562
100000,70,89497.0,10265,160.07,10503,89497
200000,70,178991.0,13575,320.44,21009,178991
400000,70,357657.0,21504,644.96,42343,357657
600000,70,536178.0,28213,971.66,63822,536178
800000,70,714756.0,34775,1286.97,85244,714756
1000000,70,893621.0,41448,1604.46,106379,893621
2,71,2.0,0,0.0,0,2
3,71,3.0,0,0.0,0,3
100,71,94.0,2,0.0,6,94
200,71,182.0,10,0.57,18,182
2000,71,1786.0,1042,3.13,214,1786
10000,71,8981.0,3654,15.87,1019,8981
20000,71,17913.0,3984,32.01,2087,17913
40000,71,35795.0,4662,63.46,4205,35795
60000,71,53743.0,5452,94.05,6257,53743
80000,71,71615.0,6137,127.01,8385,71615
100000,71,89463.0,6872,157.89,10537,89463
200000,71,178859.0,10914,324.14,21141,178859
400000,71,357894.0,17578,643.06,42106,357894
600000,71,536542.0,24793,967.39,63458,536542
800000,71,715160.0,31558,1285.45,84840,715160
1000000,71,893889.0,39634,1611.68,106111,893889
2,72,2.0,0,0.0,0,2
3,72,3.0,0,0.0,0,3
100,72,91.0,14,0.85,9,91
200,72,180.0,21,1.14,20,180
2000,72,1789.0,75,3.8,211,1789
10000,72,8929.0,315,15.77,1071,8929
20000,72,17919.0,639,32.11,2081,17919
40000,72,35789.0,1447,62.32,4211,35789
60000,72,53667.0,2349,93.76,6333,53667
80000,72,71583.0,3002,121.6,8417,71583
100000,72,89428.0,3661,152.66,10572,89428
200000,72,178660.0,7250,313.98,21340,178660
400000,72,357454.0,82520,621.49,42546,357454
600000,72,535858.0,92757,942.12,64142,535858
800000,72,714566.0,143684,1247.45,85434,714566
1000000,72,892972.0,331093,1564.56,107028,892972
2,73,2.0,0,0.0,0,2
3,73,3.0,0,0.0,0,3
100,73,85.0,17,1.61,15,85
200,73,181.0,22,1.71,19,181
2000,73,1805.0,80,4.37,195,1805
10000,73,8957.0,404,16.82,1043,8957
20000,73,17855.0,1127,31.16,2145,17855
40000,73,35543.0,1779,63.08,4457,35543
60000,73,53404.0,2462,94.14,6596,53404
80000,73,71309.0,3158,128.25,8691,71309
100000,73,89139.0,3807,160.26,10861,89139
200000,73,178593.0,7160,320.72,21407,178593
400000,73,356921.0,13755,634.51,43079,356921
600000,73,535767.0,20570,966.53,64233,535767
800000,73,714418.0,27270,1285.64,85582,714418
1000000,73,893273.0,33815,1598.38,106727,893273
2,74,2.0,0,0.0,0,2
3,74,3.0,0,0.0,0,3
100,74,88.0,23,0.09,12,88
200,74,172.0,79,0.28,28,172
2000,74,1754.0,134,2.75,246,1754
10000,74,8870.0,388,13.3,1130,8870
20000,74,17815.0,722,28.97,2185,17815
40000,74,35670.0,1372,60.04,4330,35670
60000,74,53516.0,2043,92.15,6484,53516
80000,74,71452.0,2736,125.49,8548,71452
100000,74,89381.0,3381,157.13,10619,89381
200000,74,178739.0,7735,316.83,21261,178739
400000,74,357454.0,24471,639.92,42546,357454
600000,74,536136.0,31142,954.56,63864,536136
800000,74,715027.0,38006,1276.14,84973,715027
1000000,74,893705.0,134457,1600.56,106295,893705
2,75,2.0,0,0.0,0,2
3,75,3.0,0,0.0,0,3
100,75,91.0,93,0.66,9,91
200,75,184.0,190,0.76,16,184
2000,75,1806.0,1785,3.42,194,1806
10000,75,8958.0,9598,15.01,1042,8958
20000,75,17911.0,19435,29.45,2089,17911
40000,75,35776.0,38883,59.37,4224,35776
60000,75,53672.0,58539,91.58,6328,53672
80000,75,71571.0,78184,122.17,8429,71571
100000,75,89462.0,97795,152.09,10538,89462
200000,75,178689.0,195975,311.79,21311,178689
400000,75,357418.0,392515,630.42,42582,357418
600000,75,535935.0,588885,954.09,64065,535935
800000,75,714667.0,771517,1273.48,85333,714667
1000000,75,893465.0,968280,1590.4,106535,893465
2,76,2.0,0,0.0,0,2
3,76,3.0,0,0.0,0,3
100,76,91.0,9,0.28,9,91
200,76,173.0,14,0.66,27,173
2000,76,1783.0,81,4.18,217,1783
10000,76,8899.0,355,16.63,1101,8899
20000,76,17881.0,726,36.48,2119,17881
40000,76,35757.0,1391,67.92,4243,35757
60000,76,53525.0,2078,100.13,6475,53525
80000,76,71444.0,2722,131.29,8556,71444
100000,76,89258.0,3398,163.4,10742,89258
200000,76,178566.0,6651,313.98,21434,178566
400000,76,357489.0,13406,634.79,42511,357489
600000,76,536160.0,64298,956.65,63840,536160
800000,76,714801.0,108006,1280.13,85199,714801
1000000,76,893462.0,140116,1607.31,106538,893462
2,77,2.0,0,0.0,0,2
3,77,3.0,0,0.0,0,3
100,77,90.0,12,0.66,10,90
200,77,179.0,16,0.76,21,179
2000,77,1780.0,1740,2.75,220,1780
10000,77,8961.0,9614,12.73,1039,8961
20000,77,17876.0,19459,29.07,2124,17876
40000,77,35807.0,38780,63.65,4193,35807
60000,77,53725.0,58437,96.14,6275,53725
80000,77,71665.0,78107,126.73,8335,71665
100000,77,89486.0,97760,158.65,10514,89486
200000,77,178962.0,196137,322.81,21038,178962
400000,77,357740.0,392889,638.31,42260,357740
600000,77,536428.0,476840,948.48,63572,536428
800000,77,715145.0,625880,1262.65,84855,715145
1000000,77,893911.0,822463,1577.57,106089,893911
2,78,1.0,1,0.0,1,1
3,78,2.0,1,0.0,1,2
100,78,90.0,2,0.0,10,90
200,78,178.0,6,0.28,22,178
2000,78,1765.0,73,3.8,235,1765
10000,78,8938.0,1088,16.34,1062,8938
20000,78,17804.0,7944,32.49,2196,17804
40000,78,35627.0,8667,66.88,4373,35627
60000,78,53518.0,9315,97.56,6482,53518
80000,78,71420.0,9968,129.1,8580,71420
100000,78,89242.0,10648,161.59,10758,89242
200000,78,178590.0,13953,320.06,21410,178590
400000,78,357238.0,20725,646.48,42762,357238
600000,78,535843.0,27370,964.92,64157,535843
800000,78,714544.0,34087,1284.78,85456,714544
1000000,78,893182.0,40594,1590.87,106818,893182
2,79,2.0,0,0.0,0,2
3,79,3.0,0,0.0,0,3
100,79,90.0,13,1.23,10,90
200,79,177.0,14,1.33,23,177
2000,79,1775.0,162,4.37,225,1775
10000,79,8947.0,491,17.2,1053,8947
20000,79,17831.0,960,31.16,2169,17831
40000,79,35728.0,1627,58.99,4272,35728
60000,79,53588.0,2274,88.44,6412,53588
80000,79,71398.0,2971,121.98,8602,71398
100000,79,89262.0,3652,154.47,10738,89262
200000,79,178374.0,6991,307.04,21626,178374
400000,79,357081.0,15749,623.77,42919,357081
600000,79,535840.0,27286,932.05,64160,535840
800000,79,714658.0,34027,1249.06,85342,714658
1000000,79,893455.0,40664,1570.92,106545,893455
2,80,2.0,0,0.0,0,2
3,80,3.0,0,0.0,0,3
100,80,89.0,16,1.52,11,89
200,80,177.0,17,1.61,23,177
2000,80,1779.0,84,4.75,221,1779
10000,80,8916.0,358,16.91,1084,8916
20000,80,17823.0,715,32.68,2177,17823
40000,80,35653.0,1392,65.17,4347,35653
60000,80,53477.0,2030,95.28,6523,53477
80000,80,71404.0,2689,125.02,8596,71404
100000,80,89266.0,3364,157.89,10734,89266
200000,80,178587.0,6745,316.73,21413,178587
400000,80,357187.0,13377,630.8,42813,357187
600000,80,535993.0,20025,943.35,64007,535993
800000,80,714680.0,26806,1266.26,85320,714680
1000000,80,893265.0,33385,1574.91,106735,893265
2,81,1.0,0,0.0,1,1
3,81,1.0,0,0.0,2,1
100,81,90.0,6,0.57,10,90
200,81,177.0,15,0.76,23,177
2000,81,1769.0,120,4.08,231,1769
10000,81,8954.0,3831,16.44,1046,8954
20000,81,17868.0,13665,31.44,2132,17868
40000,81,35784.0,33362,63.27,4216,35784
60000,81,53624.0,52984,94.52,6376,53624
80000,81,71499.0,72413,128.25,8501,71499
100000,81,89442.0,92108,159.88,10558,89442
200000,81,178954.0,190405,316.92,21046,178954
400000,81,357510.0,382856,638.59,42490,357510
600000,81,536114.0,567953,955.99,63886,536114
800000,81,714756.0,756894,1269.49,85244,714756
1000000,81,893277.0,950211,1594.39,106723,893277
2,82,2.0,0,0.0,0,2
3,82,3.0,0,0.0,0,3
100,82,90.0,3,0.0,10,90
200,82,181.0,13,0.57,19,181
2000,82,1792.0,1632,2.85,208,1792
10000,82,8972.0,9494,14.92,1028,8972
20000,82,17850.0,19350,31.54,2150,17850
40000,82,35696.0,38995,61.27,4304,35696
60000,82,53555.0,58682,93.67,6445,53555
80000,82,71418.0,78375,127.96,8582,71418
100000,82,89294.0,98013,160.07,10706,89294
200000,82,178491.0,196347,317.97,21509,178491
400000,82,357086.0,392989,640.49,42914,357086
600000,82,535780.0,589667,964.16,64220,535780
800000,82,714457.0,786274,1288.39,85543,714457
1000000,82,893069.0,982946,1602.56,106931,893069
2,83,2.0,0,0.0,0,2
3,83,3.0,0,0.0,0,3
100,83,95.0,2,0.0,5,95
200,83,194.0,3,0.0,6,194
2000,83,1799.0,65,2.37,201,1799
10000,83,8902.0,1553,14.16,1098,8902
20000,83,17806.0,1895,30.68,2194,17806
40000,83,35674.0,2613,63.46,4326,35674
60000,83,53521.0,3284,94.62,6479,53521
80000,83,71408.0,3942,124.64,8592,71408
100000,83,89299.0,4626,157.7,10701,89299
200000,83,178702.0,31413,307.8,21298,178702
400000,83,357367.0,228043,633.08,42633,357367
600000,83,536235.0,424725,950.76,63765,536235
800000,83,714843.0,621523,1269.39,85157,714843
1000000,83,893393.0,818130,1570.54,106607,893393
2,84,0.0,0,0.0,2,0
3,84,1.0,0,0.0,2,1
100,84,86.0,9,0.85,14,86
200,84,172.0,17,1.14,28,172
2000,84,1779.0,137,4.27,221,1779
10000,84,8866.0,479,16.53,1134,8866
20000,84,17784.0,789,31.44,2216,17784
40000,84,35630.0,2780,62.98,4370,35630
60000,84,53518.0,3459,94.71,6482,53518
80000,84,71284.0,4115,125.02,8716,71284
100000,84,89263.0,4784,156.84,10737,89263
200000,84,178663.0,8017,308.94,21337,178663
400000,84,357287.0,14563,620.73,42713,357287
600000,84,536035.0,60327,933.85,63965,536035
800000,84,714703.0,118121,1250.68,85297,714703
1000000,84,893652.0,124797,1568.26,106348,893652
2,85,2.0,0,0.0,0,2
3,85,3.0,0,0.0,0,3
100,85,86.0,4,0.38,14,86
200,85,176.0,11,0.57,24,176
2000,85,1780.0,72,2.75,220,1780
10000,85,8904.0,594,16.82,1096,8904
20000,85,17793.0,1061,34.29,2207,17793
40000,85,35656.0,1705,64.41,4344,35656
60000,85,53483.0,3086,96.8,6517,53483
80000,85,71335.0,19588,129.48,8665,71335
100000,85,89193.0,39244,160.26,10807,89193
200000,85,178601.0,137574,316.26,21399,178601
400000,85,357603.0,334178,633.56,42397,357603
600000,85,536081.0,530817,955.23,63919,536081
800000,85,714969.0,727501,1265.02,85031,714969
1000000,85,893795.0,924112,1574.06,106205,893795
2,86,0.0,0,0.0,2,0
3,86,1.0,0,0.0,2,1
100,86,90.0,15,0.19,10,90
200,86,174.0,73,0.19,26,174
2000,86,1778.0,163,3.51,222,1778
10000,86,8960.0,500,15.68,1040,8960
20000,86,17919.0,854,32.3,2081,17919
40000,86,35828.0,1621,63.84,4172,35828
60000,86,53710.0,2276,94.62,6290,53710
80000,86,71559.0,2989,130.91,8441,71559
100000,86,89478.0,3652,163.02,10522,89478
200000,86,178842.0,7092,322.43,21158,178842
400000,86,357644.0,82191,630.04,42356,357644
600000,86,536498.0,88856,940.69,63502,536498
800000,86,715000.0,96798,1260.65,85000,715000
1000000,86,893879.0,103383,1567.6,106121,893879
2,87,1.0,0,0.0,1,1
3,87,2.0,0,0.0,1,2
100,87,86.0,0,0.0,14,86
200,87,172.0,47,3.51,28,172
2000,87,1790.0,1821,6.46,210,1790
10000,87,8906.0,9692,19.19,1094,8906
20000,87,17866.0,19538,34.48,2134,17866
40000,87,35726.0,39201,66.88,4274,35726
60000,87,53607.0,58825,95.28,6393,53607
80000,87,71414.0,78482,128.82,8586,71414
100000,87,89280.0,98183,160.64,10720,89280
200000,87,178616.0,195524,316.26,21384,178616
400000,87,357303.0,392167,639.83,42697,357303
600000,87,535898.0,588837,958.46,64102,535898
800000,87,714529.0,785508,1276.14,85471,714529
1000000,87,893166.0,982183,1596.29,106834,893166
2,88,2.0,0,0.0,0,2
3,88,3.0,0,0.0,0,3
100,88,95.0,1,0.09,5,95
200,88,187.0,8,0.28,13,187
2000,88,1816.0,89,3.04,184,1816
10000,88,8972.0,377,16.72,1028,8972
20000,88,17890.0,740,32.77,2110,17890
40000,88,35707.0,1377,63.84,4293,35707
60000,88,53626.0,2008,90.82,6374,53626
80000,88,71552.0,2738,123.88,8448,71552
100000,88,89455.0,3420,155.61,10545,89455
200000,88,178833.0,6770,315.97,21167,178833
400000,88,357428.0,13465,630.52,42572,357428
600000,88,536336.0,20143,948.01,63664,536336
800000,88,714983.0,27757,1267.4,85017,714983
1000000,88,893945.0,97084,1586.12,106055,893945
2,89,1.0,0,0.0,1,1
3,89,2.0,0,0.0,1,2
100,89,87.0,94,0.28,13,87
200,89,179.0,192,0.66,21,179
2000,89,1788.0,1965,3.42,212,1788
10000,89,8933.0,9772,16.34,1067,8933
20000,89,17840.0,18751,30.68,2160,17840
40000,89,35782.0,20870,63.74,4218,35782
60000,89,53661.0,21555,97.09,6339,53661
80000,89,71438.0,23014,130.62,8562,71438
100000,89,89318.0,24099,160.55,10682,89318
200000,89,178567.0,27405,314.36,21433,178567
400000,89,357510.0,220659,637.83,42490,357510
600000,89,536228.0,417392,949.24,63772,536228
800000,89,714779.0,614083,1260.46,85221,714779
1000000,89,893586.0,810754,1575.48,106414,893586
2,90,0.0,0,0.0,2,0
3,90,1.0,0,0.0,2,1
100,90,88.0,16,0.38,12,88
200,90,181.0,20,0.57,19,181
2000,90,1797.0,108,2.75,203,1797
10000,90,8959.0,1510,16.15,1041,8959
20000,90,17914.0,1958,31.06,2086,17914
40000,90,35784.0,2678,69.73,4216,35784
60000,90,53588.0,3473,101.27,6412,53588
80000,90,71456.0,4129,131.86,8544,71456
100000,90,89296.0,11547,164.73,10704,89296
200000,90,178692.0,109949,319.49,21308,178692
400000,90,357051.0,269562,639.35,42949,357051
600000,90,535787.0,466083,955.23,64213,535787
800000,90,714306.0,662644,1263.98,85694,714306
1000000,90,893053.0,859311,1583.65,106947,893053
2,91,2.0,0,0.0,0,2
3,91,3.0,0,0.0,0,3
100,91,90.0,85,0.28,10,90
200,91,181.0,185,0.47,19,181
2000,91,1776.0,1952,4.18,224,1776
10000,91,8943.0,9795,15.96,1057,8943
20000,91,17852.0,19639,30.4,2148,17852
40000,91,35740.0,39308,61.65,4260,35740
60000,91,53652.0,58982,93.48,6348,53652
80000,91,71456.0,78659,128.25,8544,71456
100000,91,89364.0,98319,160.74,10636,89364
200000,91,178683.0,195626,324.14,21317,178683
400000,91,357293.0,392226,645.43,42707,357293
600000,91,535904.0,588955,964.73,64096,535904
800000,91,714611.0,785544,1284.31,85389,714611
1000000,91,893364.0,982243,1592.87,106636,893364
2,92,2.0,0,0.0,0,2
3,92,3.0,0,0.0,0,3
100,92,87.0,11,0.47,13,87
200,92,179.0,13,0.57,21,179
2000,92,1800.0,71,3.7,200,1800
10000,92,8944.0,335,16.53,1056,8944
20000,92,17905.0,994,31.63,2095,17905
40000,92,35800.0,1658,63.55,4200,35800
60000,92,53708.0,2298,93.29,6292,53708
80000,92,71557.0,2967,125.68,8443,71557
100000,92,89398.0,3658,158.27,10602,89398
200000,92,178697.0,7355,314.17,21303,178697
400000,92,357289.0,29050,622.06,42711,357289
600000,92,535906.0,41190,941.45,64094,535906
800000,92,714561.0,47862,1249.06,85439,714561
1000000,92,893298.0,54510,1567.31,106702,893298
2,93,1.0,0,0.0,1,1
3,93,2.0,0,0.0,1,2
100,93,86.0,6,0.09,14,86
200,93,174.0,8,0.19,26,174
2000,93,1785.0,77,4.18,215,1785
10000,93,8959.0,1552,17.67,1041,8959
20000,93,17905.0,10357,33.34,2095,17905
40000,93,35786.0,30024,62.7,4214,35786
60000,93,53720.0,49705,92.43,6280,53720
80000,93,71608.0,69305,123.78,8392,71608
100000,93,89550.0,88972,156.08,10450,89550
200000,93,178866.0,187271,308.85,21134,178866
400000,93,357690.0,383887,619.31,42310,357690
600000,93,536283.0,580595,940.41,63717,536283
800000,93,714705.0,776901,1259.04,85295,714705
1000000,93,893550.0,973531,1572.82,106450,893550
2,94,1.0,0,0.0,1,1
3,94,2.0,1,0.0,1,2
100,94,88.0,97,0.66,12,88
200,94,176.0,196,0.95,24,176
2000,94,1786.0,1089,4.37,214,1786
10000,94,8911.0,1353,16.72,1089,8911
20000,94,17861.0,1687,32.77,2139,17861
40000,94,35761.0,2356,65.17,4239,35761
60000,94,53597.0,3002,97.56,6403,53597
80000,94,71428.0,3659,126.63,8572,71428
100000,94,89238.0,4352,159.12,10762,89238
200000,94,178491.0,7658,312.46,21509,178491
400000,94,357052.0,81736,625.39,42948,357052
600000,94,535800.0,278433,938.98,64200,535800
800000,94,714534.0,475091,1253.34,85466,714534
1000000,94,893428.0,671748,1570.35,106572,893428
2,95,2.0,0,0.0,0,2
3,95,3.0,0,0.0,0,3
100,95,87.0,70,1.23,13,87
200,95,177.0,76,1.52,23,177
2000,95,1807.0,138,4.84,193,1807
10000,95,8988.0,462,18.72,1012,8988
20000,95,17939.0,779,33.15,2061,17939
40000,95,35765.0,1438,62.98,4235,35765
60000,95,53659.0,2116,94.52,6341,53659
80000,95,71454.0,2780,127.58,8546,71454
100000,95,89268.0,3430,157.6,10732,89268
200000,95,178570.0,6788,313.5,21430,178570
400000,95,357245.0,13509,637.83,42755,357245
600000,95,535857.0,20154,954.18,64143,535857
800000,95,714391.0,26894,1272.91,85609,714391
1000000,95,892938.0,33481,1586.88,107062,892938
2,96,2.0,0,0.0,0,2
3,96,3.0,0,0.0,0,3
100,96,91.0,95,0.47,9,91
200,96,180.0,194,0.66,20,180
2000,96,1796.0,1958,4.08,204,1796
10000,96,8980.0,9808,15.3,1020,8980
20000,96,17931.0,18915,29.92,2069,17931
40000,96,35848.0,38164,61.75,4152,35848
60000,96,53719.0,57616,92.81,6281,53719
80000,96,71484.0,77263,124.54,8516,71484
100000,96,89376.0,96958,154.09,10624,89376
200000,96,178750.0,195337,314.17,21250,178750
400000,96,357740.0,391956,626.81,42260,357740
600000,96,536390.0,579487,943.64,63610,536390
800000,96,715136.0,776092,1260.94,84864,715136
1000000,96,893793.0,972770,1575.86,106207,893793
2,97,1.0,1,0.0,1,1
3,97,2.0,1,0.0,1,2
100,97,90.0,15,1.23,10,90
200,97,183.0,17,1.42,17,183
2000,97,1772.0,973,4.18,228,1772
10000,97,8915.0,8838,16.06,1085,8915
20000,97,17774.0,18658,31.63,2226,17774
40000,97,35604.0,38308,64.79,4396,35604
60000,97,53450.0,57972,93.0,6550,53450
80000,97,71315.0,77631,124.45,8685,71315
100000,97,89177.0,97337,155.32,10823,89177
200000,97,178473.0,195599,316.92,21527,178473
400000,97,357272.0,392204,631.85,42728,357272
600000,97,536079.0,588858,943.45,63921,536079
800000,97,714842.0,785561,1262.27,85158,714842
1000000,97,893458.0,982016,1580.99,106542,893458
2,98,2.0,0,0.0,0,2
3,98,3.0,0,0.0,0,3
100,98,87.0,3,0.09,13,87
200,98,179.0,6,0.28,21,179
2000,98,1776.0,1189,5.41,224,1776
10000,98,8900.0,9036,18.34,1100,8900
20000,98,17825.0,18857,32.68,2175,17825
40000,98,35744.0,38526,63.36,4256,35744
60000,98,53580.0,58197,95.28,6420,53580
80000,98,71426.0,77821,123.88,8574,71426
100000,98,89277.0,97471,155.04,10723,89277
200000,98,178542.0,195632,320.34,21458,178542
400000,98,357345.0,354655,647.33,42655,357345
600000,98,536005.0,551226,962.07,63995,536005
800000,98,714544.0,747943,1276.9,85456,714544
1000000,98,893065.0,944620,1586.88,106935,893065
2,99,2.0,0,0.0,0,2
3,99,3.0,0,0.0,0,3
100,99,89.0,21,0.47,11,89
200,99,175.0,26,0.66,25,175
2000,99,1782.0,239,3.99,218,1782
10000,99,8907.0,771,17.29,1093,8907
20000,99,17824.0,1109,33.44,2176,17824
40000,99,35745.0,1790,64.98,4255,35745
60000,99,53586.0,2468,96.52,6414,53586
80000,99,71447.0,3107,127.11,8553,71447
100000,99,89279.0,3775,155.99,10721,89279
200000,99,178510.0,7211,317.49,21490,178510
400000,99,357126.0,13973,642.77,42874,357126
600000,99,535870.0,20649,967.01,64130,535870
800000,99,714412.0,27288,1275.85,85588,714412
1000000,99,892966.0,34116,1603.13,107034,892966
2,100,2.0,0,0.0,0,2
3,100,3.0,0,0.0,0,3
100,100,93.0,53,3.8,7,93
200,100,184.0,67,4.27,16,184
2000,100,1801.0,1273,7.12,199,1801
10000,100,8932.0,9134,18.53,1068,8932
20000,100,17846.0,18970,34.2,2154,17846
40000,100,35786.0,38648,69.06,4214,35786
60000,100,53670.0,58327,102.31,6330,53670
80000,100,71554.0,78002,133.28,8446,71554
100000,100,89364.0,97666,163.4,10636,89364
200000,100,178540.0,195935,322.24,21460,178540
400000,100,357225.0,391283,643.91,42775,357225
600000,100,535940.0,587906,958.27,64060,535940
800000,100,714684.0,784507,1267.4,85316,714684
1000000,100,893310.0,981131,1584.13,106690,893310
