Timestep,Iteration,Total Reward,Suboptimal Arms,Total Regret,Zeros Count,Ones Count
2,1,2.0,1,0.05,0,2
3,1,3.0,2,0.14,0,3
100,1,91.0,67,4.86,9,91
200,1,173.0,133,9.73,27,173
2000,1,1754.0,816,58.12,246,1754
10000,1,8873.0,1303,93.39,1127,8873
20000,1,17858.0,1587,110.37,2142,17858
40000,1,35722.0,2069,137.4,4278,35722
60000,1,53553.0,2259,150.9,6447,53553
80000,1,71485.0,2295,154.02,8515,71485
10000,1,8873.0,1303,93.39,1127,8873
2,2,2.0,1,0.05,0,2
3,2,3.0,2,0.14,0,3
100,2,86.0,62,4.39,14,86
200,2,172.0,129,9.6,28,172
2000,2,1734.0,838,55.61,266,1734
10000,2,8841.0,1570,105.1,1159,8841
20000,2,17782.0,1971,131.25,2218,17782
40000,2,35566.0,2291,150.24,4434,35566
60000,2,53432.0,2571,165.94,6568,53432
80000,2,71357.0,2626,169.27,8643,71357
10000,2,8841.0,1570,105.1,1159,8841
2,3,2.0,1,0.05,0,2
3,3,2.0,2,0.14,1,2
100,3,77.0,61,4.04,23,77
200,3,161.0,125,8.12,39,161
2000,3,1719.0,913,56.29,281,1719
10000,3,8794.0,1798,107.06,1206,8794
20000,3,17690.0,1927,115.17,2310,17690
40000,3,35528.0,2274,140.13,4472,35528
60000,3,53379.0,2343,145.34,6621,53379
80000,3,71266.0,2592,156.94,8734,71266
10000,3,8794.0,1798,107.06,1206,8794
2,4,2.0,1,0.05,0,2
3,4,3.0,2,0.14,0,3
100,4,87.0,66,4.42,13,87
200,4,172.0,120,8.15,28,172
2000,4,1737.0,821,53.65,263,1737
10000,4,8838.0,1827,116.62,1162,8838
20000,4,17754.0,2011,128.75,2246,17754
40000,4,35611.0,2538,155.61,4389,35611
60000,4,53577.0,2760,171.2,6423,53577
80000,4,71445.0,2807,173.46,8555,71445
10000,4,8838.0,1827,116.62,1162,8838
2,5,1.0,1,0.05,1,1
3,5,2.0,2,0.14,1,2
100,5,85.0,61,4.24,15,85
200,5,172.0,109,7.65,28,172
2000,5,1750.0,738,51.46,250,1750
10000,5,8909.0,1504,100.08,1091,8909
20000,5,17745.0,2351,142.09,2255,17745
40000,5,35560.0,2586,156.62,4440,35560
60000,5,53490.0,2615,158.27,6510,53490
80000,5,71373.0,2668,160.86,8627,71373
10000,5,8909.0,1504,100.08,1091,8909
2,6,2.0,1,0.05,0,2
3,6,2.0,2,0.14,1,2
100,6,80.0,62,4.09,20,80
200,6,162.0,120,8.15,38,162
2000,6,1720.0,740,47.65,280,1720
10000,6,8817.0,1695,101.03,1183,8817
20000,6,17749.0,1995,120.23,2251,17749
40000,6,35714.0,2291,135.0,4286,35714
60000,6,53507.0,2582,159.64,6493,53507
80000,6,71513.0,2654,163.73,8487,71513
10000,6,8817.0,1695,101.03,1183,8817
2,7,2.0,1,0.05,0,2
3,7,3.0,2,0.14,0,3
100,7,89.0,65,4.42,11,89
200,7,180.0,135,9.32,20,180
2000,7,1734.0,805,53.43,266,1734
10000,7,8925.0,1540,99.65,1075,8925
20000,7,17869.0,1931,124.05,2131,17869
40000,7,35733.0,2271,149.74,4267,35733
60000,7,53701.0,2366,157.72,6299,53701
80000,7,71627.0,2432,161.89,8373,71627
10000,7,8925.0,1540,99.65,1075,8925
2,8,2.0,1,0.05,0,2
3,8,3.0,2,0.14,0,3
100,8,78.0,67,4.66,22,78
200,8,162.0,130,8.5,38,162
2000,8,1752.0,679,42.81,248,1752
10000,8,8837.0,1460,85.1,1163,8837
20000,8,17853.0,1571,92.1,2147,17853
40000,8,35709.0,1873,109.14,4291,35709
60000,8,53575.0,1939,113.01,6425,53575
80000,8,71482.0,1964,114.93,8518,71482
10000,8,8837.0,1460,85.1,1163,8837
2,9,2.0,1,0.05,0,2
3,9,2.0,2,0.14,1,2
100,9,81.0,65,4.32,19,81
200,9,173.0,128,8.31,27,173
2000,9,1726.0,914,58.78,274,1726
10000,9,8889.0,1405,91.38,1111,8889
20000,9,17813.0,1731,112.5,2187,17813
40000,9,35638.0,1877,121.57,4362,35638
60000,9,53482.0,2059,136.21,6518,53482
80000,9,71293.0,2132,140.79,8707,71293
10000,9,8889.0,1405,91.38,1111,8889
2,10,2.0,1,0.05,0,2
3,10,2.0,2,0.14,1,2
100,10,85.0,61,3.99,15,85
200,10,174.0,124,8.23,26,174
2000,10,1740.0,904,56.68,260,1740
10000,10,8870.0,1598,98.86,1130,8870
20000,10,17788.0,2077,124.82,2212,17788
40000,10,35687.0,2989,170.45,4313,35687
60000,10,53583.0,3175,180.92,6417,53583
80000,10,71466.0,3263,184.98,8534,71466
10000,10,8870.0,1598,98.86,1130,8870
2,11,2.0,1,0.05,0,2
3,11,2.0,2,0.14,1,2
100,11,85.0,64,4.43,15,85
200,11,171.0,123,8.48,29,171
2000,11,1742.0,934,59.03,258,1742
10000,11,8858.0,2223,127.54,1142,8858
20000,11,17834.0,2884,160.93,2166,17834
40000,11,35738.0,3232,185.19,4262,35738
60000,11,53683.0,3390,195.15,6317,53683
80000,11,71598.0,3715,211.22,8402,71598
10000,11,8858.0,2223,127.54,1142,8858
2,12,2.0,1,0.05,0,2
3,12,3.0,2,0.14,0,3
100,12,88.0,67,4.66,12,88
200,12,170.0,116,8.12,30,170
2000,12,1742.0,734,46.08,258,1742
10000,12,8837.0,2048,128.06,1163,8837
20000,12,17743.0,2507,158.61,2257,17743
40000,12,35678.0,2899,179.6,4322,35678
60000,12,53472.0,3213,200.83,6528,53472
80000,12,71340.0,3350,210.5,8660,71340
10000,12,8837.0,2048,128.06,1163,8837
2,13,2.0,1,0.05,0,2
3,13,3.0,2,0.14,0,3
100,13,83.0,63,4.53,17,83
200,13,169.0,125,8.82,31,169
2000,13,1753.0,731,47.85,247,1753
10000,13,8871.0,1458,90.66,1129,8871
20000,13,17719.0,2000,120.1,2281,17719
40000,13,35524.0,3143,172.63,4476,35524
60000,13,53377.0,3234,178.03,6623,53377
80000,13,71233.0,3512,191.59,8767,71233
10000,13,8871.0,1458,90.66,1129,8871
2,14,2.0,1,0.05,0,2
3,14,3.0,2,0.14,0,3
100,14,89.0,69,4.95,11,89
200,14,172.0,144,9.93,28,172
2000,14,1728.0,1058,67.81,272,1728
10000,14,8766.0,2167,129.67,1234,8766
20000,14,17759.0,2218,132.71,2241,17759
40000,14,35598.0,2449,144.65,4402,35598
60000,14,53498.0,2936,167.52,6502,53498
80000,14,71354.0,3072,174.09,8646,71354
10000,14,8766.0,2167,129.67,1234,8766
2,15,1.0,1,0.05,1,1
3,15,2.0,2,0.14,1,2
100,15,86.0,63,4.28,14,86
200,15,172.0,119,8.15,28,172
2000,15,1725.0,850,51.85,275,1725
10000,15,8799.0,1624,100.13,1201,8799
20000,15,17803.0,1824,112.13,2197,17803
40000,15,35709.0,2216,133.22,4291,35709
60000,15,53533.0,2416,145.12,6467,53533
80000,15,71467.0,2735,159.97,8533,71467
10000,15,8799.0,1624,100.13,1201,8799
2,16,1.0,1,0.05,1,1
3,16,2.0,2,0.14,1,2
100,16,88.0,64,4.53,12,88
200,16,172.0,127,8.86,28,172
2000,16,1759.0,699,50.01,241,1759
10000,16,8913.0,1393,95.69,1087,8913
20000,16,17775.0,2145,135.82,2225,17775
40000,16,35648.0,2386,150.12,4352,35648
60000,16,53489.0,2488,157.81,6511,53489
80000,16,71375.0,2517,159.36,8625,71375
10000,16,8913.0,1393,95.69,1087,8913
2,17,1.0,1,0.05,1,1
3,17,1.0,2,0.14,2,1
100,17,84.0,67,4.66,16,84
200,17,171.0,126,8.82,29,171
2000,17,1760.0,855,53.93,240,1760
10000,17,8854.0,1477,97.37,1146,8854
20000,17,17782.0,1702,113.49,2218,17782
40000,17,35727.0,1838,124.26,4273,35727
60000,17,53618.0,3002,178.34,6382,53618
80000,17,71458.0,3163,187.98,8542,71458
10000,17,8854.0,1477,97.37,1146,8854
2,18,1.0,1,0.05,1,1
3,18,2.0,2,0.14,1,2
100,18,88.0,63,4.23,12,88
200,18,175.0,124,8.23,25,175
2000,18,1741.0,805,52.38,259,1741
10000,18,8825.0,2106,121.72,1175,8825
20000,18,17764.0,2449,144.81,2236,17764
40000,18,35631.0,2877,166.96,4369,35631
60000,18,53485.0,3039,177.25,6515,53485
80000,18,71351.0,3060,178.55,8649,71351
10000,18,8825.0,2106,121.72,1175,8825
2,19,2.0,1,0.05,0,2
3,19,3.0,2,0.14,0,3
100,19,87.0,63,4.38,13,87
200,19,174.0,130,8.6,26,174
2000,19,1748.0,893,54.44,252,1748
10000,19,8857.0,2424,134.48,1143,8857
20000,19,17719.0,3211,174.34,2281,17719
40000,19,35623.0,3647,202.16,4377,35623
60000,19,53462.0,3929,220.75,6538,53462
80000,19,71419.0,3987,223.46,8581,71419
10000,19,8857.0,2424,134.48,1143,8857
2,20,2.0,1,0.05,0,2
3,20,3.0,2,0.14,0,3
100,20,92.0,63,4.33,8,92
200,20,182.0,125,8.72,18,182
2000,20,1725.0,951,59.8,275,1725
10000,20,8878.0,1711,101.0,1122,8878
20000,20,17810.0,2032,117.64,2190,17810
40000,20,35667.0,2676,153.42,4333,35667
60000,20,53577.0,2886,166.42,6423,53577
80000,20,71552.0,2911,167.64,8448,71552
10000,20,8878.0,1711,101.0,1122,8878
2,21,2.0,1,0.05,0,2
3,21,3.0,2,0.14,0,3
100,21,89.0,63,4.08,11,89
200,21,177.0,116,7.57,23,177
2000,21,1753.0,826,51.07,247,1753
10000,21,8926.0,1645,92.68,1074,8926
20000,21,17903.0,1943,107.99,2097,17903
40000,21,35810.0,2574,138.48,4190,35810
60000,21,53748.0,2817,153.41,6252,53748
80000,21,71616.0,2882,157.14,8384,71616
10000,21,8926.0,1645,92.68,1074,8926
2,22,1.0,1,0.05,1,1
3,22,2.0,2,0.14,1,2
100,22,87.0,68,4.36,13,87
200,22,169.0,133,8.58,31,169
2000,22,1732.0,854,50.28,268,1732
10000,22,8876.0,1723,94.34,1124,8876
20000,22,17807.0,2087,117.87,2193,17807
40000,22,35583.0,2586,146.62,4417,35583
60000,22,53426.0,2782,155.74,6574,53426
80000,22,71245.0,2830,158.1,8755,71245
10000,22,8876.0,1723,94.34,1124,8876
2,23,2.0,1,0.05,0,2
3,23,2.0,2,0.14,1,2
100,23,83.0,63,4.23,17,83
200,23,170.0,125,8.27,30,170
2000,23,1732.0,787,47.47,268,1732
10000,23,8859.0,1423,88.14,1141,8859
20000,23,17810.0,1631,101.45,2190,17810
40000,23,35655.0,2158,126.36,4345,35655
60000,23,53524.0,2299,133.31,6476,53524
80000,23,71388.0,2478,141.86,8612,71388
10000,23,8859.0,1423,88.14,1141,8859
2,24,2.0,1,0.05,0,2
3,24,3.0,2,0.14,0,3
100,24,83.0,61,4.34,17,83
200,24,167.0,121,8.29,33,167
2000,24,1735.0,755,48.13,265,1735
10000,24,8810.0,1870,112.1,1190,8810
20000,24,17725.0,2399,145.4,2275,17725
40000,24,35562.0,3171,182.04,4438,35562
60000,24,53432.0,3270,187.95,6568,53432
80000,24,71380.0,3330,191.05,8620,71380
10000,24,8810.0,1870,112.1,1190,8810
2,25,2.0,1,0.05,0,2
3,25,2.0,2,0.14,1,2
100,25,87.0,61,4.24,13,87
200,25,175.0,122,8.19,25,175
2000,25,1769.0,789,48.81,231,1769
10000,25,8858.0,1729,103.71,1142,8858
20000,25,17742.0,2229,130.16,2258,17742
40000,25,35635.0,2665,158.27,4365,35635
60000,25,53459.0,3148,182.81,6541,53459
80000,25,71301.0,3260,188.2,8699,71301
10000,25,8858.0,1729,103.71,1142,8858
2,26,2.0,1,0.05,0,2
3,26,3.0,2,0.14,0,3
100,26,86.0,59,4.25,14,86
200,26,172.0,113,8.23,28,172
2000,26,1742.0,921,55.2,258,1742
10000,26,8895.0,1699,98.06,1105,8895
20000,26,17802.0,1925,110.28,2198,17802
40000,26,35697.0,2115,124.73,4303,35697
60000,26,53541.0,2334,137.18,6459,53541
80000,26,71381.0,2600,152.15,8619,71381
10000,26,8895.0,1699,98.06,1105,8895
2,27,2.0,1,0.05,0,2
3,27,2.0,2,0.14,1,2
100,27,81.0,63,4.23,19,81
200,27,169.0,117,8.01,31,169
2000,27,1735.0,684,46.63,265,1735
10000,27,8822.0,1339,85.01,1178,8822
20000,27,17735.0,1678,103.86,2265,17735
40000,27,35546.0,1994,122.73,4454,35546
60000,27,53477.0,2178,135.21,6523,53477
80000,27,71383.0,2375,148.57,8617,71383
10000,27,8822.0,1339,85.01,1178,8822
2,28,2.0,1,0.05,0,2
3,28,3.0,2,0.14,0,3
100,28,86.0,63,4.53,14,86
200,28,171.0,136,9.37,29,171
2000,28,1719.0,876,56.87,281,1719
10000,28,8822.0,1873,117.24,1178,8822
20000,28,17801.0,1997,125.52,2199,17801
40000,28,35738.0,2254,138.88,4262,35738
60000,28,53680.0,2508,152.81,6320,53680
80000,28,71551.0,2611,158.99,8449,71551
10000,28,8822.0,1873,117.24,1178,8822
2,29,2.0,1,0.05,0,2
3,29,3.0,2,0.14,0,3
100,29,86.0,61,4.19,14,86
200,29,175.0,109,7.5,25,175
2000,29,1742.0,835,54.88,258,1742
10000,29,8812.0,2114,118.98,1188,8812
20000,29,17777.0,2325,131.63,2223,17777
40000,29,35599.0,2784,155.08,4401,35599
60000,29,53519.0,2851,158.99,6481,53519
80000,29,71422.0,2897,161.66,8578,71422
10000,29,8812.0,2114,118.98,1188,8812
2,30,1.0,1,0.05,1,1
3,30,2.0,2,0.14,1,2
100,30,82.0,63,4.33,18,82
200,30,169.0,125,9.02,31,169
2000,30,1702.0,872,53.09,298,1702
10000,30,8814.0,1631,97.8,1186,8814
20000,30,17748.0,2145,122.38,2252,17748
40000,30,35634.0,2351,132.9,4366,35634
60000,30,53459.0,2408,136.46,6541,53459
80000,30,71345.0,2598,146.16,8655,71345
10000,30,8814.0,1631,97.8,1186,8814
2,31,2.0,1,0.05,0,2
3,31,3.0,2,0.14,0,3
100,31,88.0,68,4.56,12,88
200,31,172.0,130,8.45,28,172
2000,31,1749.0,812,44.99,251,1749
10000,31,8823.0,1691,94.8,1177,8823
20000,31,17800.0,1778,99.56,2200,17800
40000,31,35638.0,2029,113.36,4362,35638
60000,31,53555.0,2235,123.28,6445,53555
80000,31,71506.0,2456,134.22,8494,71506
10000,31,8823.0,1691,94.8,1177,8823
2,32,2.0,1,0.05,0,2
3,32,3.0,2,0.14,0,3
100,32,89.0,62,4.39,11,89
200,32,172.0,107,7.66,28,172
2000,32,1737.0,963,61.49,263,1737
10000,32,8807.0,2119,127.21,1193,8807
20000,32,17710.0,2929,175.2,2290,17710
40000,32,35580.0,3193,188.93,4420,35580
60000,32,53462.0,3324,197.33,6538,53462
80000,32,71415.0,3362,200.09,8585,71415
10000,32,8807.0,2119,127.21,1193,8807
2,33,2.0,1,0.05,0,2
3,33,3.0,2,0.14,0,3
100,33,86.0,67,4.61,14,86
200,33,177.0,130,8.85,23,177
2000,33,1751.0,906,53.67,249,1751
10000,33,8911.0,1865,108.18,1089,8911
20000,33,17844.0,2201,126.5,2156,17844
40000,33,35673.0,2935,169.82,4327,35673
60000,33,53546.0,3142,179.49,6454,53546
80000,33,71383.0,3396,192.82,8617,71383
10000,33,8911.0,1865,108.18,1089,8911
2,34,2.0,1,0.05,0,2
3,34,3.0,2,0.14,0,3
100,34,87.0,69,4.65,13,87
200,34,170.0,127,8.71,30,170
2000,34,1699.0,916,61.22,301,1699
10000,34,8768.0,2024,118.23,1232,8768
20000,34,17733.0,2142,125.59,2267,17733
40000,34,35681.0,2464,140.58,4319,35681
60000,34,53553.0,2988,164.71,6447,53553
80000,34,71443.0,3140,172.0,8557,71443
10000,34,8768.0,2024,118.23,1232,8768
2,35,1.0,1,0.05,1,1
3,35,1.0,2,0.14,2,1
100,35,75.0,55,3.77,25,75
200,35,164.0,105,7.22,36,164
2000,35,1726.0,607,40.17,274,1726
10000,35,8839.0,1490,87.85,1161,8839
20000,35,17788.0,1763,105.69,2212,17788
40000,35,35697.0,1914,113.93,4303,35697
60000,35,53553.0,2402,138.59,6447,53553
80000,35,71450.0,2478,142.46,8550,71450
10000,35,8839.0,1490,87.85,1161,8839
2,36,2.0,1,0.05,0,2
3,36,3.0,2,0.14,0,3
100,36,84.0,63,3.98,16,84
200,36,168.0,117,7.26,32,168
2000,36,1728.0,665,38.43,272,1728
10000,36,8861.0,1405,83.68,1139,8861
20000,36,17830.0,1606,96.82,2170,17830
40000,36,35775.0,2321,138.49,4225,35775
60000,36,53717.0,2390,142.85,6283,53717
80000,36,71611.0,2505,149.02,8389,71611
10000,36,8861.0,1405,83.68,1139,8861
2,37,2.0,1,0.05,0,2
3,37,3.0,2,0.14,0,3
100,37,88.0,60,4.2,12,88
200,37,172.0,101,7.04,28,172
2000,37,1751.0,728,45.11,249,1751
10000,37,8860.0,2048,115.91,1140,8860
20000,37,17723.0,2536,142.72,2277,17723
40000,37,35587.0,2724,151.53,4413,35587
60000,37,53494.0,2772,154.24,6506,53494
80000,37,71402.0,2841,157.79,8598,71402
10000,37,8860.0,2048,115.91,1140,8860
2,38,1.0,1,0.05,1,1
3,38,2.0,2,0.14,1,2
100,38,80.0,62,4.34,20,80
200,38,167.0,121,8.24,33,167
2000,38,1753.0,745,49.48,247,1753
10000,38,8832.0,2085,130.68,1168,8832
20000,38,17738.0,2560,157.0,2262,17738
40000,38,35626.0,2694,163.88,4374,35626
60000,38,53568.0,2722,165.84,6432,53568
80000,38,71569.0,2757,168.91,8431,71569
10000,38,8832.0,2085,130.68,1168,8832
2,39,2.0,1,0.05,0,2
3,39,2.0,2,0.14,1,2
100,39,82.0,61,4.19,18,82
200,39,165.0,108,7.51,35,165
2000,39,1754.0,600,36.15,246,1754
10000,39,8852.0,1636,90.27,1148,8852
20000,39,17779.0,2029,109.56,2221,17779
40000,39,35755.0,2283,122.39,4245,35755
60000,39,53656.0,2375,127.63,6344,53656
80000,39,71591.0,2493,134.39,8409,71591
10000,39,8852.0,1636,90.27,1148,8852
2,40,2.0,1,0.05,0,2
3,40,3.0,2,0.14,0,3
100,40,90.0,66,4.67,10,90
200,40,173.0,129,9.3,27,173
2000,40,1740.0,940,62.1,260,1740
10000,40,8842.0,2076,136.52,1158,8842
20000,40,17755.0,2495,156.97,2245,17755
40000,40,35591.0,3601,209.59,4409,35591
60000,40,53466.0,3710,215.55,6534,53466
80000,40,71363.0,4186,237.27,8637,71363
10000,40,8842.0,2076,136.52,1158,8842
2,41,2.0,1,0.05,0,2
3,41,3.0,2,0.14,0,3
100,41,81.0,65,4.47,19,81
200,41,169.0,124,8.68,31,169
2000,41,1747.0,733,49.34,253,1747
10000,41,8822.0,1393,88.14,1178,8822
20000,41,17715.0,1704,107.38,2285,17715
40000,41,35626.0,1947,120.87,4374,35626
60000,41,53511.0,2294,136.63,6489,53511
80000,41,71320.0,2352,139.84,8680,71320
10000,41,8822.0,1393,88.14,1178,8822
2,42,2.0,1,0.05,0,2
3,42,3.0,2,0.14,0,3
100,42,90.0,66,4.57,10,90
200,42,179.0,126,8.37,21,179
2000,42,1743.0,781,52.95,257,1743
10000,42,8848.0,2002,119.44,1152,8848
20000,42,17772.0,2213,130.79,2228,17772
40000,42,35591.0,2695,158.92,4409,35591
60000,42,53496.0,2886,169.32,6504,53496
80000,42,71370.0,2939,172.2,8630,71370
10000,42,8848.0,2002,119.44,1152,8848
2,43,2.0,1,0.05,0,2
3,43,3.0,2,0.14,0,3
100,43,76.0,67,4.66,24,76
200,43,156.0,142,9.94,44,156
2000,43,1678.0,928,58.56,322,1678
10000,43,8835.0,1339,81.16,1165,8835
20000,43,17682.0,1646,100.67,2318,17682
40000,43,35588.0,1797,110.27,4412,35588
60000,43,53470.0,1960,118.1,6530,53470
80000,43,71359.0,2006,120.67,8641,71359
10000,43,8835.0,1339,81.16,1165,8835
2,44,2.0,1,0.05,0,2
3,44,3.0,2,0.14,0,3
100,44,87.0,66,4.67,13,87
200,44,175.0,125,8.52,25,175
2000,44,1749.0,879,58.56,251,1749
10000,44,8849.0,2348,138.01,1151,8849
20000,44,17773.0,3034,173.98,2227,17773
40000,44,35626.0,3296,188.37,4374,35626
60000,44,53503.0,3671,206.19,6497,53503
80000,44,71478.0,3689,207.45,8522,71478
10000,44,8849.0,2348,138.01,1151,8849
2,45,2.0,1,0.05,0,2
3,45,3.0,2,0.14,0,3
100,45,87.0,60,4.0,13,87
200,45,175.0,120,7.95,25,175
2000,45,1771.0,653,42.19,229,1771
10000,45,8867.0,1250,81.3,1133,8867
20000,45,17833.0,1587,102.27,2167,17833
40000,45,35608.0,1965,122.58,4392,35608
60000,45,53568.0,1986,124.37,6432,53568
80000,45,71505.0,2018,126.11,8495,71505
10000,45,8867.0,1250,81.3,1133,8867
2,46,2.0,1,0.05,0,2
3,46,3.0,2,0.14,0,3
100,46,86.0,68,4.76,14,86
200,46,170.0,121,8.79,30,170
2000,46,1728.0,1038,67.36,272,1728
10000,46,8820.0,1784,108.63,1180,8820
20000,46,17776.0,1973,120.24,2224,17776
40000,46,35712.0,2056,125.37,4288,35712
60000,46,53590.0,2240,135.9,6410,53590
80000,46,71464.0,2319,139.75,8536,71464
10000,46,8820.0,1784,108.63,1180,8820
2,47,1.0,1,0.05,1,1
3,47,2.0,2,0.14,1,2
100,47,83.0,60,4.0,17,83
200,47,164.0,117,7.76,36,164
2000,47,1740.0,914,58.13,260,1740
10000,47,8824.0,1826,107.47,1176,8824
20000,47,17753.0,2097,121.42,2247,17753
40000,47,35623.0,2286,131.87,4377,35623
60000,47,53509.0,2375,137.73,6491,53509
80000,47,71364.0,2512,145.49,8636,71364
10000,47,8824.0,1826,107.47,1176,8824
2,48,2.0,1,0.05,0,2
3,48,2.0,2,0.14,1,2
100,48,87.0,59,3.75,13,87
200,48,177.0,110,6.95,23,177
2000,48,1754.0,590,35.7,246,1754
10000,48,8930.0,1439,82.51,1070,8930
20000,48,17890.0,1657,96.07,2110,17890
40000,48,35858.0,1820,105.25,4142,35858
60000,48,53691.0,2161,122.05,6309,53691
80000,48,71599.0,2258,128.41,8401,71599
10000,48,8930.0,1439,82.51,1070,8930
2,49,2.0,1,0.05,0,2
3,49,3.0,2,0.14,0,3
100,49,88.0,67,4.66,12,88
200,49,171.0,134,9.08,29,171
2000,49,1741.0,790,51.5,259,1741
10000,49,8836.0,1406,87.87,1164,8836
20000,49,17738.0,1698,105.56,2262,17738
40000,49,35679.0,1771,111.4,4321,35679
60000,49,53566.0,1909,119.91,6434,53566
80000,49,71461.0,2323,139.33,8539,71461
10000,49,8836.0,1406,87.87,1164,8836
2,50,2.0,1,0.05,0,2
3,50,3.0,2,0.14,0,3
100,50,85.0,67,4.81,15,85
200,50,165.0,115,8.17,35,165
2000,50,1739.0,653,41.09,261,1739
10000,50,8876.0,1097,66.37,1124,8876
20000,50,17842.0,1255,76.23,2158,17842
40000,50,35735.0,1527,90.62,4265,35735
60000,50,53606.0,1669,98.51,6394,53606
80000,50,71550.0,1739,102.16,8450,71550
10000,50,8876.0,1097,66.37,1124,8876
2,51,2.0,1,0.05,0,2
3,51,3.0,2,0.14,0,3
100,51,90.0,66,4.57,10,90
200,51,177.0,131,9.29,23,177
2000,51,1739.0,799,48.26,261,1739
10000,51,8908.0,1492,85.54,1092,8908
20000,51,17822.0,2286,123.42,2178,17822
40000,51,35687.0,2508,139.41,4313,35687
60000,51,53689.0,2601,144.5,6311,53689
80000,51,71584.0,2916,161.72,8416,71584
10000,51,8908.0,1492,85.54,1092,8908
2,52,2.0,1,0.05,0,2
3,52,3.0,2,0.14,0,3
100,52,89.0,62,4.14,11,89
200,52,177.0,124,8.28,23,177
2000,52,1753.0,783,50.44,247,1753
10000,52,8852.0,1541,97.9,1148,8852
20000,52,17835.0,1724,109.08,2165,17835
40000,52,35677.0,2310,137.0,4323,35677
60000,52,53572.0,2446,147.02,6428,53572
80000,52,71407.0,2580,153.9,8593,71407
10000,52,8852.0,1541,97.9,1148,8852
2,53,2.0,1,0.05,0,2
3,53,3.0,2,0.14,0,3
100,53,83.0,63,4.13,17,83
200,53,172.0,127,8.11,28,172
2000,53,1707.0,1006,54.47,293,1707
10000,53,8874.0,1631,86.55,1126,8874
20000,53,17751.0,2367,126.52,2249,17751
40000,53,35671.0,2551,137.2,4329,35671
60000,53,53641.0,2610,142.2,6359,53641
80000,53,71553.0,2819,151.7,8447,71553
10000,53,8874.0,1631,86.55,1126,8874
2,54,2.0,1,0.05,0,2
3,54,3.0,2,0.14,0,3
100,54,89.0,65,4.42,11,89
200,54,176.0,134,8.58,24,176
2000,54,1740.0,880,56.0,260,1740
10000,54,8779.0,1928,113.86,1221,8779
20000,54,17723.0,2342,133.29,2277,17723
40000,54,35495.0,2905,162.27,4505,35495
60000,54,53393.0,3054,169.98,6607,53393
80000,54,71265.0,3435,192.47,8735,71265
10000,54,8779.0,1928,113.86,1221,8779
2,55,2.0,1,0.05,0,2
3,55,2.0,2,0.14,1,2
100,55,90.0,66,4.57,10,90
200,55,176.0,126,8.57,24,176
2000,55,1735.0,796,49.47,265,1735
10000,55,8817.0,1464,85.78,1183,8817
20000,55,17734.0,1764,101.58,2266,17734
40000,55,35589.0,1935,110.63,4411,35589
60000,55,53469.0,2053,117.64,6531,53469
80000,55,71354.0,2069,118.51,8646,71354
10000,55,8817.0,1464,85.78,1183,8817
2,56,2.0,1,0.05,0,2
3,56,2.0,2,0.14,1,2
100,56,82.0,65,4.37,18,82
200,56,165.0,126,8.22,35,165
2000,56,1743.0,639,40.56,257,1743
10000,56,8869.0,1261,79.5,1131,8869
20000,56,17804.0,1433,91.24,2196,17804
40000,56,35625.0,2009,120.56,4375,35625
60000,56,53496.0,2164,128.08,6504,53496
80000,56,71431.0,2790,162.75,8569,71431
10000,56,8869.0,1261,79.5,1131,8869
2,57,2.0,1,0.05,0,2
3,57,3.0,2,0.14,0,3
100,57,85.0,64,4.43,15,85
200,57,168.0,124,8.58,32,168
2000,57,1733.0,853,54.44,267,1733
10000,57,8878.0,1578,98.11,1122,8878
20000,57,17782.0,2063,125.29,2218,17782
40000,57,35655.0,2288,138.61,4345,35655
60000,57,53545.0,2490,148.95,6455,53545
80000,57,71406.0,2612,156.29,8594,71406
10000,57,8878.0,1578,98.11,1122,8878
2,58,2.0,1,0.05,0,2
3,58,3.0,2,0.14,0,3
100,58,84.0,66,4.57,16,84
200,58,173.0,128,8.96,27,173
2000,58,1747.0,837,51.07,253,1747
10000,58,8892.0,1726,103.22,1108,8892
20000,58,17879.0,2198,128.36,2121,17879
40000,58,35728.0,3021,170.54,4272,35728
60000,58,53688.0,3087,174.56,6312,53688
80000,58,71521.0,3220,182.5,8479,71521
10000,58,8892.0,1726,103.22,1108,8892
2,59,1.0,1,0.05,1,1
3,59,2.0,2,0.14,1,2
100,59,79.0,63,4.13,21,79
200,59,169.0,118,7.71,31,169
2000,59,1754.0,609,36.61,246,1754
10000,59,8848.0,1408,79.66,1152,8848
20000,59,17724.0,1811,104.0,2276,17724
40000,59,35540.0,2094,117.98,4460,35540
60000,59,53347.0,2217,126.17,6653,53347
80000,59,71241.0,2321,131.0,8759,71241
10000,59,8848.0,1408,79.66,1152,8848
2,60,2.0,1,0.05,0,2
3,60,3.0,2,0.14,0,3
100,60,84.0,61,4.14,16,84
200,60,172.0,111,7.59,28,172
2000,60,1739.0,792,50.24,261,1739
10000,60,8840.0,2077,121.82,1160,8840
20000,60,17815.0,2403,147.94,2185,17815
40000,60,35645.0,2818,175.41,4355,35645
60000,60,53436.0,3611,214.79,6564,53436
80000,60,71290.0,3644,217.23,8710,71290
10000,60,8840.0,2077,121.82,1160,8840
2,61,2.0,1,0.05,0,2
3,61,3.0,2,0.14,0,3
100,61,91.0,64,4.43,9,91
200,61,171.0,121,8.09,29,171
2000,61,1747.0,691,43.6,253,1747
10000,61,8878.0,1283,78.64,1122,8878
20000,61,17818.0,1736,106.77,2182,17818
40000,61,35631.0,2463,144.13,4369,35631
60000,61,53495.0,2583,150.08,6505,53495
80000,61,71361.0,2766,159.92,8639,71361
10000,61,8878.0,1283,78.64,1122,8878
2,62,2.0,1,0.05,0,2
3,62,3.0,2,0.14,0,3
100,62,83.0,60,4.0,17,83
200,62,169.0,113,7.33,31,169
2000,62,1734.0,765,43.63,266,1734
10000,62,8800.0,1738,97.46,1200,8800
20000,62,17677.0,2005,110.48,2323,17677
40000,62,35585.0,2474,134.08,4415,35585
60000,62,53452.0,2542,138.69,6548,53452
80000,62,71384.0,2552,139.29,8616,71384
10000,62,8800.0,1738,97.46,1200,8800
2,63,2.0,1,0.05,0,2
3,63,3.0,2,0.14,0,3
100,63,87.0,60,4.2,13,87
200,63,175.0,116,8.02,25,175
2000,63,1726.0,940,60.5,274,1726
10000,63,8812.0,2280,129.95,1188,8812
20000,63,17739.0,2668,152.36,2261,17739
40000,63,35637.0,2871,163.69,4363,35637
60000,63,53607.0,2927,167.26,6393,53607
80000,63,71509.0,2976,171.47,8491,71509
10000,63,8812.0,2280,129.95,1188,8812
2,64,2.0,1,0.05,0,2
3,64,3.0,2,0.14,0,3
100,64,83.0,65,4.37,17,83
200,64,169.0,124,8.33,31,169
2000,64,1741.0,997,61.62,259,1741
10000,64,8883.0,1949,115.06,1117,8883
20000,64,17796.0,2288,133.51,2204,17796
40000,64,35654.0,2823,162.28,4346,35654
60000,64,53516.0,2973,170.53,6484,53516
80000,64,71387.0,3053,174.43,8613,71387
10000,64,8883.0,1949,115.06,1117,8883
2,65,1.0,1,0.05,1,1
3,65,2.0,2,0.14,1,2
100,65,86.0,58,3.96,14,86
200,65,169.0,119,8.25,31,169
2000,65,1721.0,972,62.04,279,1721
10000,65,8792.0,1669,105.06,1208,8792
20000,65,17705.0,1998,124.96,2295,17705
40000,65,35591.0,2229,139.9,4409,35591
60000,65,53515.0,2282,143.94,6485,53515
80000,65,71390.0,2394,149.18,8610,71390
10000,65,8792.0,1669,105.06,1208,8792
2,66,2.0,1,0.05,0,2
3,66,2.0,2,0.14,1,2
100,66,87.0,61,4.19,13,87
200,66,170.0,120,8.05,30,170
2000,66,1748.0,891,57.95,252,1748
10000,66,8862.0,1649,105.16,1138,8862
20000,66,17757.0,2056,128.82,2243,17757
40000,66,35648.0,2290,146.7,4352,35648
60000,66,53460.0,2553,165.68,6540,53460
80000,66,71337.0,2655,171.02,8663,71337
10000,66,8862.0,1649,105.16,1138,8862
2,67,2.0,1,0.05,0,2
3,67,2.0,2,0.14,1,2
100,67,87.0,66,4.57,13,87
200,67,168.0,141,9.54,32,168
2000,67,1744.0,936,56.87,256,1744
10000,67,8851.0,1791,107.55,1149,8851
20000,67,17776.0,2296,135.82,2224,17776
40000,67,35663.0,2534,149.33,4337,35663
60000,67,53547.0,2674,156.43,6453,53547
80000,67,71462.0,2780,162.45,8538,71462
10000,67,8851.0,1791,107.55,1149,8851
2,68,1.0,1,0.05,1,1
3,68,2.0,2,0.14,1,2
100,68,82.0,72,4.74,18,82
200,68,170.0,141,9.44,30,170
2000,68,1749.0,987,62.12,251,1749
10000,68,8850.0,2028,120.36,1150,8850
20000,68,17768.0,2526,146.87,2232,17768
40000,68,35681.0,2817,165.56,4319,35681
60000,68,53601.0,2879,168.9,6399,53601
80000,68,71542.0,2955,172.87,8458,71542
10000,68,8850.0,2028,120.36,1150,8850
2,69,2.0,1,0.05,0,2
3,69,3.0,2,0.14,0,3
100,69,84.0,68,4.76,16,84
200,69,173.0,133,9.03,27,173
2000,69,1711.0,951,60.65,289,1711
10000,69,8870.0,1887,114.37,1130,8870
20000,69,17775.0,2259,134.41,2225,17775
40000,69,35615.0,3071,173.24,4385,35615
60000,69,53483.0,3215,184.12,6517,53483
80000,69,71427.0,3231,185.04,8573,71427
10000,69,8870.0,1887,114.37,1130,8870
2,70,2.0,1,0.05,0,2
3,70,3.0,2,0.14,0,3
100,70,84.0,69,4.9,16,84
200,70,170.0,133,9.28,30,170
2000,70,1724.0,824,49.98,276,1724
10000,70,8834.0,1912,110.19,1166,8834
20000,70,17751.0,2206,127.22,2249,17751
40000,70,35665.0,2404,137.88,4335,35665
60000,70,53567.0,2626,148.42,6433,53567
80000,70,71421.0,2694,153.13,8579,71421
10000,70,8834.0,1912,110.19,1166,8834
2,71,2.0,1,0.05,0,2
3,71,3.0,2,0.14,0,3
100,71,86.0,63,4.28,14,86
200,71,172.0,123,8.18,28,172
2000,71,1733.0,908,54.91,267,1733
10000,71,8852.0,1646,96.22,1148,8852
20000,71,17797.0,1963,113.14,2203,17797
40000,71,35695.0,2261,133.55,4305,35695
60000,71,53511.0,2623,153.48,6489,53511
80000,71,71353.0,2685,156.72,8647,71353
10000,71,8852.0,1646,96.22,1148,8852
2,72,2.0,1,0.05,0,2
3,72,3.0,2,0.14,0,3
100,72,83.0,60,4.15,17,83
200,72,166.0,115,7.47,34,166
2000,72,1752.0,882,54.14,248,1752
10000,72,8827.0,2074,122.03,1173,8827
20000,72,17788.0,2477,141.11,2212,17788
40000,72,35592.0,2908,164.16,4408,35592
60000,72,53372.0,3164,178.63,6628,53372
80000,72,71229.0,3349,190.6,8771,71229
10000,72,8827.0,2074,122.03,1173,8827
2,73,1.0,1,0.05,1,1
3,73,2.0,2,0.14,1,2
100,73,84.0,69,5.05,16,84
200,73,169.0,131,9.49,31,169
2000,73,1728.0,880,55.1,272,1728
10000,73,8798.0,1722,108.19,1202,8798
20000,73,17704.0,2075,127.58,2296,17704
40000,73,35594.0,2223,139.59,4406,35594
60000,73,53461.0,2344,145.68,6539,53461
80000,73,71337.0,2424,149.48,8663,71337
10000,73,8798.0,1722,108.19,1202,8798
2,74,1.0,1,0.05,1,1
3,74,2.0,2,0.14,1,2
100,74,82.0,65,4.52,18,82
200,74,171.0,125,8.42,29,171
2000,74,1732.0,946,57.07,268,1732
10000,74,8783.0,2222,125.44,1217,8783
20000,74,17721.0,2387,135.47,2279,17721
40000,74,35587.0,2790,165.85,4413,35587
60000,74,53511.0,2959,175.1,6489,53511
80000,74,71404.0,3256,188.82,8596,71404
10000,74,8783.0,2222,125.44,1217,8783
2,75,2.0,1,0.05,0,2
3,75,3.0,2,0.14,0,3
100,75,89.0,65,4.42,11,89
200,75,180.0,120,7.9,20,180
2000,75,1749.0,918,54.56,251,1749
10000,75,8840.0,2129,122.61,1160,8840
20000,75,17803.0,2270,131.2,2197,17803
40000,75,35753.0,2685,153.87,4247,35753
60000,75,53744.0,2811,162.39,6256,53744
80000,75,71642.0,3036,176.32,8358,71642
10000,75,8840.0,2129,122.61,1160,8840
2,76,2.0,1,0.05,0,2
3,76,3.0,2,0.14,0,3
100,76,85.0,64,4.43,15,85
200,76,176.0,133,9.28,24,176
2000,76,1729.0,938,62.31,271,1729
10000,76,8779.0,2176,135.47,1221,8779
20000,76,17714.0,2343,146.48,2286,17714
40000,76,35652.0,2496,154.52,4348,35652
60000,76,53565.0,2590,160.25,6435,53565
80000,76,71450.0,2695,168.17,8550,71450
10000,76,8779.0,2176,135.47,1221,8779
2,77,2.0,1,0.05,0,2
3,77,3.0,2,0.14,0,3
100,77,82.0,64,4.48,18,82
200,77,159.0,122,8.44,41,159
2000,77,1729.0,1005,62.33,271,1729
10000,77,8802.0,2092,126.89,1198,8802
20000,77,17795.0,2264,137.13,2205,17795
40000,77,35714.0,2873,166.73,4286,35714
60000,77,53601.0,3005,173.97,6399,53601
80000,77,71469.0,3150,181.1,8531,71469
10000,77,8802.0,2092,126.89,1198,8802
2,78,1.0,1,0.05,1,1
3,78,2.0,2,0.14,1,2
100,78,83.0,60,4.15,17,83
200,78,163.0,113,7.78,37,163
2000,78,1738.0,831,50.8,262,1738
10000,78,8866.0,1745,103.98,1134,8866
20000,78,17831.0,2011,117.3,2169,17831
40000,78,35692.0,2381,136.35,4308,35692
60000,78,53561.0,2809,156.25,6439,53561
80000,78,71460.0,3023,166.78,8540,71460
10000,78,8866.0,1745,103.98,1134,8866
2,79,2.0,1,0.05,0,2
3,79,3.0,2,0.14,0,3
100,79,86.0,63,4.38,14,86
200,79,175.0,126,8.82,25,175
2000,79,1746.0,681,43.6,254,1746
10000,79,8863.0,1521,91.9,1137,8863
20000,79,17781.0,1699,102.11,2219,17781
40000,79,35752.0,1944,116.83,4248,35752
60000,79,53662.0,2116,126.17,6338,53662
80000,79,71525.0,2480,143.25,8475,71525
10000,79,8863.0,1521,91.9,1137,8863
2,80,2.0,1,0.05,0,2
3,80,3.0,2,0.14,0,3
100,80,87.0,62,4.14,13,87
200,80,166.0,111,7.64,34,166
2000,80,1724.0,812,51.89,276,1724
10000,80,8794.0,1424,90.68,1206,8794
20000,80,17783.0,1535,97.98,2217,17783
40000,80,35628.0,1792,114.54,4372,35628
60000,80,53493.0,2132,130.79,6507,53493
80000,80,71421.0,2226,135.12,8579,71421
10000,80,8794.0,1424,90.68,1206,8794
2,81,1.0,1,0.05,1,1
3,81,1.0,2,0.14,2,1
100,81,81.0,70,4.8,19,81
200,81,162.0,131,8.84,38,162
2000,81,1737.0,874,54.53,263,1737
10000,81,8764.0,1609,97.86,1236,8764
20000,81,17703.0,2178,127.56,2297,17703
40000,81,35551.0,2520,150.8,4449,35551
60000,81,53497.0,2562,153.54,6503,53497
80000,81,71381.0,2596,155.37,8619,71381
10000,81,8764.0,1609,97.86,1236,8764
2,82,2.0,1,0.05,0,2
3,82,3.0,2,0.14,0,3
100,82,85.0,67,4.61,15,85
200,82,170.0,133,9.28,30,170
2000,82,1765.0,766,48.37,235,1765
10000,82,8872.0,2076,119.62,1128,8872
20000,82,17801.0,2386,137.82,2199,17801
40000,82,35658.0,2863,161.68,4342,35658
60000,82,53555.0,2960,168.0,6445,53555
80000,82,71507.0,3041,172.14,8493,71507
10000,82,8872.0,2076,119.62,1128,8872
2,83,2.0,1,0.05,0,2
3,83,2.0,2,0.14,1,2
100,83,87.0,58,4.21,13,87
200,83,172.0,107,7.36,28,172
2000,83,1767.0,655,42.13,233,1767
10000,83,8791.0,2073,125.64,1209,8791
20000,83,17682.0,3044,172.43,2318,17682
40000,83,35550.0,3600,198.7,4450,35550
60000,83,53330.0,4289,231.35,6670,53330
80000,83,71213.0,4355,235.92,8787,71213
10000,83,8791.0,2073,125.64,1209,8791
2,84,2.0,1,0.05,0,2
3,84,3.0,2,0.14,0,3
100,84,85.0,65,4.42,15,85
200,84,165.0,121,8.19,35,165
2000,84,1709.0,1012,58.54,291,1709
10000,84,8861.0,1662,94.69,1139,8861
20000,84,17817.0,1825,103.08,2183,17817
40000,84,35696.0,2285,125.68,4304,35696
60000,84,53559.0,2459,134.51,6441,53559
80000,84,71425.0,2591,141.99,8575,71425
10000,84,8861.0,1662,94.69,1139,8861
2,85,2.0,1,0.05,0,2
3,85,3.0,2,0.14,0,3
100,85,89.0,65,4.52,11,89
200,85,173.0,129,9.0,27,173
2000,85,1745.0,1073,67.34,255,1745
10000,85,8883.0,2233,132.44,1117,8883
20000,85,17741.0,2490,149.75,2259,17741
40000,85,35581.0,2698,162.66,4419,35581
60000,85,53496.0,2738,165.51,6504,53496
80000,85,71361.0,3099,185.6,8639,71361
10000,85,8883.0,2233,132.44,1117,8883
2,86,2.0,1,0.05,0,2
3,86,3.0,2,0.14,0,3
100,86,82.0,58,4.26,18,82
200,86,164.0,104,7.28,36,164
2000,86,1737.0,847,49.32,263,1737
10000,86,8849.0,1573,94.14,1151,8849
20000,86,17782.0,2034,120.73,2218,17782
40000,86,35694.0,2279,134.86,4306,35694
60000,86,53570.0,2436,142.42,6430,53570
80000,86,71398.0,2549,149.35,8602,71398
10000,86,8849.0,1573,94.14,1151,8849
2,87,2.0,1,0.05,0,2
3,87,3.0,2,0.14,0,3
100,87,81.0,68,4.81,19,81
200,87,167.0,133,9.28,33,167
2000,87,1718.0,1072,69.54,282,1718
10000,87,8811.0,1850,113.05,1189,8811
20000,87,17765.0,2201,134.2,2235,17765
40000,87,35642.0,2575,155.82,4358,35642
60000,87,53489.0,3023,179.88,6511,53489
80000,87,71386.0,3285,194.47,8614,71386
10000,87,8811.0,1850,113.05,1189,8811
2,88,2.0,1,0.05,0,2
3,88,2.0,2,0.14,1,2
100,88,86.0,63,4.18,14,86
200,88,171.0,132,8.49,29,171
2000,88,1752.0,851,55.95,248,1752
10000,88,8816.0,2045,125.28,1184,8816
20000,88,17730.0,2545,151.72,2270,17730
40000,88,35664.0,2823,167.18,4336,35664
60000,88,53605.0,2967,176.71,6395,53605
80000,88,71566.0,3069,182.65,8434,71566
10000,88,8816.0,2045,125.28,1184,8816
2,89,2.0,1,0.05,0,2
3,89,3.0,2,0.14,0,3
100,89,86.0,65,4.52,14,86
200,89,172.0,121,8.44,28,172
2000,89,1727.0,862,53.24,273,1727
10000,89,8835.0,1385,83.83,1165,8835
20000,89,17795.0,1556,95.62,2205,17795
40000,89,35649.0,1687,105.57,4351,35649
60000,89,53536.0,2143,129.04,6464,53536
80000,89,71444.0,2239,133.46,8556,71444
10000,89,8835.0,1385,83.83,1165,8835
2,90,2.0,1,0.05,0,2
3,90,2.0,2,0.14,1,2
100,90,84.0,63,4.13,16,84
200,90,166.0,126,8.42,34,166
2000,90,1713.0,1038,66.26,287,1713
10000,90,8801.0,2098,131.86,1199,8801
20000,90,17743.0,2646,159.32,2257,17743
40000,90,35650.0,3280,189.55,4350,35650
60000,90,53507.0,3739,212.15,6493,53507
80000,90,71431.0,3785,214.42,8569,71431
10000,90,8801.0,2098,131.86,1199,8801
2,91,1.0,1,0.05,1,1
3,91,2.0,2,0.14,1,2
100,91,84.0,61,3.99,16,84
200,91,174.0,112,7.09,26,174
2000,91,1733.0,795,47.68,267,1733
10000,91,8841.0,2309,122.36,1159,8841
20000,91,17851.0,2426,128.92,2149,17851
40000,91,35713.0,2730,145.05,4287,35713
60000,91,53633.0,2836,150.67,6367,53633
80000,91,71511.0,2988,161.11,8489,71511
10000,91,8841.0,2309,122.36,1159,8841
2,92,1.0,1,0.05,1,1
3,92,2.0,2,0.14,1,2
100,92,87.0,65,4.62,13,87
200,92,169.0,137,9.41,31,169
2000,92,1732.0,886,59.82,268,1732
10000,92,8842.0,1966,121.92,1158,8842
20000,92,17836.0,2121,130.4,2164,17836
40000,92,35782.0,2283,140.93,4218,35782
60000,92,53662.0,2567,157.36,6338,53662
80000,92,71542.0,2680,163.25,8458,71542
10000,92,8842.0,1966,121.92,1158,8842
2,93,2.0,1,0.05,0,2
3,93,3.0,2,0.14,0,3
100,93,84.0,66,4.87,16,84
200,93,171.0,111,7.54,29,171
2000,93,1737.0,857,52.97,263,1737
10000,93,8904.0,1431,86.9,1096,8904
20000,93,17796.0,1728,104.06,2204,17796
40000,93,35646.0,2088,122.86,4354,35646
60000,93,53443.0,2182,128.79,6557,53443
80000,93,71355.0,2280,135.85,8645,71355
10000,93,8904.0,1431,86.9,1096,8904
2,94,1.0,1,0.05,1,1
3,94,2.0,2,0.14,1,2
100,94,80.0,68,4.66,20,80
200,94,162.0,129,9.15,38,162
2000,94,1743.0,604,40.83,257,1743
10000,94,8809.0,1628,99.56,1191,8809
20000,94,17680.0,1952,123.39,2320,17680
40000,94,35597.0,2001,126.5,4403,35597
60000,94,53453.0,2113,134.29,6547,53453
80000,94,71331.0,2139,135.71,8669,71331
10000,94,8809.0,1628,99.56,1191,8809
2,95,2.0,1,0.05,0,2
3,95,3.0,2,0.14,0,3
100,95,86.0,62,4.39,14,86
200,95,168.0,124,8.68,32,168
2000,95,1731.0,813,52.74,269,1731
10000,95,8872.0,1822,107.89,1128,8872
20000,95,17775.0,2297,136.27,2225,17775
40000,95,35644.0,2732,160.39,4356,35644
60000,95,53504.0,2902,168.89,6496,53504
80000,95,71397.0,3222,183.44,8603,71397
10000,95,8872.0,1822,107.89,1128,8872
2,96,2.0,1,0.05,0,2
3,96,3.0,2,0.14,0,3
100,96,89.0,63,4.48,11,89
200,96,175.0,115,7.77,25,175
2000,96,1727.0,907,61.37,273,1727
10000,96,8844.0,2132,124.99,1156,8844
20000,96,17704.0,2599,148.75,2296,17704
40000,96,35570.0,2934,174.38,4430,35570
60000,96,53523.0,2972,177.14,6477,53523
80000,96,71499.0,2996,178.92,8501,71499
10000,96,8844.0,2132,124.99,1156,8844
2,97,2.0,1,0.05,0,2
3,97,3.0,2,0.14,0,3
100,97,86.0,68,4.81,14,86
200,97,172.0,137,9.56,28,172
2000,97,1719.0,959,62.91,281,1719
10000,97,8854.0,1629,102.01,1146,8854
20000,97,17781.0,2189,134.41,2219,17781
40000,97,35606.0,2936,171.47,4394,35606
60000,97,53571.0,2987,174.91,6429,53571
80000,97,71407.0,3160,188.9,8593,71407
10000,97,8854.0,1629,102.01,1146,8854
2,98,1.0,1,0.05,1,1
3,98,2.0,2,0.14,1,2
100,98,85.0,60,4.2,15,85
200,98,176.0,109,7.35,24,176
2000,98,1759.0,671,42.55,241,1759
10000,98,8884.0,1401,85.8,1116,8884
20000,98,17826.0,1975,119.88,2174,17826
40000,98,35686.0,2523,146.28,4314,35686
60000,98,53578.0,2605,151.02,6422,53578
80000,98,71515.0,2712,156.49,8485,71515
10000,98,8884.0,1401,85.8,1116,8884
2,99,2.0,1,0.05,0,2
3,99,3.0,2,0.14,0,3
100,99,89.0,60,4.45,11,89
200,99,175.0,111,8.04,25,175
2000,99,1713.0,972,58.99,287,1713
10000,99,8838.0,1621,96.75,1162,8838
20000,99,17791.0,1925,111.43,2209,17791
40000,99,35620.0,2311,136.65,4380,35620
60000,99,53446.0,2474,149.73,6554,53446
80000,99,71400.0,2488,150.61,8600,71400
10000,99,8838.0,1621,96.75,1162,8838
2,100,2.0,1,0.05,0,2
3,100,3.0,2,0.14,0,3
100,100,83.0,60,4.15,17,83
200,100,164.0,105,7.12,36,164
2000,100,1760.0,646,44.72,240,1760
10000,100,8862.0,1412,88.14,1138,8862
20000,100,17799.0,1860,112.3,2201,17799
40000,100,35689.0,2307,135.52,4311,35689
60000,100,53611.0,2355,138.33,6389,53611
80000,100,71449.0,2644,153.03,8551,71449
10000,100,8862.0,1412,88.14,1138,8862
