Timestep,Iteration,Total Reward,Suboptimal Arms,Total Regret,Zeros Count,Ones Count
2,1,2.0,2,0.06,0,2
3,1,2.0,2,0.06,1,2
100,1,88.0,67,1.99,12,88
200,1,174.0,135,3.99,26,174
2000,1,1732.0,1280,36.92,268,1732
10000,1,8864.0,6039,160.23,1136,8864
20000,1,17692.0,11912,312.44,2308,17692
40000,1,35485.0,22498,562.58,4515,35485
60000,1,53309.0,32803,773.43,6691,53309
80000,1,71072.0,42297,971.29,8928,71072
10000,1,8864.0,6039,160.23,1136,8864
2,2,2.0,2,0.06,0,2
3,2,3.0,2,0.06,0,3
100,2,89.0,68,2.12,11,89
200,2,175.0,132,4.08,25,175
2000,2,1763.0,1275,37.31,237,1763
10000,2,8805.0,6127,165.51,1195,8805
20000,2,17666.0,12016,305.0,2334,17666
40000,2,35399.0,23477,575.29,4601,35399
60000,2,53228.0,33571,798.35,6772,53228
80000,2,70993.0,43461,1018.37,9007,70993
10000,2,8805.0,6127,165.51,1195,8805
2,3,2.0,2,0.06,0,2
3,3,3.0,2,0.06,0,3
100,3,88.0,67,2.03,12,88
200,3,171.0,131,3.83,29,171
2000,3,1738.0,1299,36.35,262,1738
10000,3,8815.0,6339,166.03,1185,8815
20000,3,17635.0,12160,316.28,2365,17635
40000,3,35388.0,23435,564.99,4612,35388
60000,3,53185.0,33397,777.17,6815,53185
80000,3,71014.0,42884,963.64,8986,71014
10000,3,8815.0,6339,166.03,1185,8815
2,4,2.0,2,0.06,0,2
3,4,3.0,2,0.06,0,3
100,4,88.0,67,1.99,12,88
200,4,182.0,132,3.92,18,182
2000,4,1746.0,1280,36.28,254,1746
10000,4,8782.0,6173,163.05,1218,8782
20000,4,17652.0,11937,309.81,2348,17652
40000,4,35512.0,22041,536.49,4488,35512
60000,4,53229.0,32024,757.88,6771,53229
80000,4,71062.0,42397,983.77,8938,71062
10000,4,8782.0,6173,163.05,1218,8782
2,5,2.0,2,0.06,0,2
3,5,3.0,2,0.06,0,3
100,5,88.0,67,1.99,12,88
200,5,176.0,135,3.99,24,176
2000,5,1778.0,1326,38.9,222,1778
10000,5,8844.0,6288,171.28,1156,8844
20000,5,17668.0,12419,328.11,2332,17668
40000,5,35434.0,23368,574.76,4566,35434
60000,5,53221.0,34341,804.77,6779,53221
80000,5,71030.0,44410,998.9,8970,71030
10000,5,8844.0,6288,171.28,1156,8844
2,6,2.0,2,0.06,0,2
3,6,3.0,2,0.06,0,3
100,6,88.0,67,1.95,12,88
200,6,176.0,135,3.87,24,176
2000,6,1761.0,1283,36.47,239,1761
10000,6,8832.0,6190,166.22,1168,8832
20000,6,17746.0,11924,304.84,2254,17746
40000,6,35504.0,22438,551.02,4496,35504
60000,6,53365.0,32186,766.3,6635,53365
80000,6,71114.0,41844,970.44,8886,71114
10000,6,8832.0,6190,166.22,1168,8832
2,7,2.0,2,0.06,0,2
3,7,3.0,2,0.06,0,3
100,7,88.0,68,1.96,12,88
200,7,174.0,136,3.96,26,174
2000,7,1769.0,1330,37.1,231,1769
10000,7,8873.0,6243,167.47,1127,8873
20000,7,17747.0,11928,306.12,2253,17747
40000,7,35519.0,23113,551.37,4481,35519
60000,7,53387.0,33186,757.26,6613,53387
80000,7,71201.0,42329,946.13,8799,71201
10000,7,8873.0,6243,167.47,1127,8873
2,8,1.0,2,0.06,1,1
3,8,2.0,2,0.06,1,2
100,8,85.0,65,1.89,15,85
200,8,175.0,131,3.71,25,175
2000,8,1797.0,1310,36.34,203,1797
10000,8,8872.0,6309,161.93,1128,8872
20000,8,17724.0,12318,310.54,2276,17724
40000,8,35544.0,22961,551.33,4456,35544
60000,8,53310.0,33593,773.61,6690,53310
80000,8,71072.0,43237,974.25,8928,71072
10000,8,8872.0,6309,161.93,1128,8872
2,9,2.0,2,0.06,0,2
3,9,3.0,2,0.06,0,3
100,9,83.0,67,1.99,17,83
200,9,171.0,134,3.98,29,171
2000,9,1749.0,1251,34.35,251,1749
10000,9,8819.0,6115,163.39,1181,8819
20000,9,17721.0,11770,302.94,2279,17721
40000,9,35481.0,22799,544.63,4519,35481
60000,9,53277.0,33294,764.02,6723,53277
80000,9,71067.0,42785,956.69,8933,71067
10000,9,8819.0,6115,163.39,1181,8819
2,10,2.0,2,0.06,0,2
3,10,3.0,2,0.06,0,3
100,10,90.0,66,1.98,10,90
200,10,180.0,131,3.91,20,180
2000,10,1794.0,1306,37.46,206,1794
10000,10,8880.0,6378,174.94,1120,8880
20000,10,17757.0,12352,319.52,2243,17757
40000,10,35530.0,23109,560.85,4470,35530
60000,10,53383.0,33558,780.1,6617,53383
80000,10,71189.0,43239,991.23,8811,71189
10000,10,8880.0,6378,174.94,1120,8880
2,11,1.0,2,0.06,1,1
3,11,2.0,2,0.06,1,2
100,11,87.0,66,1.94,13,87
200,11,175.0,133,3.89,25,175
2000,11,1769.0,1291,37.15,231,1769
10000,11,8838.0,6447,169.87,1162,8838
20000,11,17713.0,12275,313.19,2287,17713
40000,11,35455.0,23662,571.22,4545,35455
60000,11,53343.0,32901,777.81,6657,53343
80000,11,71106.0,42525,972.73,8894,71106
10000,11,8838.0,6447,169.87,1162,8838
2,12,2.0,2,0.06,0,2
3,12,3.0,2,0.06,0,3
100,12,91.0,67,1.99,9,91
200,12,174.0,131,3.83,26,174
2000,12,1762.0,1281,36.41,238,1762
10000,12,8818.0,5903,161.83,1182,8818
20000,12,17656.0,11746,302.46,2344,17656
40000,12,35345.0,22535,558.79,4655,35345
60000,12,53089.0,32846,780.74,6911,53089
80000,12,70893.0,41969,984.29,9107,70893
10000,12,8818.0,5903,161.83,1182,8818
2,13,1.0,2,0.06,1,1
3,13,1.0,2,0.06,2,1
100,13,81.0,66,1.94,19,81
200,13,166.0,136,3.92,34,166
2000,13,1766.0,1263,35.35,234,1766
10000,13,8816.0,5999,161.87,1184,8816
20000,13,17690.0,11696,308.36,2310,17690
40000,13,35450.0,22594,549.34,4550,35450
60000,13,53263.0,33144,789.64,6737,53263
80000,13,71009.0,43427,987.51,8991,71009
10000,13,8816.0,5999,161.87,1184,8816
2,14,2.0,2,0.06,0,2
3,14,3.0,2,0.06,0,3
100,14,88.0,67,1.95,12,88
200,14,178.0,134,3.74,22,178
2000,14,1782.0,1255,34.19,218,1782
10000,14,8815.0,6108,162.2,1185,8815
20000,14,17747.0,11863,305.39,2253,17747
40000,14,35532.0,22745,576.57,4468,35532
60000,14,53200.0,33967,823.55,6800,53200
80000,14,70941.0,43668,1032.16,9059,70941
10000,14,8815.0,6108,162.2,1185,8815
2,15,2.0,2,0.06,0,2
3,15,3.0,2,0.06,0,3
100,15,86.0,65,1.89,14,86
200,15,176.0,129,3.73,24,176
2000,15,1790.0,1270,35.86,210,1790
10000,15,8893.0,6181,158.17,1107,8893
20000,15,17734.0,12139,313.43,2266,17734
40000,15,35371.0,23018,570.58,4629,35371
60000,15,53216.0,32975,781.31,6784,53216
80000,15,70994.0,43704,999.88,9006,70994
10000,15,8893.0,6181,158.17,1107,8893
2,16,1.0,2,0.06,1,1
3,16,1.0,2,0.06,2,1
100,16,84.0,66,1.94,16,84
200,16,162.0,132,3.84,38,162
2000,16,1736.0,1248,35.64,264,1736
10000,16,8842.0,6039,165.71,1158,8842
20000,16,17704.0,11728,309.28,2296,17704
40000,16,35485.0,22692,575.68,4515,35485
60000,16,53226.0,33605,821.01,6774,53226
80000,16,71096.0,43098,995.18,8904,71096
10000,16,8842.0,6039,165.71,1158,8842
2,17,2.0,2,0.06,0,2
3,17,2.0,2,0.06,1,2
100,17,86.0,66,1.86,14,86
200,17,173.0,134,3.74,27,173
2000,17,1757.0,1282,36.1,243,1757
10000,17,8856.0,6129,163.29,1144,8856
20000,17,17704.0,11904,309.96,2296,17704
40000,17,35457.0,22999,583.47,4543,35457
60000,17,53307.0,32740,797.28,6693,53307
80000,17,71134.0,42586,998.22,8866,71134
10000,17,8856.0,6129,163.29,1144,8856
2,18,1.0,2,0.06,1,1
3,18,2.0,2,0.06,1,2
100,18,90.0,65,1.97,10,90
200,18,173.0,131,3.91,27,173
2000,18,1767.0,1285,37.65,233,1767
10000,18,8885.0,6183,163.27,1115,8885
20000,18,17736.0,11855,307.03,2264,17736
40000,18,35452.0,22527,567.59,4548,35452
60000,18,53122.0,32154,801.26,6878,53122
80000,18,70954.0,41945,1009.61,9046,70954
10000,18,8885.0,6183,163.27,1115,8885
2,19,1.0,2,0.06,1,1
3,19,2.0,2,0.06,1,2
100,19,90.0,66,1.94,10,90
200,19,175.0,130,3.7,25,175
2000,19,1772.0,1281,35.81,228,1772
10000,19,8863.0,6192,159.96,1137,8863
20000,19,17765.0,11829,299.29,2235,17765
40000,19,35478.0,22845,541.49,4522,35478
60000,19,53218.0,34259,785.15,6782,53218
80000,19,71010.0,44806,997.62,8990,71010
10000,19,8863.0,6192,159.96,1137,8863
2,20,2.0,2,0.06,0,2
3,20,3.0,2,0.06,0,3
100,20,88.0,66,1.94,12,88
200,20,180.0,133,3.89,20,180
2000,20,1783.0,1290,35.9,217,1783
10000,20,8818.0,6124,161.04,1182,8818
20000,20,17734.0,11783,312.27,2266,17734
40000,20,35447.0,22492,568.72,4553,35447
60000,20,53235.0,32870,792.46,6765,53235
80000,20,70983.0,42661,998.01,9017,70983
10000,20,8818.0,6124,161.04,1182,8818
2,21,2.0,2,0.06,0,2
3,21,2.0,2,0.06,1,2
100,21,90.0,67,1.99,10,90
200,21,175.0,134,3.94,25,175
2000,21,1757.0,1256,35.84,243,1757
10000,21,8927.0,5872,162.28,1073,8927
20000,21,17792.0,11589,305.17,2208,17792
40000,21,35505.0,22106,553.62,4495,35505
60000,21,53299.0,31941,777.21,6701,53299
80000,21,71121.0,40883,959.87,8879,71121
10000,21,8927.0,5872,162.28,1073,8927
2,22,2.0,2,0.06,0,2
3,22,3.0,2,0.06,0,3
100,22,84.0,64,1.92,16,84
200,22,178.0,128,3.8,22,178
2000,22,1786.0,1257,35.73,214,1786
10000,22,8942.0,6112,166.2,1058,8942
20000,22,17787.0,11809,304.89,2213,17787
40000,22,35566.0,22637,549.37,4434,35566
60000,22,53318.0,33497,777.73,6682,53318
80000,22,71150.0,42930,973.54,8850,71150
10000,22,8942.0,6112,166.2,1058,8942
2,23,2.0,2,0.06,0,2
3,23,3.0,2,0.06,0,3
100,23,89.0,67,1.95,11,89
200,23,178.0,133,3.85,22,178
2000,23,1791.0,1288,35.96,209,1791
10000,23,8904.0,6205,172.13,1096,8904
20000,23,17733.0,11976,325.0,2267,17733
40000,23,35506.0,22464,587.36,4494,35506
60000,23,53285.0,32055,803.11,6715,53285
80000,23,71124.0,42111,1017.19,8876,71124
10000,23,8904.0,6205,172.13,1096,8904
2,24,1.0,2,0.06,1,1
3,24,2.0,2,0.06,1,2
100,24,87.0,65,1.89,13,87
200,24,178.0,132,3.92,22,178
2000,24,1782.0,1281,36.21,218,1782
10000,24,8847.0,6066,166.86,1153,8847
20000,24,17776.0,12044,307.52,2224,17776
40000,24,35514.0,23140,575.68,4486,35514
60000,24,53244.0,33866,809.66,6756,53244
80000,24,71046.0,43264,1005.0,8954,71046
10000,24,8847.0,6066,166.86,1153,8847
2,25,2.0,2,0.06,0,2
3,25,3.0,2,0.06,0,3
100,25,89.0,66,1.98,11,89
200,25,176.0,134,4.02,24,176
2000,25,1778.0,1283,37.23,222,1778
10000,25,8849.0,6177,173.21,1151,8849
20000,25,17662.0,11773,326.57,2338,17662
40000,25,35438.0,22658,591.54,4562,35438
60000,25,53212.0,33311,830.71,6788,53212
80000,25,71017.0,44359,1056.63,8983,71017
10000,25,8849.0,6177,173.21,1151,8849
2,26,2.0,2,0.06,0,2
3,26,3.0,2,0.06,0,3
100,26,89.0,67,2.03,11,89
200,26,182.0,131,3.91,18,182
2000,26,1780.0,1259,35.19,220,1780
10000,26,8827.0,5935,159.35,1173,8827
20000,26,17651.0,11574,294.86,2349,17651
40000,26,35449.0,22847,549.27,4551,35449
60000,26,53229.0,32875,751.35,6771,53229
80000,26,71010.0,43327,963.15,8990,71010
10000,26,8827.0,5935,159.35,1173,8827
2,27,2.0,2,0.06,0,2
3,27,2.0,2,0.06,1,2
100,27,82.0,67,1.95,18,82
200,27,165.0,134,3.78,35,165
2000,27,1759.0,1326,38.58,241,1759
10000,27,8788.0,6304,177.36,1212,8788
20000,27,17639.0,12301,326.57,2361,17639
40000,27,35347.0,23905,603.97,4653,35347
60000,27,53153.0,34353,847.33,6847,53153
80000,27,70912.0,44612,1047.32,9088,70912
10000,27,8788.0,6304,177.36,1212,8788
2,28,2.0,2,0.06,0,2
3,28,3.0,2,0.06,0,3
100,28,82.0,65,2.05,18,82
200,28,168.0,127,3.79,32,168
2000,28,1740.0,1304,35.8,260,1740
10000,28,8782.0,6256,159.4,1218,8782
20000,28,17604.0,12116,297.6,2396,17604
40000,28,35291.0,23694,565.78,4709,35291
60000,28,53072.0,34107,788.63,6928,53072
80000,28,70846.0,44441,1005.49,9154,70846
10000,28,8782.0,6256,159.4,1218,8782
2,29,2.0,2,0.06,0,2
3,29,3.0,2,0.06,0,3
100,29,88.0,67,2.03,12,88
200,29,174.0,133,4.09,26,174
2000,29,1734.0,1333,37.13,266,1734
10000,29,8800.0,6125,160.45,1200,8800
20000,29,17711.0,11864,299.08,2289,17711
40000,29,35419.0,22112,542.76,4581,35419
60000,29,53121.0,32674,781.14,6879,53121
80000,29,70913.0,41728,969.76,9087,70913
10000,29,8800.0,6125,160.45,1200,8800
2,30,2.0,2,0.06,0,2
3,30,3.0,2,0.06,0,3
100,30,87.0,66,1.94,13,87
200,30,173.0,131,3.87,27,173
2000,30,1769.0,1286,34.74,231,1769
10000,30,8875.0,6406,166.58,1125,8875
20000,30,17740.0,12423,316.11,2260,17740
40000,30,35507.0,23572,578.08,4493,35507
60000,30,53265.0,34751,828.83,6735,53265
80000,30,71041.0,44178,1017.42,8959,71041
10000,30,8875.0,6406,166.58,1125,8875
2,31,2.0,2,0.06,0,2
3,31,3.0,2,0.06,0,3
100,31,90.0,69,2.05,10,90
200,31,178.0,132,3.88,22,178
2000,31,1766.0,1263,35.87,234,1766
10000,31,8893.0,6074,160.98,1107,8893
20000,31,17777.0,11763,305.39,2223,17777
40000,31,35482.0,23044,556.32,4518,35482
60000,31,53255.0,33707,785.47,6745,53255
80000,31,70998.0,43235,1005.91,9002,70998
10000,31,8893.0,6074,160.98,1107,8893
2,32,2.0,2,0.06,0,2
3,32,3.0,2,0.06,0,3
100,32,94.0,67,2.03,6,94
200,32,184.0,133,4.09,16,184
2000,32,1753.0,1304,38.16,247,1753
10000,32,8812.0,6322,181.14,1188,8812
20000,32,17714.0,12183,330.79,2286,17714
40000,32,35442.0,23072,585.6,4558,35442
60000,32,53260.0,33938,827.1,6740,53260
80000,32,71032.0,44109,1045.09,8968,71032
10000,32,8812.0,6322,181.14,1188,8812
2,33,2.0,2,0.06,0,2
3,33,3.0,2,0.06,0,3
100,33,88.0,65,1.97,12,88
200,33,180.0,127,3.87,20,180
2000,33,1786.0,1289,36.69,214,1786
10000,33,8868.0,6082,157.9,1132,8868
20000,33,17667.0,11924,295.36,2333,17667
40000,33,35429.0,23235,549.07,4571,35429
60000,33,53125.0,33826,781.74,6875,53125
80000,33,70873.0,44067,992.99,9127,70873
10000,33,8868.0,6082,157.9,1132,8868
2,34,2.0,2,0.06,0,2
3,34,3.0,2,0.06,0,3
100,34,84.0,68,2.04,16,84
200,34,168.0,138,4.1,32,168
2000,34,1753.0,1313,38.97,247,1753
10000,34,8878.0,6347,179.63,1122,8878
20000,34,17741.0,12042,329.54,2259,17741
40000,34,35507.0,23059,588.47,4493,35507
60000,34,53225.0,33553,817.01,6775,53225
80000,34,70952.0,43885,1031.93,9048,70952
10000,34,8878.0,6347,179.63,1122,8878
2,35,1.0,2,0.06,1,1
3,35,2.0,2,0.06,1,2
100,35,87.0,66,1.94,13,87
200,35,174.0,132,3.84,26,174
2000,35,1785.0,1252,35.64,215,1785
10000,35,8798.0,6098,166.7,1202,8798
20000,35,17651.0,12242,306.86,2349,17651
40000,35,35380.0,23129,560.09,4620,35380
60000,35,53219.0,33715,768.75,6781,53219
80000,35,71044.0,43245,948.33,8956,71044
10000,35,8798.0,6098,166.7,1202,8798
2,36,1.0,2,0.06,1,1
3,36,2.0,2,0.06,1,2
100,36,87.0,67,1.95,13,87
200,36,165.0,133,3.89,35,165
2000,36,1750.0,1287,35.51,250,1750
10000,36,8790.0,6137,166.49,1210,8790
20000,36,17684.0,12000,314.76,2316,17684
40000,36,35417.0,23045,567.41,4583,35417
60000,36,53193.0,32966,776.62,6807,53193
80000,36,71082.0,43149,973.61,8918,71082
10000,36,8790.0,6137,166.49,1210,8790
2,37,2.0,2,0.06,0,2
3,37,3.0,2,0.06,0,3
100,37,89.0,66,1.98,11,89
200,37,178.0,132,3.96,22,178
2000,37,1743.0,1295,37.07,257,1743
10000,37,8859.0,6303,163.35,1141,8859
20000,37,17723.0,12280,310.2,2277,17723
40000,37,35526.0,23267,573.83,4474,35526
60000,37,53343.0,34220,812.84,6657,53343
80000,37,71173.0,44345,1028.49,8827,71173
10000,37,8859.0,6303,163.35,1141,8859
2,38,2.0,2,0.06,0,2
3,38,3.0,2,0.06,0,3
100,38,87.0,66,1.94,13,87
200,38,174.0,131,3.83,26,174
2000,38,1759.0,1324,38.4,241,1759
10000,38,8858.0,6099,171.71,1142,8858
20000,38,17673.0,11536,304.92,2327,17673
40000,38,35421.0,22139,544.63,4579,35421
60000,38,53203.0,32073,755.17,6797,53203
80000,38,70989.0,41603,962.39,9011,70989
10000,38,8858.0,6099,171.71,1142,8858
2,39,2.0,2,0.06,0,2
3,39,3.0,2,0.06,0,3
100,39,85.0,68,1.96,15,85
200,39,176.0,135,3.91,24,176
2000,39,1751.0,1324,37.04,249,1751
10000,39,8800.0,6164,165.72,1200,8800
20000,39,17633.0,12110,317.58,2367,17633
40000,39,35397.0,23105,571.89,4603,35397
60000,39,53142.0,33819,794.15,6858,53142
80000,39,70972.0,44673,1005.21,9028,70972
10000,39,8800.0,6164,165.72,1200,8800
2,40,2.0,2,0.06,0,2
3,40,2.0,2,0.06,1,2
100,40,89.0,67,1.99,11,89
200,40,176.0,133,3.93,24,176
2000,40,1775.0,1279,36.27,225,1775
10000,40,8874.0,6167,166.63,1126,8874
20000,40,17755.0,11989,307.85,2245,17755
40000,40,35541.0,22709,544.73,4459,35541
60000,40,53253.0,33115,763.31,6747,53253
80000,40,71081.0,43257,968.21,8919,71081
10000,40,8874.0,6167,166.63,1126,8874
2,41,2.0,2,0.06,0,2
3,41,3.0,2,0.06,0,3
100,41,88.0,65,1.89,12,88
200,41,175.0,129,3.73,25,175
2000,41,1772.0,1308,36.04,228,1772
10000,41,8873.0,6227,170.75,1127,8873
20000,41,17705.0,12243,328.99,2295,17705
40000,41,35421.0,23008,592.2,4579,35421
60000,41,53173.0,33265,823.01,6827,53173
80000,41,70951.0,43470,1049.42,9049,70951
10000,41,8873.0,6227,170.75,1127,8873
2,42,0.0,2,0.06,2,0
3,42,1.0,2,0.06,2,1
100,42,85.0,65,1.93,15,85
200,42,175.0,128,3.68,25,175
2000,42,1776.0,1262,35.74,224,1776
10000,42,8840.0,6044,162.68,1160,8840
20000,42,17717.0,11566,299.66,2283,17717
40000,42,35495.0,22228,541.52,4505,35495
60000,42,53224.0,33045,771.17,6776,53224
80000,42,71060.0,42840,982.16,8940,71060
10000,42,8840.0,6044,162.68,1160,8840
2,43,2.0,2,0.06,0,2
3,43,2.0,2,0.06,1,2
100,43,91.0,68,2.0,9,91
200,43,177.0,134,3.9,23,177
2000,43,1776.0,1292,36.28,224,1776
10000,43,8824.0,6115,167.03,1176,8824
20000,43,17659.0,12206,314.3,2341,17659
40000,43,35517.0,22965,561.45,4483,35517
60000,43,53264.0,33640,798.68,6736,53264
80000,43,71040.0,43922,1015.18,8960,71040
10000,43,8824.0,6115,167.03,1176,8824
2,44,2.0,2,0.06,0,2
3,44,3.0,2,0.06,0,3
100,44,88.0,65,1.93,12,88
200,44,180.0,131,3.95,20,180
2000,44,1784.0,1263,36.51,216,1784
10000,44,8844.0,6062,164.26,1156,8844
20000,44,17658.0,11860,304.72,2342,17658
40000,44,35418.0,23009,568.81,4582,35418
60000,44,53188.0,33386,794.26,6812,53188
80000,44,70894.0,43438,1002.94,9106,70894
10000,44,8844.0,6062,164.26,1156,8844
2,45,2.0,2,0.06,0,2
3,45,3.0,2,0.06,0,3
100,45,91.0,66,1.9,9,91
200,45,178.0,131,3.67,22,178
2000,45,1792.0,1290,35.66,208,1792
10000,45,8888.0,6193,163.33,1112,8888
20000,45,17708.0,11926,303.78,2292,17708
40000,45,35277.0,23172,583.4,4723,35277
60000,45,53064.0,33428,803.72,6936,53064
80000,45,70902.0,44090,1026.5,9098,70902
10000,45,8888.0,6193,163.33,1112,8888
2,46,2.0,2,0.06,0,2
3,46,3.0,2,0.06,0,3
100,46,88.0,66,2.06,12,88
200,46,171.0,131,4.03,29,171
2000,46,1755.0,1250,36.66,245,1755
10000,46,8827.0,6230,170.74,1173,8827
20000,46,17664.0,12131,305.59,2336,17664
40000,46,35388.0,23199,560.71,4612,35388
60000,46,53206.0,33712,767.0,6794,53206
80000,46,71077.0,43114,953.54,8923,71077
10000,46,8827.0,6230,170.74,1173,8827
2,47,2.0,2,0.06,0,2
3,47,3.0,2,0.06,0,3
100,47,93.0,67,2.03,7,93
200,47,183.0,133,4.01,17,183
2000,47,1758.0,1278,37.1,242,1758
10000,47,8881.0,6185,167.57,1119,8881
20000,47,17732.0,11893,313.85,2268,17732
40000,47,35436.0,23036,561.32,4564,35436
60000,47,53146.0,33629,795.05,6854,53146
80000,47,70917.0,43236,993.76,9083,70917
10000,47,8881.0,6185,167.57,1119,8881
2,48,2.0,2,0.06,0,2
3,48,3.0,2,0.06,0,3
100,48,95.0,65,1.85,5,95
200,48,180.0,131,3.79,20,180
2000,48,1765.0,1274,37.18,235,1765
10000,48,8841.0,6322,173.78,1159,8841
20000,48,17677.0,12294,324.94,2323,17677
40000,48,35459.0,23475,571.71,4541,35459
60000,48,53238.0,34085,807.37,6762,53238
80000,48,71020.0,43451,1000.91,8980,71020
10000,48,8841.0,6322,173.78,1159,8841
2,49,1.0,2,0.06,1,1
3,49,2.0,2,0.06,1,2
100,49,84.0,64,1.8,16,84
200,49,180.0,130,3.74,20,180
2000,49,1772.0,1273,36.49,228,1772
10000,49,8887.0,6195,169.23,1113,8887
20000,49,17785.0,12074,317.06,2215,17785
40000,49,35589.0,22719,563.55,4411,35589
60000,49,53432.0,32792,773.0,6568,53432
80000,49,71197.0,43337,1005.61,8803,71197
10000,49,8887.0,6195,169.23,1113,8887
2,50,0.0,2,0.06,2,0
3,50,1.0,2,0.06,2,1
100,50,82.0,67,2.03,18,82
200,50,169.0,133,3.97,31,169
2000,50,1750.0,1300,37.4,250,1750
10000,50,8846.0,6236,159.92,1154,8846
20000,50,17750.0,11828,292.56,2250,17750
40000,50,35529.0,22858,539.82,4471,35529
60000,50,53382.0,33647,761.35,6618,53382
80000,50,71196.0,43856,950.24,8804,71196
10000,50,8846.0,6236,159.92,1154,8846
2,51,2.0,2,0.06,0,2
3,51,3.0,2,0.06,0,3
100,51,87.0,66,1.9,13,87
200,51,174.0,134,3.9,26,174
2000,51,1748.0,1285,36.65,252,1748
10000,51,8841.0,5868,159.76,1159,8841
20000,51,17722.0,11342,300.1,2278,17722
40000,51,35452.0,21751,537.07,4548,35452
60000,51,53322.0,31915,749.75,6678,53322
80000,51,71078.0,41201,951.77,8922,71078
10000,51,8841.0,5868,159.76,1159,8841
2,52,2.0,2,0.06,0,2
3,52,3.0,2,0.06,0,3
100,52,88.0,66,1.9,12,88
200,52,178.0,129,3.73,22,178
2000,52,1783.0,1266,35.58,217,1783
10000,52,8849.0,6064,166.68,1151,8849
20000,52,17761.0,11993,315.69,2239,17761
40000,52,35545.0,22915,568.23,4455,35545
60000,52,53310.0,33657,795.17,6690,53310
80000,52,71111.0,43892,1007.24,8889,71111
10000,52,8849.0,6064,166.68,1151,8849
2,53,2.0,2,0.06,0,2
3,53,3.0,2,0.06,0,3
100,53,89.0,66,1.94,11,89
200,53,173.0,133,3.97,27,173
2000,53,1790.0,1275,35.15,210,1790
10000,53,8839.0,5985,159.09,1161,8839
20000,53,17637.0,11779,306.43,2363,17637
40000,53,35460.0,23669,570.77,4540,35460
60000,53,53275.0,34771,789.23,6725,53275
80000,53,71067.0,44930,1009.5,8933,71067
10000,53,8839.0,5985,159.09,1161,8839
2,54,2.0,2,0.06,0,2
3,54,3.0,2,0.06,0,3
100,54,88.0,67,1.95,12,88
200,54,179.0,133,3.93,21,179
2000,54,1761.0,1313,37.53,239,1761
10000,54,8828.0,6200,168.16,1172,8828
20000,54,17622.0,12114,315.7,2378,17622
40000,54,35388.0,22726,549.14,4612,35388
60000,54,53224.0,32606,769.46,6776,53224
80000,54,70980.0,42415,973.59,9020,70980
10000,54,8828.0,6200,168.16,1172,8828
2,55,2.0,2,0.06,0,2
3,55,3.0,2,0.06,0,3
100,55,90.0,66,2.02,10,90
200,55,180.0,134,4.06,20,180
2000,55,1775.0,1345,39.13,225,1775
10000,55,8848.0,6282,174.86,1152,8848
20000,55,17679.0,12374,316.94,2321,17679
40000,55,35429.0,23514,595.98,4571,35429
60000,55,53282.0,33986,812.06,6718,53282
80000,55,71083.0,44081,1011.81,8917,71083
10000,55,8848.0,6282,174.86,1152,8848
2,56,2.0,2,0.06,0,2
3,56,3.0,2,0.06,0,3
100,56,88.0,67,2.03,12,88
200,56,174.0,136,4.04,26,174
2000,56,1764.0,1309,37.29,236,1764
10000,56,8880.0,6039,163.87,1120,8880
20000,56,17780.0,11838,311.98,2220,17780
40000,56,35490.0,23035,576.31,4510,35490
60000,56,53205.0,33230,812.46,6795,53205
80000,56,71009.0,42961,1017.45,8991,71009
10000,56,8880.0,6039,163.87,1120,8880
2,57,2.0,2,0.06,0,2
3,57,3.0,2,0.06,0,3
100,57,84.0,65,1.93,16,84
200,57,165.0,132,3.8,35,165
2000,57,1768.0,1330,37.98,232,1768
10000,57,8852.0,6040,163.56,1148,8852
20000,57,17674.0,11852,309.12,2326,17674
40000,57,35368.0,22600,550.0,4632,35368
60000,57,53124.0,32661,769.89,6876,53124
80000,57,70944.0,42523,986.35,9056,70944
10000,57,8852.0,6040,163.56,1148,8852
2,58,2.0,2,0.06,0,2
3,58,3.0,2,0.06,0,3
100,58,89.0,66,1.98,11,89
200,58,175.0,133,3.97,25,175
2000,58,1749.0,1296,36.08,251,1749
10000,58,8798.0,6062,166.26,1202,8798
20000,58,17634.0,11889,309.33,2366,17634
40000,58,35451.0,22770,555.22,4549,35451
60000,58,53237.0,32679,755.83,6763,53237
80000,58,71042.0,42993,976.89,8958,71042
10000,58,8798.0,6062,166.26,1202,8798
2,59,2.0,2,0.06,0,2
3,59,2.0,2,0.06,1,2
100,59,85.0,67,1.99,15,85
200,59,173.0,132,4.0,27,173
2000,59,1763.0,1268,35.64,237,1763
10000,59,8819.0,6220,166.36,1181,8819
20000,59,17579.0,11827,313.47,2421,17579
40000,59,35313.0,23149,583.37,4687,35313
60000,59,53081.0,33640,798.84,6919,53081
80000,59,70798.0,43508,990.36,9202,70798
10000,59,8819.0,6220,166.36,1181,8819
2,60,2.0,2,0.06,0,2
3,60,3.0,2,0.06,0,3
100,60,88.0,65,1.97,12,88
200,60,175.0,129,3.81,25,175
2000,60,1753.0,1237,36.21,247,1753
10000,60,8841.0,6066,167.3,1159,8841
20000,60,17680.0,11802,316.34,2320,17680
40000,60,35520.0,22147,550.83,4480,35520
60000,60,53337.0,32581,776.73,6663,53337
80000,60,71112.0,42435,985.75,8888,71112
10000,60,8841.0,6066,167.3,1159,8841
2,61,1.0,2,0.06,1,1
3,61,1.0,2,0.06,2,1
100,61,80.0,67,2.03,20,80
200,61,173.0,131,3.87,27,173
2000,61,1776.0,1341,38.25,224,1776
10000,61,8821.0,6304,172.68,1179,8821
20000,61,17682.0,12169,323.77,2318,17682
40000,61,35464.0,23625,567.89,4536,35464
60000,61,53285.0,35191,795.71,6715,53285
80000,61,71037.0,44868,987.88,8963,71037
10000,61,8821.0,6304,172.68,1179,8821
2,62,1.0,2,0.06,1,1
3,62,2.0,2,0.06,1,2
100,62,83.0,65,1.97,17,83
200,62,170.0,126,3.82,30,170
2000,62,1769.0,1236,35.84,231,1769
10000,62,8837.0,6043,166.23,1163,8837
20000,62,17703.0,11571,302.07,2297,17703
40000,62,35388.0,21626,537.02,4612,35388
60000,62,53205.0,31121,749.49,6795,53205
80000,62,71106.0,40618,928.02,8894,71106
10000,62,8837.0,6043,166.23,1163,8837
2,63,2.0,2,0.06,0,2
3,63,3.0,2,0.06,0,3
100,63,87.0,68,2.0,13,87
200,63,176.0,135,3.99,24,176
2000,63,1737.0,1273,36.45,263,1737
10000,63,8784.0,6214,161.78,1216,8784
20000,63,17621.0,12230,310.22,2379,17621
40000,63,35379.0,23398,564.9,4621,35379
60000,63,53205.0,33817,785.73,6795,53205
80000,63,71049.0,43074,980.82,8951,71049
10000,63,8784.0,6214,161.78,1216,8784
2,64,0.0,2,0.06,2,0
3,64,1.0,2,0.06,2,1
100,64,83.0,65,1.89,17,83
200,64,171.0,132,3.8,29,171
2000,64,1749.0,1317,37.65,251,1749
10000,64,8783.0,6362,175.22,1217,8783
20000,64,17642.0,12288,322.68,2358,17642
40000,64,35357.0,24101,594.49,4643,35357
60000,64,53172.0,34718,840.42,6828,53172
80000,64,70950.0,43854,1026.38,9050,70950
10000,64,8783.0,6362,175.22,1217,8783
2,65,2.0,2,0.06,0,2
3,65,3.0,2,0.06,0,3
100,65,90.0,67,2.03,10,90
200,65,177.0,127,3.75,23,177
2000,65,1781.0,1249,35.21,219,1781
10000,65,8854.0,6065,162.73,1146,8854
20000,65,17697.0,11567,307.03,2303,17697
40000,65,35449.0,22464,563.32,4551,35449
60000,65,53215.0,33140,776.2,6785,53215
80000,65,70986.0,43302,965.7,9014,70986
10000,65,8854.0,6065,162.73,1146,8854
2,66,1.0,2,0.06,1,1
3,66,2.0,2,0.06,1,2
100,66,83.0,65,1.97,17,83
200,66,168.0,133,3.93,32,168
2000,66,1746.0,1233,36.09,254,1746
10000,66,8871.0,6077,163.41,1129,8871
20000,66,17784.0,11806,305.78,2216,17784
40000,66,35562.0,22199,548.15,4438,35562
60000,66,53408.0,31893,770.49,6592,53408
80000,66,71217.0,41927,971.23,8783,71217
10000,66,8871.0,6077,163.41,1129,8871
2,67,2.0,2,0.06,0,2
3,67,3.0,2,0.06,0,3
100,67,90.0,68,2.0,10,90
200,67,179.0,135,3.91,21,179
2000,67,1772.0,1260,37.24,228,1772
10000,67,8823.0,6070,167.34,1177,8823
20000,67,17661.0,12008,312.68,2339,17661
40000,67,35378.0,22731,564.47,4622,35378
60000,67,53147.0,32922,789.46,6853,53147
80000,67,70893.0,43629,1009.97,9107,70893
10000,67,8823.0,6070,167.34,1177,8823
2,68,2.0,2,0.06,0,2
3,68,3.0,2,0.06,0,3
100,68,93.0,68,2.0,7,93
200,68,180.0,134,3.98,20,180
2000,68,1759.0,1273,36.09,241,1759
10000,68,8819.0,6037,161.33,1181,8819
20000,68,17714.0,11421,302.37,2286,17714
40000,68,35410.0,21762,535.14,4590,35410
60000,68,53149.0,32111,742.75,6851,53149
80000,68,70972.0,42119,934.11,9028,70972
10000,68,8819.0,6037,161.33,1181,8819
2,69,2.0,2,0.06,0,2
3,69,2.0,2,0.06,1,2
100,69,87.0,66,1.9,13,87
200,69,173.0,131,3.91,27,173
2000,69,1740.0,1267,37.03,260,1740
10000,69,8812.0,6126,166.98,1188,8812
20000,69,17665.0,12027,310.71,2335,17665
40000,69,35488.0,23063,562.11,4512,35488
60000,69,53181.0,33768,803.84,6819,53181
80000,69,70918.0,42717,997.37,9082,70918
10000,69,8812.0,6126,166.98,1188,8812
2,70,1.0,2,0.06,1,1
3,70,2.0,2,0.06,1,2
100,70,85.0,65,1.93,15,85
200,70,175.0,130,3.86,25,175
2000,70,1753.0,1261,36.17,247,1753
10000,70,8823.0,6030,160.1,1177,8823
20000,70,17591.0,11883,301.55,2409,17591
40000,70,35354.0,22861,552.93,4646,35354
60000,70,53195.0,32396,772.88,6805,53195
80000,70,70974.0,42140,990.76,9026,70974
10000,70,8823.0,6030,160.1,1177,8823
2,71,2.0,2,0.06,0,2
3,71,3.0,2,0.06,0,3
100,71,92.0,67,2.03,8,92
200,71,181.0,133,3.97,19,181
2000,71,1768.0,1305,37.81,232,1768
10000,71,8832.0,6063,168.19,1168,8832
20000,71,17713.0,11898,308.06,2287,17713
40000,71,35446.0,22739,545.55,4554,35446
60000,71,53156.0,33567,779.43,6844,53156
80000,71,70957.0,44147,993.47,9043,70957
10000,71,8832.0,6063,168.19,1168,8832
2,72,1.0,2,0.06,1,1
3,72,2.0,2,0.06,1,2
100,72,83.0,65,1.89,17,83
200,72,171.0,128,3.76,29,171
2000,72,1760.0,1315,38.75,240,1760
10000,72,8826.0,6180,165.12,1174,8826
20000,72,17682.0,12003,299.27,2318,17682
40000,72,35385.0,22919,560.95,4615,35385
60000,72,53266.0,33033,783.89,6734,53266
80000,72,71065.0,42473,977.45,8935,71065
10000,72,8826.0,6180,165.12,1174,8826
2,73,1.0,2,0.06,1,1
3,73,2.0,2,0.06,1,2
100,73,88.0,65,1.93,12,88
200,73,180.0,130,3.86,20,180
2000,73,1758.0,1283,36.23,242,1758
10000,73,8829.0,6042,163.94,1171,8829
20000,73,17689.0,11896,306.96,2311,17689
40000,73,35474.0,22651,565.95,4526,35474
60000,73,53218.0,33036,802.6,6782,53218
80000,73,71017.0,43109,1020.85,8983,71017
10000,73,8829.0,6042,163.94,1171,8829
2,74,1.0,2,0.06,1,1
3,74,2.0,2,0.06,1,2
100,74,87.0,67,1.99,13,87
200,74,179.0,135,3.99,21,179
2000,74,1771.0,1312,36.16,229,1771
10000,74,8870.0,5981,160.17,1130,8870
20000,74,17749.0,11711,300.63,2251,17749
40000,74,35538.0,23159,561.43,4462,35538
60000,74,53332.0,32580,775.84,6668,53332
80000,74,71061.0,42764,995.16,8939,71061
10000,74,8870.0,5981,160.17,1130,8870
2,75,1.0,2,0.06,1,1
3,75,2.0,2,0.06,1,2
100,75,87.0,66,1.94,13,87
200,75,173.0,131,3.87,27,173
2000,75,1761.0,1248,36.08,239,1761
10000,75,8820.0,6148,172.04,1180,8820
20000,75,17738.0,12128,309.64,2262,17738
40000,75,35464.0,23251,573.99,4536,35464
60000,75,53207.0,33280,797.76,6793,53207
80000,75,70983.0,43015,1001.79,9017,70983
10000,75,8820.0,6148,172.04,1180,8820
2,76,2.0,2,0.06,0,2
3,76,3.0,2,0.06,0,3
100,76,92.0,66,1.94,8,92
200,76,185.0,131,3.83,15,185
2000,76,1783.0,1265,36.17,217,1783
10000,76,8804.0,6172,168.4,1196,8804
20000,76,17659.0,11911,308.27,2341,17659
40000,76,35359.0,23230,577.54,4641,35359
60000,76,53115.0,33244,817.96,6885,53115
80000,76,70896.0,43800,1032.28,9104,70896
10000,76,8804.0,6172,168.4,1196,8804
2,77,2.0,2,0.06,0,2
3,77,3.0,2,0.06,0,3
100,77,91.0,66,1.98,9,91
200,77,180.0,131,3.95,20,180
2000,77,1776.0,1298,37.54,224,1776
10000,77,8837.0,6221,173.25,1163,8837
20000,77,17719.0,11818,312.42,2281,17719
40000,77,35551.0,22453,562.65,4449,35551
60000,77,53384.0,32569,788.25,6616,53384
80000,77,71227.0,41565,973.73,8773,71227
10000,77,8837.0,6221,173.25,1163,8837
2,78,2.0,2,0.06,0,2
3,78,3.0,2,0.06,0,3
100,78,84.0,67,1.99,16,84
200,78,173.0,132,3.96,27,173
2000,78,1758.0,1314,36.46,242,1758
10000,78,8861.0,6366,172.94,1139,8861
20000,78,17720.0,12463,331.39,2280,17720
40000,78,35473.0,23201,587.77,4527,35473
60000,78,53226.0,34312,834.4,6774,53226
80000,78,71133.0,43985,1040.45,8867,71133
10000,78,8861.0,6366,172.94,1139,8861
2,79,2.0,2,0.06,0,2
3,79,3.0,2,0.06,0,3
100,79,91.0,67,1.95,9,91
200,79,174.0,134,3.94,26,174
2000,79,1756.0,1292,36.96,244,1756
10000,79,8798.0,6125,169.81,1202,8798
20000,79,17622.0,11958,312.06,2378,17622
40000,79,35385.0,23871,605.23,4615,35385
60000,79,53148.0,34348,838.16,6852,53148
80000,79,70993.0,44568,1055.84,9007,70993
10000,79,8798.0,6125,169.81,1202,8798
2,80,2.0,2,0.06,0,2
3,80,3.0,2,0.06,0,3
100,80,87.0,66,1.94,13,87
200,80,177.0,131,3.95,23,177
2000,80,1778.0,1271,35.83,222,1778
10000,80,8857.0,5986,158.98,1143,8857
20000,80,17720.0,11640,302.36,2280,17720
40000,80,35401.0,22397,546.97,4599,35401
60000,80,53225.0,32981,752.37,6775,53225
80000,80,70974.0,42291,948.95,9026,70974
10000,80,8857.0,5986,158.98,1143,8857
2,81,1.0,2,0.06,1,1
3,81,2.0,2,0.06,1,2
100,81,85.0,67,1.99,15,85
200,81,169.0,134,4.02,31,169
2000,81,1756.0,1324,37.84,244,1756
10000,81,8862.0,5934,157.38,1138,8862
20000,81,17636.0,11735,304.99,2364,17636
40000,81,35391.0,22980,569.36,4609,35391
60000,81,53142.0,32650,782.94,6858,53142
80000,81,70937.0,43631,985.95,9063,70937
10000,81,8862.0,5934,157.38,1138,8862
2,82,1.0,2,0.06,1,1
3,82,1.0,2,0.06,2,1
100,82,81.0,67,1.99,19,81
200,82,169.0,129,3.61,31,169
2000,82,1766.0,1247,33.43,234,1766
10000,82,8849.0,6143,158.43,1151,8849
20000,82,17684.0,11890,301.46,2316,17684
40000,82,35464.0,22908,559.24,4536,35464
60000,82,53227.0,33773,806.05,6773,53227
80000,82,71056.0,43338,987.82,8944,71056
10000,82,8849.0,6143,158.43,1151,8849
2,83,1.0,2,0.06,1,1
3,83,2.0,2,0.06,1,2
100,83,85.0,67,1.99,15,85
200,83,174.0,134,4.1,26,174
2000,83,1766.0,1270,37.58,234,1766
10000,83,8846.0,6064,165.24,1154,8846
20000,83,17716.0,11643,307.47,2284,17716
40000,83,35509.0,22749,560.05,4491,35509
60000,83,53254.0,33031,781.59,6746,53254
80000,83,71039.0,42925,984.09,8961,71039
10000,83,8846.0,6064,165.24,1154,8846
2,84,1.0,2,0.06,1,1
3,84,2.0,2,0.06,1,2
100,84,82.0,67,2.03,18,82
200,84,171.0,131,3.95,29,171
2000,84,1757.0,1286,36.58,243,1757
10000,84,8791.0,6170,162.18,1209,8791
20000,84,17642.0,11815,298.31,2358,17642
40000,84,35361.0,22719,563.95,4639,35361
60000,84,53157.0,32397,767.45,6843,53157
80000,84,70949.0,42247,959.15,9051,70949
10000,84,8791.0,6170,162.18,1209,8791
2,85,2.0,2,0.06,0,2
3,85,3.0,2,0.06,0,3
100,85,90.0,67,2.03,10,90
200,85,175.0,131,3.91,25,175
2000,85,1740.0,1279,34.87,260,1740
10000,85,8861.0,6020,158.6,1139,8861
20000,85,17739.0,11876,306.36,2261,17739
40000,85,35489.0,22576,583.0,4511,35489
60000,85,53252.0,32832,829.72,6748,53252
80000,85,70986.0,43422,1056.9,9014,70986
10000,85,8861.0,6020,158.6,1139,8861
2,86,2.0,2,0.06,0,2
3,86,3.0,2,0.06,0,3
100,86,88.0,68,2.0,12,88
200,86,172.0,138,4.06,28,172
2000,86,1740.0,1348,37.8,260,1740
10000,86,8801.0,6379,170.75,1199,8801
20000,86,17649.0,12106,311.82,2351,17649
40000,86,35422.0,22819,549.83,4578,35422
60000,86,53183.0,33933,784.93,6817,53183
80000,86,70999.0,43528,972.96,9001,70999
10000,86,8801.0,6379,170.75,1199,8801
2,87,2.0,2,0.06,0,2
3,87,3.0,2,0.06,0,3
100,87,90.0,67,1.99,10,90
200,87,181.0,132,3.8,19,181
2000,87,1760.0,1339,37.95,240,1760
10000,87,8794.0,6308,167.08,1206,8794
20000,87,17679.0,11990,316.42,2321,17679
40000,87,35376.0,22672,580.72,4624,35376
60000,87,53156.0,32958,805.34,6844,53156
80000,87,70945.0,41966,996.78,9055,70945
10000,87,8794.0,6308,167.08,1206,8794
2,88,2.0,2,0.06,0,2
3,88,3.0,2,0.06,0,3
100,88,87.0,65,1.93,13,87
200,88,173.0,132,3.88,27,173
2000,88,1765.0,1270,36.7,235,1765
10000,88,8801.0,6150,166.94,1199,8801
20000,88,17686.0,12320,318.36,2314,17686
40000,88,35419.0,23692,579.76,4581,35419
60000,88,53182.0,33490,807.26,6818,53182
80000,88,70917.0,42621,993.29,9083,70917
10000,88,8801.0,6150,166.94,1199,8801
2,89,2.0,2,0.06,0,2
3,89,3.0,2,0.06,0,3
100,89,86.0,66,1.94,14,86
200,89,172.0,134,3.9,28,172
2000,89,1760.0,1288,37.96,240,1760
10000,89,8843.0,6248,171.64,1157,8843
20000,89,17687.0,12461,327.37,2313,17687
40000,89,35457.0,23792,602.28,4543,35457
60000,89,53177.0,34179,822.19,6823,53177
80000,89,70838.0,43611,1047.43,9162,70838
10000,89,8843.0,6248,171.64,1157,8843
2,90,2.0,2,0.06,0,2
3,90,3.0,2,0.06,0,3
100,90,84.0,65,2.05,16,84
200,90,171.0,128,3.92,29,171
2000,90,1760.0,1294,37.46,240,1760
10000,90,8804.0,6205,166.41,1196,8804
20000,90,17635.0,11754,303.5,2365,17635
40000,90,35362.0,22683,543.23,4638,35362
60000,90,53097.0,33958,778.26,6903,53097
80000,90,71017.0,42966,975.18,8983,71017
10000,90,8804.0,6205,166.41,1196,8804
2,91,2.0,2,0.06,0,2
3,91,3.0,2,0.06,0,3
100,91,91.0,68,2.08,9,91
200,91,180.0,134,4.02,20,180
2000,91,1784.0,1291,38.11,216,1784
10000,91,8838.0,6173,164.49,1162,8838
20000,91,17707.0,11991,303.11,2293,17707
40000,91,35432.0,22929,530.65,4568,35432
60000,91,53215.0,33525,769.17,6785,53215
80000,91,71013.0,43796,974.92,8987,71013
10000,91,8838.0,6173,164.49,1162,8838
2,92,2.0,2,0.06,0,2
3,92,3.0,2,0.06,0,3
100,92,81.0,65,1.89,19,81
200,92,170.0,130,3.9,30,170
2000,92,1749.0,1324,37.16,251,1749
10000,92,8846.0,6278,162.58,1154,8846
20000,92,17647.0,12020,310.56,2353,17647
40000,92,35414.0,23208,578.44,4586,35414
60000,92,53217.0,33209,794.21,6783,53217
80000,92,71089.0,43200,994.68,8911,71089
10000,92,8846.0,6278,162.58,1154,8846
2,93,1.0,2,0.06,1,1
3,93,2.0,2,0.06,1,2
100,93,85.0,67,1.99,15,85
200,93,169.0,136,4.04,31,169
2000,93,1779.0,1305,36.73,221,1779
10000,93,8841.0,6330,169.78,1159,8841
20000,93,17686.0,12020,309.88,2314,17686
40000,93,35527.0,23053,562.17,4473,35527
60000,93,53294.0,33347,775.35,6706,53294
80000,93,71153.0,43488,982.32,8847,71153
10000,93,8841.0,6330,169.78,1159,8841
2,94,1.0,2,0.06,1,1
3,94,2.0,2,0.06,1,2
100,94,83.0,67,1.99,17,83
200,94,172.0,136,4.04,28,172
2000,94,1747.0,1357,38.69,253,1747
10000,94,8836.0,6404,170.8,1164,8836
20000,94,17750.0,12191,313.27,2250,17750
40000,94,35489.0,22954,560.82,4511,35489
60000,94,53155.0,33105,777.25,6845,53155
80000,94,70982.0,42907,987.23,9018,70982
10000,94,8836.0,6404,170.8,1164,8836
2,95,2.0,2,0.06,0,2
3,95,3.0,2,0.06,0,3
100,95,82.0,69,2.05,18,82
200,95,173.0,137,3.97,27,173
2000,95,1759.0,1307,37.59,241,1759
10000,95,8792.0,6208,168.48,1208,8792
20000,95,17636.0,11796,311.16,2364,17636
40000,95,35397.0,22486,559.66,4603,35397
60000,95,53126.0,32689,781.21,6874,53126
80000,95,70911.0,42823,1005.71,9089,70911
10000,95,8792.0,6208,168.48,1208,8792
2,96,2.0,2,0.06,0,2
3,96,3.0,2,0.06,0,3
100,96,86.0,63,1.91,14,86
200,96,179.0,126,3.82,21,179
2000,96,1776.0,1247,36.79,224,1776
10000,96,8859.0,6206,168.14,1141,8859
20000,96,17681.0,12054,312.26,2319,17681
40000,96,35451.0,22928,579.12,4549,35451
60000,96,53245.0,33145,802.65,6755,53245
80000,96,71055.0,42785,1001.13,8945,71055
10000,96,8859.0,6206,168.14,1141,8859
2,97,2.0,2,0.06,0,2
3,97,3.0,2,0.06,0,3
100,97,85.0,64,1.88,15,85
200,97,177.0,130,3.78,23,177
2000,97,1772.0,1245,34.93,228,1772
10000,97,8821.0,6158,165.98,1179,8821
20000,97,17664.0,11661,295.77,2336,17664
40000,97,35417.0,22525,552.81,4583,35417
60000,97,53242.0,32797,767.41,6758,53242
80000,97,71042.0,42228,963.6,8958,71042
10000,97,8821.0,6158,165.98,1179,8821
2,98,2.0,2,0.06,0,2
3,98,3.0,2,0.06,0,3
100,98,91.0,65,1.97,9,91
200,98,172.0,131,3.99,28,172
2000,98,1771.0,1300,38.24,229,1771
10000,98,8861.0,6113,160.25,1139,8861
20000,98,17751.0,11878,300.62,2249,17751
40000,98,35460.0,22307,543.11,4540,35460
60000,98,53215.0,32379,773.91,6785,53215
80000,98,70938.0,42271,995.87,9062,70938
10000,98,8861.0,6113,160.25,1139,8861
2,99,2.0,2,0.06,0,2
3,99,3.0,2,0.06,0,3
100,99,84.0,67,1.99,16,84
200,99,173.0,135,3.91,27,173
2000,99,1752.0,1315,38.55,248,1752
10000,99,8810.0,6128,174.48,1190,8810
20000,99,17670.0,11908,316.32,2330,17670
40000,99,35434.0,23413,577.45,4566,35434
60000,99,53192.0,34476,813.44,6808,53192
80000,99,70968.0,44564,1023.52,9032,70968
10000,99,8810.0,6128,174.48,1190,8810
2,100,2.0,2,0.06,0,2
3,100,3.0,2,0.06,0,3
100,100,88.0,66,1.98,12,88
200,100,179.0,133,3.93,21,179
2000,100,1761.0,1332,38.32,239,1761
10000,100,8802.0,6226,169.9,1198,8802
20000,100,17648.0,12293,319.65,2352,17648
40000,100,35393.0,23664,568.8,4607,35393
60000,100,53226.0,34812,795.0,6774,53226
80000,100,71078.0,44581,989.41,8922,71078
10000,100,8802.0,6226,169.9,1198,8802
