Timestep,Iteration,Total Reward,Suboptimal Arms,Total Regret,Zeros Count,Ones Count
2,1,1.0,1,0.05,1,1
3,1,1.0,2,0.1,2,1
100,1,84.0,47,2.35,16,84
200,1,174.0,96,4.8,26,174
2000,1,1762.0,882,44.1,238,1762
10000,1,8807.0,3928,196.4,1193,8807
20000,1,17659.0,6957,347.85,2341,17659
40000,1,35484.0,11709,585.45,4516,35484
60000,1,53295.0,15642,782.1,6705,53295
80000,1,71185.0,19238,961.9,8815,71185
10000,1,8807.0,3928,196.4,1193,8807
2,2,1.0,1,0.05,1,1
3,2,2.0,1,0.05,1,2
100,2,81.0,51,2.55,19,81
200,2,166.0,94,4.7,34,166
2000,2,1738.0,847,42.35,262,1738
10000,2,8806.0,3995,199.75,1194,8806
20000,2,17676.0,7170,358.5,2324,17676
40000,2,35445.0,11525,576.25,4555,35445
60000,2,53266.0,14631,731.55,6734,53266
80000,2,71011.0,17998,899.9,8989,71011
10000,2,8806.0,3995,199.75,1194,8806
2,3,2.0,1,0.05,0,2
3,3,3.0,1,0.05,0,3
100,3,91.0,49,2.45,9,91
200,3,177.0,100,5.0,23,177
2000,3,1750.0,856,42.8,250,1750
10000,3,8774.0,3964,198.2,1226,8774
20000,3,17642.0,7171,358.55,2358,17642
40000,3,35409.0,12142,607.1,4591,35409
60000,3,53172.0,16301,815.05,6828,53172
80000,3,70994.0,19905,995.25,9006,70994
10000,3,8774.0,3964,198.2,1226,8774
2,4,1.0,1,0.05,1,1
3,4,2.0,1,0.05,1,2
100,4,87.0,48,2.4,13,87
200,4,176.0,91,4.55,24,176
2000,4,1767.0,791,39.55,233,1767
10000,4,8834.0,3693,184.65,1166,8834
20000,4,17631.0,6955,347.75,2369,17631
40000,4,35398.0,11791,589.55,4602,35398
60000,4,53279.0,15475,773.75,6721,53279
80000,4,71074.0,18906,945.3,8926,71074
10000,4,8834.0,3693,184.65,1166,8834
2,5,2.0,1,0.05,0,2
3,5,3.0,1,0.05,0,3
100,5,84.0,46,2.3,16,84
200,5,169.0,94,4.7,31,169
2000,5,1746.0,848,42.4,254,1746
10000,5,8801.0,3744,187.2,1199,8801
20000,5,17619.0,6428,321.4,2381,17619
40000,5,35313.0,10677,533.85,4687,35313
60000,5,53176.0,13993,699.65,6824,53176
80000,5,70945.0,18249,912.45,9055,70945
10000,5,8801.0,3744,187.2,1199,8801
2,6,1.0,1,0.05,1,1
3,6,2.0,2,0.1,1,2
100,6,89.0,48,2.4,11,89
200,6,177.0,99,4.95,23,177
2000,6,1749.0,885,44.25,251,1749
10000,6,8820.0,3799,189.95,1180,8820
20000,6,17591.0,6743,337.15,2409,17591
40000,6,35332.0,11403,570.15,4668,35332
60000,6,53163.0,15103,755.15,6837,53163
80000,6,71089.0,18585,929.25,8911,71089
10000,6,8820.0,3799,189.95,1180,8820
2,7,2.0,1,0.05,0,2
3,7,3.0,1,0.05,0,3
100,7,84.0,51,2.55,16,84
200,7,172.0,94,4.7,28,172
2000,7,1766.0,926,46.3,234,1766
10000,7,8813.0,3855,192.75,1187,8813
20000,7,17653.0,6982,349.1,2347,17653
40000,7,35429.0,11711,585.55,4571,35429
60000,7,53172.0,15586,779.3,6828,53172
80000,7,70999.0,18192,909.6,9001,70999
10000,7,8813.0,3855,192.75,1187,8813
2,8,1.0,1,0.05,1,1
3,8,2.0,1,0.05,1,2
100,8,85.0,46,2.3,15,85
200,8,171.0,93,4.65,29,171
2000,8,1742.0,912,45.6,258,1742
10000,8,8808.0,3897,194.85,1192,8808
20000,8,17694.0,6956,347.8,2306,17694
40000,8,35509.0,12028,601.4,4491,35509
60000,8,53307.0,15938,796.9,6693,53307
80000,8,71180.0,18894,944.7,8820,71180
10000,8,8808.0,3897,194.85,1192,8808
2,9,1.0,1,0.05,1,1
3,9,2.0,1,0.05,1,2
100,9,89.0,47,2.35,11,89
200,9,184.0,93,4.65,16,184
2000,9,1780.0,897,44.85,220,1780
10000,9,8843.0,3889,194.45,1157,8843
20000,9,17689.0,6946,347.3,2311,17689
40000,9,35470.0,11873,593.65,4530,35470
60000,9,53306.0,14931,746.55,6694,53306
80000,9,71155.0,17949,897.45,8845,71155
10000,9,8843.0,3889,194.45,1157,8843
2,10,2.0,1,0.05,0,2
3,10,3.0,1,0.05,0,3
100,10,82.0,51,2.55,18,82
200,10,172.0,99,4.95,28,172
2000,10,1740.0,954,47.7,260,1740
10000,10,8785.0,3883,194.15,1215,8785
20000,10,17618.0,6782,339.1,2382,17618
40000,10,35304.0,12018,600.9,4696,35304
60000,10,53105.0,15483,774.15,6895,53105
80000,10,70939.0,18609,930.45,9061,70939
10000,10,8785.0,3883,194.15,1215,8785
2,11,2.0,1,0.05,0,2
3,11,3.0,1,0.05,0,3
100,11,87.0,48,2.4,13,87
200,11,162.0,101,5.05,38,162
2000,11,1737.0,863,43.15,263,1737
10000,11,8794.0,3724,186.2,1206,8794
20000,11,17615.0,6891,344.55,2385,17615
40000,11,35354.0,11567,578.35,4646,35354
60000,11,53142.0,16344,817.2,6858,53142
80000,11,70928.0,19820,991.0,9072,70928
10000,11,8794.0,3724,186.2,1206,8794
2,12,2.0,1,0.05,0,2
3,12,3.0,1,0.05,0,3
100,12,83.0,51,2.55,17,83
200,12,170.0,94,4.7,30,170
2000,12,1749.0,914,45.7,251,1749
10000,12,8858.0,3771,188.55,1142,8858
20000,12,17752.0,6519,325.95,2248,17752
40000,12,35498.0,11335,566.75,4502,35498
60000,12,53374.0,14275,713.75,6626,53374
80000,12,71113.0,18159,907.95,8887,71113
10000,12,8858.0,3771,188.55,1142,8858
2,13,1.0,1,0.05,1,1
3,13,2.0,1,0.05,1,2
100,13,91.0,48,2.4,9,91
200,13,176.0,95,4.75,24,176
2000,13,1768.0,827,41.35,232,1768
10000,13,8799.0,3743,187.15,1201,8799
20000,13,17667.0,6745,337.25,2333,17667
40000,13,35388.0,11247,562.35,4612,35388
60000,13,53172.0,14780,739.0,6828,53172
80000,13,71100.0,18313,915.65,8900,71100
10000,13,8799.0,3743,187.15,1201,8799
2,14,2.0,1,0.05,0,2
3,14,3.0,1,0.05,0,3
100,14,83.0,48,2.4,17,83
200,14,169.0,92,4.6,31,169
2000,14,1747.0,876,43.8,253,1747
10000,14,8784.0,3771,188.55,1216,8784
20000,14,17604.0,7060,353.0,2396,17604
40000,14,35331.0,12173,608.65,4669,35331
60000,14,53130.0,15415,770.75,6870,53130
80000,14,70933.0,18961,948.05,9067,70933
10000,14,8784.0,3771,188.55,1216,8784
2,15,2.0,1,0.05,0,2
3,15,3.0,1,0.05,0,3
100,15,86.0,49,2.45,14,86
200,15,181.0,94,4.7,19,181
2000,15,1740.0,911,45.55,260,1740
10000,15,8781.0,3854,192.7,1219,8781
20000,15,17568.0,6997,349.85,2432,17568
40000,15,35319.0,11842,592.1,4681,35319
60000,15,53064.0,16077,803.85,6936,53064
80000,15,70951.0,18735,936.75,9049,70951
10000,15,8781.0,3854,192.7,1219,8781
2,16,2.0,1,0.05,0,2
3,16,3.0,1,0.05,0,3
100,16,85.0,51,2.55,15,85
200,16,171.0,96,4.8,29,171
2000,16,1743.0,847,42.35,257,1743
10000,16,8802.0,3767,188.35,1198,8802
20000,16,17730.0,6562,328.1,2270,17730
40000,16,35512.0,11135,556.75,4488,35512
60000,16,53333.0,15153,757.65,6667,53333
80000,16,71133.0,18725,936.25,8867,71133
10000,16,8802.0,3767,188.35,1198,8802
2,17,1.0,1,0.05,1,1
3,17,2.0,1,0.05,1,2
100,17,88.0,46,2.3,12,88
200,17,178.0,95,4.75,22,178
2000,17,1776.0,891,44.55,224,1776
10000,17,8848.0,3784,189.2,1152,8848
20000,17,17716.0,6686,334.3,2284,17716
40000,17,35467.0,11350,567.5,4533,35467
60000,17,53321.0,14732,736.6,6679,53321
80000,17,71284.0,17470,873.5,8716,71284
10000,17,8848.0,3784,189.2,1152,8848
2,18,2.0,1,0.05,0,2
3,18,3.0,1,0.05,0,3
100,18,87.0,54,2.7,13,87
200,18,178.0,104,5.2,22,178
2000,18,1745.0,934,46.7,255,1745
10000,18,8760.0,4024,201.2,1240,8760
20000,18,17649.0,7257,362.85,2351,17649
40000,18,35395.0,11998,599.9,4605,35395
60000,18,53155.0,16374,818.7,6845,53155
80000,18,70976.0,20223,1011.15,9024,70976
10000,18,8760.0,4024,201.2,1240,8760
2,19,2.0,1,0.05,0,2
3,19,3.0,1,0.05,0,3
100,19,89.0,47,2.35,11,89
200,19,180.0,93,4.65,20,180
2000,19,1750.0,1000,50.0,250,1750
10000,19,8821.0,4085,204.25,1179,8821
20000,19,17731.0,7011,350.55,2269,17731
40000,19,35443.0,12216,610.8,4557,35443
60000,19,53256.0,15937,796.85,6744,53256
80000,19,71018.0,19384,969.2,8982,71018
10000,19,8821.0,4085,204.25,1179,8821
2,20,2.0,1,0.05,0,2
3,20,3.0,1,0.05,0,3
100,20,91.0,48,2.4,9,91
200,20,171.0,97,4.85,29,171
2000,20,1738.0,864,43.2,262,1738
10000,20,8755.0,3685,184.25,1245,8755
20000,20,17610.0,6873,343.65,2390,17610
40000,20,35352.0,11589,579.45,4648,35352
60000,20,53163.0,15387,769.35,6837,53163
80000,20,70929.0,18667,933.35,9071,70929
10000,20,8755.0,3685,184.25,1245,8755
2,21,2.0,1,0.05,0,2
3,21,3.0,1,0.05,0,3
100,21,86.0,50,2.5,14,86
200,21,178.0,96,4.8,22,178
2000,21,1751.0,879,43.95,249,1751
10000,21,8780.0,3892,194.6,1220,8780
20000,21,17605.0,6881,344.05,2395,17605
40000,21,35318.0,11575,578.75,4682,35318
60000,21,53143.0,15033,751.65,6857,53143
80000,21,70974.0,17956,897.8,9026,70974
10000,21,8780.0,3892,194.6,1220,8780
2,22,2.0,1,0.05,0,2
3,22,3.0,1,0.05,0,3
100,22,88.0,49,2.45,12,88
200,22,177.0,96,4.8,23,177
2000,22,1802.0,890,44.5,198,1802
10000,22,8888.0,3918,195.9,1112,8888
20000,22,17722.0,6858,342.9,2278,17722
40000,22,35439.0,12377,618.85,4561,35439
60000,22,53232.0,16340,817.0,6768,53232
80000,22,71114.0,19348,967.4,8886,71114
10000,22,8888.0,3918,195.9,1112,8888
2,23,1.0,1,0.05,1,1
3,23,2.0,2,0.1,1,2
100,23,89.0,49,2.45,11,89
200,23,175.0,95,4.75,25,175
2000,23,1753.0,903,45.15,247,1753
10000,23,8835.0,3799,189.95,1165,8835
20000,23,17698.0,6693,334.65,2302,17698
40000,23,35493.0,11082,554.1,4507,35493
60000,23,53286.0,15155,757.75,6714,53286
80000,23,71135.0,18553,927.65,8865,71135
10000,23,8835.0,3799,189.95,1165,8835
2,24,2.0,1,0.05,0,2
3,24,3.0,1,0.05,0,3
100,24,87.0,46,2.3,13,87
200,24,180.0,93,4.65,20,180
2000,24,1744.0,842,42.1,256,1744
10000,24,8771.0,3826,191.3,1229,8771
20000,24,17546.0,6991,349.55,2454,17546
40000,24,35307.0,11577,578.85,4693,35307
60000,24,53086.0,15104,755.2,6914,53086
80000,24,70898.0,18383,919.15,9102,70898
10000,24,8771.0,3826,191.3,1229,8771
2,25,1.0,1,0.05,1,1
3,25,2.0,1,0.05,1,2
100,25,89.0,46,2.3,11,89
200,25,183.0,92,4.6,17,183
2000,25,1740.0,855,42.75,260,1740
10000,25,8821.0,3620,181.0,1179,8821
20000,25,17652.0,7056,352.8,2348,17652
40000,25,35449.0,11540,577.0,4551,35449
60000,25,53352.0,14855,742.75,6648,53352
80000,25,71165.0,17985,899.25,8835,71165
10000,25,8821.0,3620,181.0,1179,8821
2,26,1.0,1,0.05,1,1
3,26,2.0,1,0.05,1,2
100,26,88.0,49,2.45,12,88
200,26,177.0,96,4.8,23,177
2000,26,1755.0,889,44.45,245,1755
10000,26,8795.0,3986,199.3,1205,8795
20000,26,17606.0,6968,348.4,2394,17606
40000,26,35355.0,11020,551.0,4645,35355
60000,26,53185.0,14461,723.05,6815,53185
80000,26,71024.0,17535,876.75,8976,71024
10000,26,8795.0,3986,199.3,1205,8795
2,27,2.0,1,0.05,0,2
3,27,3.0,1,0.05,0,3
100,27,86.0,50,2.5,14,86
200,27,173.0,99,4.95,27,173
2000,27,1742.0,898,44.9,258,1742
10000,27,8766.0,3984,199.2,1234,8766
20000,27,17583.0,7457,372.85,2417,17583
40000,27,35333.0,12852,642.6,4667,35333
60000,27,53089.0,17202,860.1,6911,53089
80000,27,70979.0,20508,1025.4,9021,70979
10000,27,8766.0,3984,199.2,1234,8766
2,28,2.0,1,0.05,0,2
3,28,3.0,1,0.05,0,3
100,28,88.0,49,2.45,12,88
200,28,175.0,97,4.85,25,175
2000,28,1751.0,941,47.05,249,1751
10000,28,8813.0,4022,201.1,1187,8813
20000,28,17632.0,7052,352.6,2368,17632
40000,28,35386.0,11634,581.7,4614,35386
60000,28,53281.0,14659,732.95,6719,53281
80000,28,71192.0,17248,862.4,8808,71192
10000,28,8813.0,4022,201.1,1187,8813
2,29,2.0,1,0.05,0,2
3,29,2.0,1,0.05,1,2
100,29,94.0,50,2.5,6,94
200,29,177.0,99,4.95,23,177
2000,29,1749.0,909,45.45,251,1749
10000,29,8755.0,3944,197.2,1245,8755
20000,29,17598.0,7011,350.55,2402,17598
40000,29,35375.0,12117,605.85,4625,35375
60000,29,53203.0,15677,783.85,6797,53203
80000,29,71044.0,18766,938.3,8956,71044
10000,29,8755.0,3944,197.2,1245,8755
2,30,1.0,1,0.05,1,1
3,30,2.0,1,0.05,1,2
100,30,87.0,48,2.4,13,87
200,30,174.0,94,4.7,26,174
2000,30,1772.0,923,46.15,228,1772
10000,30,8770.0,3959,197.95,1230,8770
20000,30,17609.0,6738,336.9,2391,17609
40000,30,35374.0,11883,594.15,4626,35374
60000,30,53159.0,15927,796.35,6841,53159
80000,30,70975.0,18660,933.0,9025,70975
10000,30,8770.0,3959,197.95,1230,8770
2,31,2.0,1,0.05,0,2
3,31,3.0,1,0.05,0,3
100,31,89.0,47,2.35,11,89
200,31,179.0,92,4.6,21,179
2000,31,1767.0,855,42.75,233,1767
10000,31,8804.0,3766,188.3,1196,8804
20000,31,17660.0,6535,326.75,2340,17660
40000,31,35389.0,11696,584.8,4611,35389
60000,31,53255.0,15662,783.1,6745,53255
80000,31,71103.0,18917,945.85,8897,71103
10000,31,8804.0,3766,188.3,1196,8804
2,32,2.0,1,0.05,0,2
3,32,3.0,1,0.05,0,3
100,32,89.0,49,2.45,11,89
200,32,177.0,92,4.6,23,177
2000,32,1735.0,875,43.75,265,1735
10000,32,8797.0,3733,186.65,1203,8797
20000,32,17605.0,7084,354.2,2395,17605
40000,32,35257.0,12486,624.3,4743,35257
60000,32,53047.0,16612,830.6,6953,53047
80000,32,70822.0,19913,995.65,9178,70822
10000,32,8797.0,3733,186.65,1203,8797
2,33,2.0,1,0.05,0,2
3,33,3.0,1,0.05,0,3
100,33,84.0,50,2.5,16,84
200,33,170.0,92,4.6,30,170
2000,33,1743.0,871,43.55,257,1743
10000,33,8816.0,3870,193.5,1184,8816
20000,33,17687.0,7271,363.55,2313,17687
40000,33,35419.0,11877,593.85,4581,35419
60000,33,53172.0,16075,803.75,6828,53172
80000,33,70930.0,20042,1002.1,9070,70930
10000,33,8816.0,3870,193.5,1184,8816
2,34,2.0,1,0.05,0,2
3,34,3.0,1,0.05,0,3
100,34,85.0,48,2.4,15,85
200,34,174.0,94,4.7,26,174
2000,34,1741.0,891,44.55,259,1741
10000,34,8740.0,4196,209.8,1260,8740
20000,34,17514.0,7109,355.45,2486,17514
40000,34,35300.0,12517,625.85,4700,35300
60000,34,53109.0,16836,841.8,6891,53109
80000,34,70946.0,20028,1001.4,9054,70946
10000,34,8740.0,4196,209.8,1260,8740
2,35,0.0,1,0.05,2,0
3,35,1.0,1,0.05,2,1
100,35,88.0,52,2.6,12,88
200,35,174.0,102,5.1,26,174
2000,35,1761.0,882,44.1,239,1761
10000,35,8827.0,3923,196.15,1173,8827
20000,35,17683.0,6856,342.8,2317,17683
40000,35,35430.0,12076,603.8,4570,35430
60000,35,53262.0,15805,790.25,6738,53262
80000,35,71069.0,19399,969.95,8931,71069
10000,35,8827.0,3923,196.15,1173,8827
2,36,1.0,1,0.05,1,1
3,36,2.0,1,0.05,1,2
100,36,89.0,51,2.55,11,89
200,36,177.0,100,5.0,23,177
2000,36,1783.0,914,45.7,217,1783
10000,36,8866.0,3714,185.7,1134,8866
20000,36,17753.0,6953,347.65,2247,17753
40000,36,35575.0,11996,599.8,4425,35575
60000,36,53388.0,16089,804.45,6612,53388
80000,36,71183.0,19409,970.45,8817,71183
10000,36,8866.0,3714,185.7,1134,8866
2,37,2.0,1,0.05,0,2
3,37,3.0,1,0.05,0,3
100,37,86.0,47,2.35,14,86
200,37,175.0,97,4.85,25,175
2000,37,1769.0,857,42.85,231,1769
10000,37,8815.0,3967,198.35,1185,8815
20000,37,17718.0,6694,334.7,2282,17718
40000,37,35369.0,11621,581.05,4631,35369
60000,37,53189.0,15040,752.0,6811,53189
80000,37,71033.0,18079,903.95,8967,71033
10000,37,8815.0,3967,198.35,1185,8815
2,38,2.0,1,0.05,0,2
3,38,2.0,1,0.05,1,2
100,38,88.0,47,2.35,12,88
200,38,172.0,94,4.7,28,172
2000,38,1753.0,854,42.7,247,1753
10000,38,8783.0,3785,189.25,1217,8783
20000,38,17596.0,6666,333.3,2404,17596
40000,38,35324.0,11468,573.4,4676,35324
60000,38,53145.0,14847,742.35,6855,53145
80000,38,70984.0,18346,917.3,9016,70984
10000,38,8783.0,3785,189.25,1217,8783
2,39,2.0,1,0.05,0,2
3,39,3.0,1,0.05,0,3
100,39,84.0,44,2.2,16,84
200,39,169.0,91,4.55,31,169
2000,39,1750.0,880,44.0,250,1750
10000,39,8835.0,3858,192.9,1165,8835
20000,39,17657.0,7016,350.8,2343,17657
40000,39,35465.0,11774,588.7,4535,35465
60000,39,53235.0,15923,796.15,6765,53235
80000,39,71093.0,19583,979.15,8907,71093
10000,39,8835.0,3858,192.9,1165,8835
2,40,2.0,1,0.05,0,2
3,40,3.0,1,0.05,0,3
100,40,88.0,49,2.45,12,88
200,40,177.0,97,4.85,23,177
2000,40,1750.0,913,45.65,250,1750
10000,40,8837.0,3970,198.5,1163,8837
20000,40,17674.0,6904,345.2,2326,17674
40000,40,35381.0,11969,598.45,4619,35381
60000,40,53233.0,16390,819.5,6767,53233
80000,40,70978.0,20295,1014.75,9022,70978
10000,40,8837.0,3970,198.5,1163,8837
2,41,2.0,1,0.05,0,2
3,41,2.0,1,0.05,1,2
100,41,87.0,48,2.4,13,87
200,41,173.0,97,4.85,27,173
2000,41,1733.0,886,44.3,267,1733
10000,41,8793.0,3911,195.55,1207,8793
20000,41,17644.0,6913,345.65,2356,17644
40000,41,35419.0,11527,576.35,4581,35419
60000,41,53165.0,16322,816.1,6835,53165
80000,41,70938.0,20130,1006.5,9062,70938
10000,41,8793.0,3911,195.55,1207,8793
2,42,1.0,1,0.05,1,1
3,42,2.0,1,0.05,1,2
100,42,81.0,46,2.3,19,81
200,42,174.0,94,4.7,26,174
2000,42,1750.0,813,40.65,250,1750
10000,42,8817.0,3449,172.45,1183,8817
20000,42,17707.0,6154,307.7,2293,17707
40000,42,35421.0,10727,536.35,4579,35421
60000,42,53309.0,14375,718.75,6691,53309
80000,42,71129.0,18080,904.0,8871,71129
10000,42,8817.0,3449,172.45,1183,8817
2,43,1.0,1,0.05,1,1
3,43,2.0,1,0.05,1,2
100,43,85.0,46,2.3,15,85
200,43,171.0,88,4.4,29,171
2000,43,1765.0,775,38.75,235,1765
10000,43,8836.0,3788,189.4,1164,8836
20000,43,17710.0,6886,344.3,2290,17710
40000,43,35475.0,11968,598.4,4525,35475
60000,43,53243.0,16012,800.6,6757,53243
80000,43,71039.0,19244,962.2,8961,71039
10000,43,8836.0,3788,189.4,1164,8836
2,44,1.0,1,0.05,1,1
3,44,2.0,1,0.05,1,2
100,44,91.0,48,2.4,9,91
200,44,177.0,96,4.8,23,177
2000,44,1765.0,843,42.15,235,1765
10000,44,8838.0,3580,179.0,1162,8838
20000,44,17712.0,6334,316.7,2288,17712
40000,44,35451.0,10986,549.3,4549,35451
60000,44,53211.0,14918,745.9,6789,53211
80000,44,71061.0,17693,884.65,8939,71061
10000,44,8838.0,3580,179.0,1162,8838
2,45,2.0,1,0.05,0,2
3,45,3.0,1,0.05,0,3
100,45,84.0,50,2.5,16,84
200,45,169.0,100,5.0,31,169
2000,45,1743.0,915,45.75,257,1743
10000,45,8757.0,3909,195.45,1243,8757
20000,45,17628.0,6604,330.2,2372,17628
40000,45,35368.0,11563,578.15,4632,35368
60000,45,53235.0,15168,758.4,6765,53235
80000,45,71022.0,18276,913.8,8978,71022
10000,45,8757.0,3909,195.45,1243,8757
2,46,2.0,1,0.05,0,2
3,46,3.0,1,0.05,0,3
100,46,86.0,49,2.45,14,86
200,46,166.0,96,4.8,34,166
2000,46,1746.0,903,45.15,254,1746
10000,46,8814.0,3805,190.25,1186,8814
20000,46,17675.0,6583,329.15,2325,17675
40000,46,35499.0,11544,577.2,4501,35499
60000,46,53364.0,15491,774.55,6636,53364
80000,46,71181.0,19216,960.8,8819,71181
10000,46,8814.0,3805,190.25,1186,8814
2,47,2.0,1,0.05,0,2
3,47,3.0,1,0.05,0,3
100,47,94.0,50,2.5,6,94
200,47,179.0,101,5.05,21,179
2000,47,1774.0,867,43.35,226,1774
10000,47,8882.0,3874,193.7,1118,8882
20000,47,17713.0,6802,340.1,2287,17713
40000,47,35434.0,11826,591.3,4566,35434
60000,47,53232.0,16299,814.95,6768,53232
80000,47,71026.0,20151,1007.55,8974,71026
10000,47,8882.0,3874,193.7,1118,8882
2,48,2.0,1,0.05,0,2
3,48,3.0,1,0.05,0,3
100,48,89.0,47,2.35,11,89
200,48,181.0,96,4.8,19,181
2000,48,1787.0,924,46.2,213,1787
10000,48,8831.0,3949,197.45,1169,8831
20000,48,17676.0,6877,343.85,2324,17676
40000,48,35426.0,11633,581.65,4574,35426
60000,48,53252.0,15089,754.45,6748,53252
80000,48,71172.0,18405,920.25,8828,71172
10000,48,8831.0,3949,197.45,1169,8831
2,49,2.0,1,0.05,0,2
3,49,3.0,1,0.05,0,3
100,49,93.0,49,2.45,7,93
200,49,178.0,95,4.75,22,178
2000,49,1759.0,879,43.95,241,1759
10000,49,8863.0,3825,191.25,1137,8863
20000,49,17688.0,7285,364.25,2312,17688
40000,49,35422.0,12055,602.75,4578,35422
60000,49,53328.0,15636,781.8,6672,53328
80000,49,71234.0,18661,933.05,8766,71234
10000,49,8863.0,3825,191.25,1137,8863
2,50,2.0,1,0.05,0,2
3,50,3.0,1,0.05,0,3
100,50,88.0,48,2.4,12,88
200,50,182.0,97,4.85,18,182
2000,50,1767.0,883,44.15,233,1767
10000,50,8799.0,4049,202.45,1201,8799
20000,50,17675.0,6967,348.35,2325,17675
40000,50,35364.0,11902,595.1,4636,35364
60000,50,53163.0,15804,790.2,6837,53163
80000,50,70983.0,18932,946.6,9017,70983
10000,50,8799.0,4049,202.45,1201,8799
2,51,2.0,1,0.05,0,2
3,51,3.0,1,0.05,0,3
100,51,87.0,46,2.3,13,87
200,51,170.0,89,4.45,30,170
2000,51,1763.0,865,43.25,237,1763
10000,51,8845.0,3895,194.75,1155,8845
20000,51,17697.0,7247,362.35,2303,17697
40000,51,35388.0,12627,631.35,4612,35388
60000,51,53189.0,16540,827.0,6811,53189
80000,51,71098.0,19858,992.9,8902,71098
10000,51,8845.0,3895,194.75,1155,8845
2,52,2.0,1,0.05,0,2
3,52,3.0,1,0.05,0,3
100,52,87.0,50,2.5,13,87
200,52,171.0,101,5.05,29,171
2000,52,1746.0,886,44.3,254,1746
10000,52,8771.0,3582,179.1,1229,8771
20000,52,17638.0,6612,330.6,2362,17638
40000,52,35389.0,10809,540.45,4611,35389
60000,52,53192.0,14507,725.35,6808,53192
80000,52,71016.0,18182,909.1,8984,71016
10000,52,8771.0,3582,179.1,1229,8771
2,53,2.0,1,0.05,0,2
3,53,3.0,1,0.05,0,3
100,53,86.0,49,2.45,14,86
200,53,172.0,100,5.0,28,172
2000,53,1730.0,902,45.1,270,1730
10000,53,8750.0,3717,185.85,1250,8750
20000,53,17634.0,6770,338.5,2366,17634
40000,53,35450.0,11389,569.45,4550,35450
60000,53,53283.0,14918,745.9,6717,53283
80000,53,71173.0,18265,913.25,8827,71173
10000,53,8750.0,3717,185.85,1250,8750
2,54,2.0,1,0.05,0,2
3,54,3.0,1,0.05,0,3
100,54,90.0,49,2.45,10,90
200,54,175.0,94,4.7,25,175
2000,54,1761.0,887,44.35,239,1761
10000,54,8761.0,3823,191.15,1239,8761
20000,54,17590.0,7193,359.65,2410,17590
40000,54,35387.0,11535,576.75,4613,35387
60000,54,53225.0,15588,779.4,6775,53225
80000,54,71052.0,19071,953.55,8948,71052
10000,54,8761.0,3823,191.15,1239,8761
2,55,2.0,1,0.05,0,2
3,55,3.0,1,0.05,0,3
100,55,82.0,49,2.45,18,82
200,55,169.0,97,4.85,31,169
2000,55,1753.0,896,44.8,247,1753
10000,55,8785.0,3583,179.15,1215,8785
20000,55,17585.0,6365,318.25,2415,17585
40000,55,35412.0,11165,558.25,4588,35412
60000,55,53173.0,15004,750.2,6827,53173
80000,55,70996.0,18771,938.55,9004,70996
10000,55,8785.0,3583,179.15,1215,8785
2,56,2.0,1,0.05,0,2
3,56,3.0,1,0.05,0,3
100,56,89.0,48,2.4,11,89
200,56,184.0,98,4.9,16,184
2000,56,1760.0,895,44.75,240,1760
10000,56,8843.0,3950,197.5,1157,8843
20000,56,17674.0,6880,344.0,2326,17674
40000,56,35414.0,11101,555.05,4586,35414
60000,56,53254.0,14932,746.6,6746,53254
80000,56,71106.0,18654,932.7,8894,71106
10000,56,8843.0,3950,197.5,1157,8843
2,57,1.0,1,0.05,1,1
3,57,2.0,2,0.1,1,2
100,57,88.0,46,2.3,12,88
200,57,174.0,94,4.7,26,174
2000,57,1764.0,903,45.15,236,1764
10000,57,8856.0,3792,189.6,1144,8856
20000,57,17680.0,6740,337.0,2320,17680
40000,57,35446.0,11367,568.35,4554,35446
60000,57,53190.0,14574,728.7,6810,53190
80000,57,71069.0,17584,879.2,8931,71069
10000,57,8856.0,3792,189.6,1144,8856
2,58,2.0,1,0.05,0,2
3,58,3.0,1,0.05,0,3
100,58,87.0,48,2.4,13,87
200,58,178.0,96,4.8,22,178
2000,58,1751.0,853,42.65,249,1751
10000,58,8826.0,3756,187.8,1174,8826
20000,58,17710.0,6644,332.2,2290,17710
40000,58,35383.0,11042,552.1,4617,35383
60000,58,53195.0,14819,740.95,6805,53195
80000,58,71003.0,17572,878.6,8997,71003
10000,58,8826.0,3756,187.8,1174,8826
2,59,2.0,1,0.05,0,2
3,59,3.0,1,0.05,0,3
100,59,90.0,49,2.45,10,90
200,59,177.0,99,4.95,23,177
2000,59,1765.0,883,44.15,235,1765
10000,59,8826.0,3982,199.1,1174,8826
20000,59,17657.0,7115,355.75,2343,17657
40000,59,35337.0,11978,598.9,4663,35337
60000,59,53080.0,15837,791.85,6920,53080
80000,59,70894.0,19259,962.95,9106,70894
10000,59,8826.0,3982,199.1,1174,8826
2,60,1.0,1,0.05,1,1
3,60,2.0,2,0.1,1,2
100,60,89.0,51,2.55,11,89
200,60,180.0,100,5.0,20,180
2000,60,1761.0,959,47.95,239,1761
10000,60,8836.0,4156,207.8,1164,8836
20000,60,17618.0,7153,357.65,2382,17618
40000,60,35399.0,11770,588.5,4601,35399
60000,60,53120.0,16308,815.4,6880,53120
80000,60,70901.0,20003,1000.15,9099,70901
10000,60,8836.0,4156,207.8,1164,8836
2,61,2.0,1,0.05,0,2
3,61,3.0,1,0.05,0,3
100,61,88.0,51,2.55,12,88
200,61,172.0,100,5.0,28,172
2000,61,1788.0,873,43.65,212,1788
10000,61,8844.0,4010,200.5,1156,8844
20000,61,17680.0,7137,356.85,2320,17680
40000,61,35508.0,12232,611.6,4492,35508
60000,61,53360.0,16056,802.8,6640,53360
80000,61,71237.0,19404,970.2,8763,71237
10000,61,8844.0,4010,200.5,1156,8844
2,62,2.0,1,0.05,0,2
3,62,3.0,1,0.05,0,3
100,62,88.0,51,2.55,12,88
200,62,175.0,101,5.05,25,175
2000,62,1739.0,866,43.3,261,1739
10000,62,8819.0,3915,195.75,1181,8819
20000,62,17721.0,7224,361.2,2279,17721
40000,62,35541.0,12387,619.35,4459,35541
60000,62,53307.0,16340,817.0,6693,53307
80000,62,71204.0,19375,968.75,8796,71204
10000,62,8819.0,3915,195.75,1181,8819
2,63,2.0,1,0.05,0,2
3,63,2.0,1,0.05,1,2
100,63,82.0,49,2.45,18,82
200,63,170.0,98,4.9,30,170
2000,63,1749.0,919,45.95,251,1749
10000,63,8816.0,3916,195.8,1184,8816
20000,63,17660.0,7136,356.8,2340,17660
40000,63,35469.0,12458,622.9,4531,35469
60000,63,53223.0,16913,845.65,6777,53223
80000,63,71014.0,20834,1041.7,8986,71014
10000,63,8816.0,3916,195.8,1184,8816
2,64,2.0,1,0.05,0,2
3,64,3.0,1,0.05,0,3
100,64,91.0,51,2.55,9,91
200,64,182.0,97,4.85,18,182
2000,64,1755.0,896,44.8,245,1755
10000,64,8810.0,4033,201.65,1190,8810
20000,64,17700.0,7126,356.3,2300,17700
40000,64,35521.0,11782,589.1,4479,35521
60000,64,53349.0,15766,788.3,6651,53349
80000,64,71234.0,18933,946.65,8766,71234
10000,64,8810.0,4033,201.65,1190,8810
2,65,1.0,1,0.05,1,1
3,65,2.0,1,0.05,1,2
100,65,87.0,48,2.4,13,87
200,65,174.0,93,4.65,26,174
2000,65,1745.0,882,44.1,255,1745
10000,65,8834.0,3647,182.35,1166,8834
20000,65,17726.0,6524,326.2,2274,17726
40000,65,35481.0,11685,584.25,4519,35481
60000,65,53172.0,15710,785.5,6828,53172
80000,65,71027.0,19009,950.45,8973,71027
10000,65,8834.0,3647,182.35,1166,8834
2,66,2.0,1,0.05,0,2
3,66,3.0,1,0.05,0,3
100,66,91.0,48,2.4,9,91
200,66,176.0,98,4.9,24,176
2000,66,1772.0,904,45.2,228,1772
10000,66,8810.0,3642,182.1,1190,8810
20000,66,17695.0,6496,324.8,2305,17695
40000,66,35484.0,10782,539.1,4516,35484
60000,66,53326.0,14674,733.7,6674,53326
80000,66,71130.0,18045,902.25,8870,71130
10000,66,8810.0,3642,182.1,1190,8810
2,67,2.0,1,0.05,0,2
3,67,3.0,1,0.05,0,3
100,67,90.0,50,2.5,10,90
200,67,178.0,100,5.0,22,178
2000,67,1766.0,861,43.05,234,1766
10000,67,8886.0,3908,195.4,1114,8886
20000,67,17666.0,6974,348.7,2334,17666
40000,67,35415.0,12139,606.95,4585,35415
60000,67,53196.0,15787,789.35,6804,53196
80000,67,71053.0,19021,951.05,8947,71053
10000,67,8886.0,3908,195.4,1114,8886
2,68,2.0,1,0.05,0,2
3,68,3.0,1,0.05,0,3
100,68,85.0,50,2.5,15,85
200,68,177.0,101,5.05,23,177
2000,68,1743.0,925,46.25,257,1743
10000,68,8767.0,4054,202.7,1233,8767
20000,68,17606.0,7136,356.8,2394,17606
40000,68,35359.0,11853,592.65,4641,35359
60000,68,53120.0,16018,800.9,6880,53120
80000,68,71049.0,18935,946.75,8951,71049
10000,68,8767.0,4054,202.7,1233,8767
2,69,2.0,1,0.05,0,2
3,69,3.0,1,0.05,0,3
100,69,90.0,49,2.45,10,90
200,69,179.0,97,4.85,21,179
2000,69,1728.0,889,44.45,272,1728
10000,69,8759.0,3874,193.7,1241,8759
20000,69,17614.0,6949,347.45,2386,17614
40000,69,35337.0,11483,574.15,4663,35337
60000,69,53221.0,15245,762.25,6779,53221
80000,69,71045.0,18444,922.2,8955,71045
10000,69,8759.0,3874,193.7,1241,8759
2,70,1.0,1,0.05,1,1
3,70,2.0,1,0.05,1,2
100,70,88.0,46,2.3,12,88
200,70,173.0,86,4.3,27,173
2000,70,1758.0,906,45.3,242,1758
10000,70,8779.0,3774,188.7,1221,8779
20000,70,17638.0,6648,332.4,2362,17638
40000,70,35460.0,12122,606.1,4540,35460
60000,70,53288.0,16685,834.25,6712,53288
80000,70,71181.0,20053,1002.65,8819,71181
10000,70,8779.0,3774,188.7,1221,8779
2,71,2.0,1,0.05,0,2
3,71,3.0,1,0.05,0,3
100,71,86.0,46,2.3,14,86
200,71,174.0,93,4.65,26,174
2000,71,1763.0,881,44.05,237,1763
10000,71,8827.0,3755,187.75,1173,8827
20000,71,17679.0,6928,346.4,2321,17679
40000,71,35415.0,11529,576.45,4585,35415
60000,71,53211.0,14947,747.35,6789,53211
80000,71,71101.0,18239,911.95,8899,71101
10000,71,8827.0,3755,187.75,1173,8827
2,72,2.0,1,0.05,0,2
3,72,3.0,1,0.05,0,3
100,72,93.0,47,2.35,7,93
200,72,183.0,94,4.7,17,183
2000,72,1773.0,889,44.45,227,1773
10000,72,8873.0,3857,192.85,1127,8873
20000,72,17718.0,7358,367.9,2282,17718
40000,72,35401.0,12674,633.7,4599,35401
60000,72,53193.0,16911,845.55,6807,53193
80000,72,70965.0,21018,1050.9,9035,70965
10000,72,8873.0,3857,192.85,1127,8873
2,73,2.0,1,0.05,0,2
3,73,3.0,1,0.05,0,3
100,73,84.0,45,2.25,16,84
200,73,171.0,93,4.65,29,171
2000,73,1773.0,879,43.95,227,1773
10000,73,8834.0,3672,183.6,1166,8834
20000,73,17653.0,6396,319.8,2347,17653
40000,73,35391.0,11240,562.0,4609,35391
60000,73,53178.0,14562,728.1,6822,53178
80000,73,71020.0,18391,919.55,8980,71020
10000,73,8834.0,3672,183.6,1166,8834
2,74,2.0,1,0.05,0,2
3,74,3.0,1,0.05,0,3
100,74,91.0,48,2.4,9,91
200,74,176.0,98,4.9,24,176
2000,74,1753.0,872,43.6,247,1753
10000,74,8805.0,3902,195.1,1195,8805
20000,74,17675.0,7149,357.45,2325,17675
40000,74,35454.0,12078,603.9,4546,35454
60000,74,53283.0,15769,788.45,6717,53283
80000,74,71114.0,19007,950.35,8886,71114
10000,74,8805.0,3902,195.1,1195,8805
2,75,1.0,1,0.05,1,1
3,75,2.0,2,0.1,1,2
100,75,86.0,51,2.55,14,86
200,75,178.0,100,5.0,22,178
2000,75,1757.0,906,45.3,243,1757
10000,75,8784.0,3994,199.7,1216,8784
20000,75,17621.0,7106,355.3,2379,17621
40000,75,35323.0,11821,591.05,4677,35323
60000,75,53090.0,15971,798.55,6910,53090
80000,75,70880.0,19176,958.8,9120,70880
10000,75,8784.0,3994,199.7,1216,8784
2,76,2.0,1,0.05,0,2
3,76,3.0,1,0.05,0,3
100,76,90.0,52,2.6,10,90
200,76,175.0,105,5.25,25,175
2000,76,1743.0,864,43.2,257,1743
10000,76,8803.0,3754,187.7,1197,8803
20000,76,17685.0,6701,335.05,2315,17685
40000,76,35418.0,10905,545.25,4582,35418
60000,76,53238.0,15024,751.2,6762,53238
80000,76,71003.0,18696,934.8,8997,71003
10000,76,8803.0,3754,187.7,1197,8803
2,77,2.0,1,0.05,0,2
3,77,3.0,1,0.05,0,3
100,77,90.0,52,2.6,10,90
200,77,179.0,103,5.15,21,179
2000,77,1761.0,839,41.95,239,1761
10000,77,8797.0,3678,183.9,1203,8797
20000,77,17656.0,6377,318.85,2344,17656
40000,77,35430.0,10657,532.85,4570,35430
60000,77,53211.0,14221,711.05,6789,53211
80000,77,71037.0,17368,868.4,8963,71037
10000,77,8797.0,3678,183.9,1203,8797
2,78,2.0,1,0.05,0,2
3,78,3.0,1,0.05,0,3
100,78,92.0,49,2.45,8,92
200,78,181.0,97,4.85,19,181
2000,78,1742.0,932,46.6,258,1742
10000,78,8804.0,3805,190.25,1196,8804
20000,78,17726.0,6929,346.45,2274,17726
40000,78,35514.0,11712,585.6,4486,35514
60000,78,53342.0,16061,803.05,6658,53342
80000,78,71221.0,19505,975.25,8779,71221
10000,78,8804.0,3805,190.25,1196,8804
2,79,2.0,1,0.05,0,2
3,79,3.0,1,0.05,0,3
100,79,87.0,52,2.6,13,87
200,79,167.0,98,4.9,33,167
2000,79,1755.0,880,44.0,245,1755
10000,79,8861.0,3788,189.4,1139,8861
20000,79,17749.0,7196,359.8,2251,17749
40000,79,35502.0,12016,600.8,4498,35502
60000,79,53315.0,15666,783.3,6685,53315
80000,79,71104.0,19119,955.95,8896,71104
10000,79,8861.0,3788,189.4,1139,8861
2,80,2.0,1,0.05,0,2
3,80,3.0,1,0.05,0,3
100,80,79.0,51,2.55,21,79
200,80,169.0,99,4.95,31,169
2000,80,1752.0,914,45.7,248,1752
10000,80,8790.0,3829,191.45,1210,8790
20000,80,17636.0,7031,351.55,2364,17636
40000,80,35402.0,12429,621.45,4598,35402
60000,80,53304.0,15863,793.15,6696,53304
80000,80,71125.0,19126,956.3,8875,71125
10000,80,8790.0,3829,191.45,1210,8790
2,81,2.0,1,0.05,0,2
3,81,3.0,1,0.05,0,3
100,81,79.0,49,2.45,21,79
200,81,166.0,96,4.8,34,166
2000,81,1731.0,874,43.7,269,1731
10000,81,8759.0,3906,195.3,1241,8759
20000,81,17638.0,6980,349.0,2362,17638
40000,81,35409.0,11893,594.65,4591,35409
60000,81,53223.0,15806,790.3,6777,53223
80000,81,71182.0,18890,944.5,8818,71182
10000,81,8759.0,3906,195.3,1241,8759
2,82,2.0,1,0.05,0,2
3,82,3.0,1,0.05,0,3
100,82,87.0,47,2.35,13,87
200,82,178.0,97,4.85,22,178
2000,82,1753.0,893,44.65,247,1753
10000,82,8790.0,3850,192.5,1210,8790
20000,82,17635.0,6682,334.1,2365,17635
40000,82,35391.0,11502,575.1,4609,35391
60000,82,53216.0,15308,765.4,6784,53216
80000,82,71159.0,17892,894.6,8841,71159
10000,82,8790.0,3850,192.5,1210,8790
2,83,1.0,1,0.05,1,1
3,83,2.0,2,0.1,1,2
100,83,91.0,52,2.6,9,91
200,83,180.0,98,4.9,20,180
2000,83,1745.0,851,42.55,255,1745
10000,83,8819.0,3758,187.9,1181,8819
20000,83,17672.0,6683,334.15,2328,17672
40000,83,35474.0,11474,573.7,4526,35474
60000,83,53304.0,15648,782.4,6696,53304
80000,83,71211.0,18821,941.05,8789,71211
10000,83,8819.0,3758,187.9,1181,8819
2,84,1.0,1,0.05,1,1
3,84,2.0,2,0.1,1,2
100,84,87.0,48,2.4,13,87
200,84,172.0,94,4.7,28,172
2000,84,1767.0,868,43.4,233,1767
10000,84,8796.0,3808,190.4,1204,8796
20000,84,17689.0,6867,343.35,2311,17689
40000,84,35426.0,11907,595.35,4574,35426
60000,84,53216.0,15483,774.15,6784,53216
80000,84,71030.0,18930,946.5,8970,71030
10000,84,8796.0,3808,190.4,1204,8796
2,85,2.0,1,0.05,0,2
3,85,3.0,1,0.05,0,3
100,85,93.0,49,2.45,7,93
200,85,180.0,100,5.0,20,180
2000,85,1746.0,934,46.7,254,1746
10000,85,8812.0,4024,201.2,1188,8812
20000,85,17683.0,6894,344.7,2317,17683
40000,85,35442.0,11963,598.15,4558,35442
60000,85,53291.0,15553,777.65,6709,53291
80000,85,71154.0,18765,938.25,8846,71154
10000,85,8812.0,4024,201.2,1188,8812
2,86,2.0,1,0.05,0,2
3,86,3.0,1,0.05,0,3
100,86,92.0,49,2.45,8,92
200,86,181.0,101,5.05,19,181
2000,86,1757.0,870,43.5,243,1757
10000,86,8826.0,3725,186.25,1174,8826
20000,86,17692.0,7011,350.55,2308,17692
40000,86,35479.0,12188,609.4,4521,35479
60000,86,53239.0,17674,883.7,6761,53239
80000,86,71061.0,20669,1033.45,8939,71061
10000,86,8826.0,3725,186.25,1174,8826
2,87,2.0,1,0.05,0,2
3,87,2.0,1,0.05,1,2
100,87,88.0,49,2.45,12,88
200,87,180.0,98,4.9,20,180
2000,87,1760.0,876,43.8,240,1760
10000,87,8862.0,3726,186.3,1138,8862
20000,87,17681.0,6632,331.6,2319,17681
40000,87,35541.0,11379,568.95,4459,35541
60000,87,53416.0,15760,788.0,6584,53416
80000,87,71168.0,19544,977.2,8832,71168
10000,87,8862.0,3726,186.3,1138,8862
2,88,2.0,1,0.05,0,2
3,88,3.0,1,0.05,0,3
100,88,89.0,51,2.55,11,89
200,88,180.0,98,4.9,20,180
2000,88,1765.0,975,48.75,235,1765
10000,88,8826.0,4058,202.9,1174,8826
20000,88,17679.0,7084,354.2,2321,17679
40000,88,35454.0,11988,599.4,4546,35454
60000,88,53284.0,16149,807.45,6716,53284
80000,88,71224.0,19007,950.35,8776,71224
10000,88,8826.0,4058,202.9,1174,8826
2,89,2.0,1,0.05,0,2
3,89,3.0,1,0.05,0,3
100,89,80.0,46,2.3,20,80
200,89,170.0,92,4.6,30,170
2000,89,1734.0,869,43.45,266,1734
10000,89,8810.0,3857,192.85,1190,8810
20000,89,17669.0,6653,332.65,2331,17669
40000,89,35427.0,11567,578.35,4573,35427
60000,89,53231.0,15527,776.35,6769,53231
80000,89,70950.0,19209,960.45,9050,70950
10000,89,8810.0,3857,192.85,1190,8810
2,90,2.0,1,0.05,0,2
3,90,3.0,1,0.05,0,3
100,90,94.0,49,2.45,6,94
200,90,182.0,93,4.65,18,182
2000,90,1759.0,887,44.35,241,1759
10000,90,8819.0,3881,194.05,1181,8819
20000,90,17705.0,6810,340.5,2295,17705
40000,90,35505.0,11801,590.05,4495,35505
60000,90,53251.0,16224,811.2,6749,53251
80000,90,71161.0,19370,968.5,8839,71161
10000,90,8819.0,3881,194.05,1181,8819
2,91,2.0,1,0.05,0,2
3,91,3.0,1,0.05,0,3
100,91,82.0,50,2.5,18,82
200,91,169.0,100,5.0,31,169
2000,91,1767.0,877,43.85,233,1767
10000,91,8795.0,3675,183.75,1205,8795
20000,91,17617.0,6366,318.3,2383,17617
40000,91,35393.0,10581,529.05,4607,35393
60000,91,53228.0,14043,702.15,6772,53228
80000,91,70971.0,17812,890.6,9029,70971
10000,91,8795.0,3675,183.75,1205,8795
2,92,2.0,1,0.05,0,2
3,92,2.0,1,0.05,1,2
100,92,91.0,52,2.6,9,91
200,92,176.0,97,4.85,24,176
2000,92,1750.0,935,46.75,250,1750
10000,92,8774.0,3825,191.25,1226,8774
20000,92,17632.0,6835,341.75,2368,17632
40000,92,35347.0,12371,618.55,4653,35347
60000,92,53170.0,16571,828.55,6830,53170
80000,92,70976.0,20139,1006.95,9024,70976
10000,92,8774.0,3825,191.25,1226,8774
2,93,2.0,1,0.05,0,2
3,93,3.0,1,0.05,0,3
100,93,91.0,47,2.35,9,91
200,93,180.0,91,4.55,20,180
2000,93,1772.0,893,44.65,228,1772
10000,93,8880.0,3857,192.85,1120,8880
20000,93,17709.0,7002,350.1,2291,17709
40000,93,35445.0,12010,600.5,4555,35445
60000,93,53189.0,16361,818.05,6811,53189
80000,93,70981.0,20027,1001.35,9019,70981
10000,93,8880.0,3857,192.85,1120,8880
2,94,2.0,1,0.05,0,2
3,94,3.0,1,0.05,0,3
100,94,92.0,48,2.4,8,92
200,94,184.0,96,4.8,16,184
2000,94,1761.0,908,45.4,239,1761
10000,94,8796.0,3665,183.25,1204,8796
20000,94,17708.0,6472,323.6,2292,17708
40000,94,35404.0,11336,566.8,4596,35404
60000,94,53166.0,15190,759.5,6834,53166
80000,94,71072.0,18445,922.25,8928,71072
10000,94,8796.0,3665,183.25,1204,8796
2,95,2.0,1,0.05,0,2
3,95,3.0,1,0.05,0,3
100,95,88.0,49,2.45,12,88
200,95,174.0,94,4.7,26,174
2000,95,1760.0,847,42.35,240,1760
10000,95,8778.0,3785,189.25,1222,8778
20000,95,17679.0,6803,340.15,2321,17679
40000,95,35446.0,11724,586.2,4554,35446
60000,95,53298.0,15328,766.4,6702,53298
80000,95,71108.0,18796,939.8,8892,71108
10000,95,8778.0,3785,189.25,1222,8778
2,96,2.0,1,0.05,0,2
3,96,3.0,1,0.05,0,3
100,96,85.0,48,2.4,15,85
200,96,176.0,95,4.75,24,176
2000,96,1745.0,843,42.15,255,1745
10000,96,8774.0,3815,190.75,1226,8774
20000,96,17648.0,6825,341.25,2352,17648
40000,96,35482.0,11272,563.6,4518,35482
60000,96,53274.0,15313,765.65,6726,53274
80000,96,71065.0,18066,903.3,8935,71065
10000,96,8774.0,3815,190.75,1226,8774
2,97,2.0,1,0.05,0,2
3,97,3.0,1,0.05,0,3
100,97,88.0,49,2.45,12,88
200,97,171.0,98,4.9,29,171
2000,97,1776.0,866,43.3,224,1776
10000,97,8822.0,3845,192.25,1178,8822
20000,97,17720.0,6909,345.45,2280,17720
40000,97,35486.0,12111,605.55,4514,35486
60000,97,53325.0,16190,809.5,6675,53325
80000,97,71048.0,19537,976.85,8952,71048
10000,97,8822.0,3845,192.25,1178,8822
2,98,1.0,1,0.05,1,1
3,98,2.0,2,0.1,1,2
100,98,88.0,51,2.55,12,88
200,98,172.0,100,5.0,28,172
2000,98,1765.0,905,45.25,235,1765
10000,98,8813.0,3894,194.7,1187,8813
20000,98,17625.0,7170,358.5,2375,17625
40000,98,35366.0,11934,596.7,4634,35366
60000,98,53287.0,15216,760.8,6713,53287
80000,98,71105.0,18547,927.35,8895,71105
10000,98,8813.0,3894,194.7,1187,8813
2,99,2.0,1,0.05,0,2
3,99,2.0,1,0.05,1,2
100,99,84.0,50,2.5,16,84
200,99,172.0,99,4.95,28,172
2000,99,1773.0,941,47.05,227,1773
10000,99,8803.0,3983,199.15,1197,8803
20000,99,17636.0,7068,353.4,2364,17636
40000,99,35461.0,11461,573.05,4539,35461
60000,99,53252.0,15935,796.75,6748,53252
80000,99,71113.0,19164,958.2,8887,71113
10000,99,8803.0,3983,199.15,1197,8803
2,100,2.0,1,0.05,0,2
3,100,3.0,1,0.05,0,3
100,100,85.0,49,2.45,15,85
200,100,175.0,95,4.75,25,175
2000,100,1729.0,892,44.6,271,1729
10000,100,8793.0,3812,190.6,1207,8793
20000,100,17633.0,6850,342.5,2367,17633
40000,100,35395.0,11899,594.95,4605,35395
60000,100,53197.0,15618,780.9,6803,53197
80000,100,70971.0,18587,929.35,9029,70971
10000,100,8793.0,3812,190.6,1207,8793
