Timestep,Iteration,Total Reward,Suboptimal Arms,Total Regret,Zeros Count,Ones Count
2,1,2.0,2,0.1,0,2
3,1,3.0,2,0.1,0,3
100,1,89.0,96,4.8,11,89
200,1,171.0,196,9.8,29,171
2000,1,1693.0,1996,99.8,307,1693
10000,1,8466.0,9996,499.8,1534,8466
20000,1,16990.0,19996,999.8,3010,16990
40000,1,34060.0,39996,1999.8,5940,34060
60000,1,51177.0,59996,2999.8,8823,51177
80000,1,68115.0,79996,3999.8,11885,68115
100000,1,85190.0,99996,4999.8,14810,85190
200000,1,170233.0,199996,9999.8,29767,170233
400000,1,340399.0,399996,19999.8,59601,340399
600000,1,510197.0,599996,29999.8,89803,510197
800000,1,680205.0,799996,39999.8,119795,680205
1000000,1,850397.0,999996,49999.8,149603,850397
2,2,2.0,2,0.1,0,2
3,2,2.0,2,0.1,1,2
100,2,85.0,99,4.95,15,85
200,2,168.0,199,9.95,32,168
2000,2,1696.0,1999,99.95,304,1696
10000,2,8529.0,9999,499.95,1471,8529
20000,2,17052.0,19999,999.95,2948,17052
40000,2,34105.0,39999,1999.95,5895,34105
60000,2,51080.0,59999,2999.95,8920,51080
80000,2,67992.0,79999,3999.95,12008,67992
100000,2,85050.0,99999,4999.95,14950,85050
200000,2,170199.0,199999,9999.95,29801,170199
400000,2,340382.0,399999,19999.95,59618,340382
600000,2,510239.0,599999,29999.95,89761,510239
800000,2,680044.0,799999,39999.95,119956,680044
1000000,2,850262.0,999999,49999.95,149738,850262
2,3,2.0,2,0.1,0,2
3,3,3.0,2,0.1,0,3
100,3,90.0,5,0.25,10,90
200,3,182.0,5,0.25,18,182
2000,3,1773.0,5,0.25,227,1773
10000,3,9021.0,5,0.25,979,9021
20000,3,18034.0,5,0.25,1966,18034
40000,3,36088.0,5,0.25,3912,36088
60000,3,54089.0,5,0.25,5911,54089
80000,3,72090.0,5,0.25,7910,72090
100000,3,90116.0,5,0.25,9884,90116
200000,3,179945.0,5,0.25,20055,179945
400000,3,359888.0,5,0.25,40112,359888
600000,3,539867.0,5,0.25,60133,539867
800000,3,719812.0,5,0.25,80188,719812
1000000,3,899890.0,5,0.25,100110,899890
2,4,2.0,2,0.1,0,2
3,4,3.0,2,0.1,0,3
100,4,86.0,52,2.6,14,86
200,4,171.0,102,5.1,29,171
2000,4,1751.0,1002,50.1,249,1751
10000,4,8763.0,5002,250.1,1237,8763
20000,4,17479.0,10002,500.1,2521,17479
40000,4,34951.0,20002,1000.1,5049,34951
60000,4,52359.0,30002,1500.1,7641,52359
80000,4,69756.0,40002,2000.1,10244,69756
100000,4,87238.0,50002,2500.1,12762,87238
200000,4,174712.0,100002,5000.1,25288,174712
400000,4,349529.0,200002,10000.1,50471,349529
600000,4,524571.0,300002,15000.1,75429,524571
800000,4,699503.0,400002,20000.1,100497,699503
1000000,4,874486.0,500002,25000.1,125514,874486
2,5,1.0,2,0.1,1,1
3,5,2.0,2,0.1,1,2
100,5,89.0,4,0.2,11,89
200,5,186.0,4,0.2,14,186
2000,5,1826.0,4,0.2,174,1826
10000,5,9002.0,4,0.2,998,9002
20000,5,18006.0,4,0.2,1994,18006
40000,5,35941.0,4,0.2,4059,35941
60000,5,53964.0,4,0.2,6036,53964
80000,5,71988.0,4,0.2,8012,71988
100000,5,89921.0,4,0.2,10079,89921
200000,5,180043.0,4,0.2,19957,180043
400000,5,360058.0,4,0.2,39942,360058
600000,5,540301.0,4,0.2,59699,540301
800000,5,720271.0,4,0.2,79729,720271
1000000,5,900187.0,4,0.2,99813,900187
2,6,2.0,2,0.1,0,2
3,6,3.0,2,0.1,0,3
100,6,82.0,54,2.7,18,82
200,6,175.0,104,5.2,25,175
2000,6,1766.0,1004,50.2,234,1766
10000,6,8750.0,5004,250.2,1250,8750
20000,6,17487.0,10004,500.2,2513,17487
40000,6,34952.0,20004,1000.2,5048,34952
60000,6,52383.0,30004,1500.2,7617,52383
80000,6,69833.0,40004,2000.2,10167,69833
100000,6,87288.0,50004,2500.2,12712,87288
200000,6,174797.0,100004,5000.2,25203,174797
400000,6,349779.0,200004,10000.2,50221,349779
600000,6,524790.0,300004,15000.2,75210,524790
800000,6,700159.0,400004,20000.2,99841,700159
1000000,6,875089.0,500004,25000.2,124911,875089
2,7,1.0,2,0.1,1,1
3,7,2.0,2,0.1,1,2
100,7,90.0,8,0.4,10,90
200,7,180.0,8,0.4,20,180
2000,7,1791.0,8,0.4,209,1791
10000,7,9005.0,8,0.4,995,9005
20000,7,18020.0,8,0.4,1980,18020
40000,7,36018.0,8,0.4,3982,36018
60000,7,54035.0,8,0.4,5965,54035
80000,7,72004.0,8,0.4,7996,72004
100000,7,89923.0,8,0.4,10077,89923
200000,7,179848.0,8,0.4,20152,179848
400000,7,359895.0,8,0.4,40105,359895
600000,7,539787.0,8,0.4,60213,539787
800000,7,719751.0,8,0.4,80249,719751
1000000,7,899879.0,8,0.4,100121,899879
2,8,2.0,2,0.1,0,2
3,8,3.0,2,0.1,0,3
100,8,93.0,54,2.7,7,93
200,8,182.0,104,5.2,18,182
2000,8,1753.0,1004,50.2,247,1753
10000,8,8754.0,5004,250.2,1246,8754
20000,8,17464.0,10004,500.2,2536,17464
40000,8,34877.0,20004,1000.2,5123,34877
60000,8,52393.0,30004,1500.2,7607,52393
80000,8,69935.0,40004,2000.2,10065,69935
100000,8,87402.0,50004,2500.2,12598,87402
200000,8,174859.0,100004,5000.2,25141,174859
400000,8,349682.0,200004,10000.2,50318,349682
600000,8,524910.0,300004,15000.2,75090,524910
800000,8,700042.0,400004,20000.2,99958,700042
1000000,8,874972.0,500004,25000.2,125028,874972
2,9,1.0,2,0.1,1,1
3,9,2.0,2,0.1,1,2
100,9,84.0,4,0.2,16,84
200,9,174.0,4,0.2,26,174
2000,9,1775.0,4,0.2,225,1775
10000,9,8945.0,4,0.2,1055,8945
20000,9,17957.0,4,0.2,2043,17957
40000,9,35908.0,4,0.2,4092,35908
60000,9,53929.0,4,0.2,6071,53929
80000,9,71902.0,4,0.2,8098,71902
100000,9,89853.0,4,0.2,10147,89853
200000,9,179928.0,4,0.2,20072,179928
400000,9,359872.0,4,0.2,40128,359872
600000,9,539860.0,4,0.2,60140,539860
800000,9,719927.0,4,0.2,80073,719927
1000000,9,900074.0,4,0.2,99926,900074
2,10,2.0,2,0.1,0,2
3,10,3.0,2,0.1,0,3
100,10,85.0,98,4.9,15,85
200,10,172.0,198,9.9,28,172
2000,10,1728.0,1998,99.9,272,1728
10000,10,8564.0,9998,499.9,1436,8564
20000,10,17056.0,19998,999.9,2944,17056
40000,10,34052.0,39998,1999.9,5948,34052
60000,10,51114.0,59998,2999.9,8886,51114
80000,10,68126.0,79998,3999.9,11874,68126
100000,10,85096.0,99998,4999.9,14904,85096
200000,10,170203.0,199998,9999.9,29797,170203
400000,10,340219.0,399998,19999.9,59781,340219
600000,10,510115.0,599998,29999.9,89885,510115
800000,10,680130.0,799998,39999.9,119870,680130
1000000,10,849965.0,999998,49999.9,150035,849965
2,11,2.0,2,0.1,0,2
3,11,3.0,2,0.1,0,3
100,11,86.0,93,4.65,14,86
200,11,167.0,193,9.65,33,167
2000,11,1680.0,1993,99.65,320,1680
10000,11,8474.0,9993,499.65,1526,8474
20000,11,16962.0,19993,999.65,3038,16962
40000,11,34060.0,39993,1999.65,5940,34060
60000,11,50997.0,59993,2999.65,9003,50997
80000,11,67962.0,79993,3999.65,12038,67962
100000,11,84922.0,99993,4999.65,15078,84922
200000,11,169942.0,199993,9999.65,30058,169942
400000,11,339987.0,399993,19999.65,60013,339987
600000,11,510016.0,599993,29999.65,89984,510016
800000,11,680241.0,799993,39999.65,119759,680241
1000000,11,850176.0,999993,49999.65,149824,850176
2,12,2.0,2,0.1,0,2
3,12,3.0,2,0.1,0,3
100,12,92.0,54,2.7,8,92
200,12,178.0,104,5.2,22,178
2000,12,1759.0,1004,50.2,241,1759
10000,12,8740.0,5004,250.2,1260,8740
20000,12,17469.0,10004,500.2,2531,17469
40000,12,34877.0,20004,1000.2,5123,34877
60000,12,52311.0,30004,1500.2,7689,52311
80000,12,69828.0,40004,2000.2,10172,69828
100000,12,87381.0,50004,2500.2,12619,87381
200000,12,174858.0,100004,5000.2,25142,174858
400000,12,349898.0,200004,10000.2,50102,349898
600000,12,524960.0,300004,15000.2,75040,524960
800000,12,699930.0,400004,20000.2,100070,699930
1000000,12,874858.0,500004,25000.2,125142,874858
2,13,2.0,2,0.1,0,2
3,13,3.0,2,0.1,0,3
100,13,88.0,52,2.6,12,88
200,13,183.0,102,5.1,17,183
2000,13,1745.0,1002,50.1,255,1745
10000,13,8739.0,5002,250.1,1261,8739
20000,13,17493.0,10002,500.1,2507,17493
40000,13,34954.0,20002,1000.1,5046,34954
60000,13,52411.0,30002,1500.1,7589,52411
80000,13,69920.0,40002,2000.1,10080,69920
100000,13,87384.0,50002,2500.1,12616,87384
200000,13,174968.0,100002,5000.1,25032,174968
400000,13,349765.0,200002,10000.1,50235,349765
600000,13,524670.0,300002,15000.1,75330,524670
800000,13,699913.0,400002,20000.1,100087,699913
1000000,13,875062.0,500002,25000.1,124938,875062
2,14,2.0,2,0.1,0,2
3,14,3.0,2,0.1,0,3
100,14,84.0,97,4.85,16,84
200,14,166.0,197,9.85,34,166
2000,14,1684.0,1997,99.85,316,1684
10000,14,8492.0,9997,499.85,1508,8492
20000,14,17012.0,19997,999.85,2988,17012
40000,14,34162.0,39997,1999.85,5838,34162
60000,14,51162.0,59997,2999.85,8838,51162
80000,14,68083.0,79997,3999.85,11917,68083
100000,14,85070.0,99997,4999.85,14930,85070
200000,14,170064.0,199997,9999.85,29936,170064
400000,14,339991.0,399997,19999.85,60009,339991
600000,14,509776.0,599997,29999.85,90224,509776
800000,14,679814.0,799997,39999.85,120186,679814
1000000,14,849993.0,999997,49999.85,150007,849993
2,15,2.0,2,0.1,0,2
3,15,3.0,2,0.1,0,3
100,15,95.0,67,3.35,5,95
200,15,187.0,134,6.7,13,187
2000,15,1751.0,1334,66.7,249,1751
10000,15,8677.0,6667,333.35,1323,8677
20000,15,17359.0,13334,666.7,2641,17359
40000,15,34722.0,26667,1333.35,5278,34722
60000,15,52065.0,40000,2000.0,7935,52065
80000,15,69500.0,53334,2666.7,10500,69500
100000,15,86864.0,66667,3333.35,13136,86864
200000,15,173675.0,133334,6666.7,26325,173675
400000,15,347143.0,266667,13333.35,52857,347143
600000,15,520491.0,400000,20000.0,79509,520491
800000,15,693913.0,533334,26666.7,106087,693913
1000000,15,867483.0,666667,33333.35,132517,867483
2,16,1.0,2,0.1,1,1
3,16,2.0,2,0.1,1,2
100,16,86.0,92,4.6,14,86
200,16,175.0,192,9.6,25,175
2000,16,1703.0,1992,99.6,297,1703
10000,16,8524.0,9992,499.6,1476,8524
20000,16,17037.0,19992,999.6,2963,17037
40000,16,34080.0,39992,1999.6,5920,34080
60000,16,51108.0,59992,2999.6,8892,51108
80000,16,68125.0,79992,3999.6,11875,68125
100000,16,85086.0,99992,4999.6,14914,85086
200000,16,170141.0,199992,9999.6,29859,170141
400000,16,340120.0,399992,19999.6,59880,340120
600000,16,510042.0,599992,29999.6,89958,510042
800000,16,680063.0,799992,39999.6,119937,680063
1000000,16,850034.0,999992,49999.6,149966,850034
2,17,1.0,2,0.1,1,1
3,17,2.0,2,0.1,1,2
100,17,87.0,6,0.3,13,87
200,17,173.0,6,0.3,27,173
2000,17,1791.0,6,0.3,209,1791
10000,17,9025.0,6,0.3,975,9025
20000,17,18048.0,6,0.3,1952,18048
40000,17,36121.0,6,0.3,3879,36121
60000,17,54103.0,6,0.3,5897,54103
80000,17,72146.0,6,0.3,7854,72146
100000,17,90167.0,6,0.3,9833,90167
200000,17,180329.0,6,0.3,19671,180329
400000,17,360212.0,6,0.3,39788,360212
600000,17,540283.0,6,0.3,59717,540283
800000,17,720380.0,6,0.3,79620,720380
1000000,17,900244.0,6,0.3,99756,900244
2,18,2.0,2,0.1,0,2
3,18,3.0,2,0.1,0,3
100,18,91.0,13,0.65,9,91
200,18,186.0,13,0.65,14,186
2000,18,1811.0,13,0.65,189,1811
10000,18,9027.0,13,0.65,973,9027
20000,18,18041.0,13,0.65,1959,18041
40000,18,35968.0,13,0.65,4032,35968
60000,18,53967.0,13,0.65,6033,53967
80000,18,71891.0,13,0.65,8109,71891
100000,18,89911.0,13,0.65,10089,89911
200000,18,179916.0,13,0.65,20084,179916
400000,18,359938.0,13,0.65,40062,359938
600000,18,539970.0,13,0.65,60030,539970
800000,18,720035.0,13,0.65,79965,720035
1000000,18,899903.0,13,0.65,100097,899903
2,19,2.0,2,0.1,0,2
3,19,2.0,2,0.1,1,2
100,19,89.0,99,4.95,11,89
200,19,169.0,199,9.95,31,169
2000,19,1693.0,1999,99.95,307,1693
10000,19,8525.0,9999,499.95,1475,8525
20000,19,17058.0,19999,999.95,2942,17058
40000,19,34047.0,39999,1999.95,5953,34047
60000,19,51088.0,59999,2999.95,8912,51088
80000,19,68076.0,79999,3999.95,11924,68076
100000,19,85104.0,99999,4999.95,14896,85104
200000,19,170331.0,199999,9999.95,29669,170331
400000,19,340376.0,399999,19999.95,59624,340376
600000,19,510254.0,599999,29999.95,89746,510254
800000,19,680583.0,799999,39999.95,119417,680583
1000000,19,850516.0,999999,49999.95,149484,850516
2,20,2.0,2,0.1,0,2
3,20,3.0,2,0.1,0,3
100,20,90.0,93,4.65,10,90
200,20,171.0,193,9.65,29,171
2000,20,1709.0,1993,99.65,291,1709
10000,20,8509.0,9993,499.65,1491,8509
20000,20,16957.0,19993,999.65,3043,16957
40000,20,34060.0,39993,1999.65,5940,34060
60000,20,51121.0,59993,2999.65,8879,51121
80000,20,68067.0,79993,3999.65,11933,68067
100000,20,85106.0,99993,4999.65,14894,85106
200000,20,170344.0,199993,9999.65,29656,170344
400000,20,340171.0,399993,19999.65,59829,340171
600000,20,509896.0,599993,29999.65,90104,509896
800000,20,679724.0,799993,39999.65,120276,679724
1000000,20,849845.0,999993,49999.65,150155,849845
2,21,1.0,2,0.1,1,1
3,21,2.0,2,0.1,1,2
100,21,87.0,51,2.55,13,87
200,21,171.0,101,5.05,29,171
2000,21,1748.0,1001,50.05,252,1748
10000,21,8723.0,5001,250.05,1277,8723
20000,21,17482.0,10001,500.05,2518,17482
40000,21,34986.0,20001,1000.05,5014,34986
60000,21,52413.0,30001,1500.05,7587,52413
80000,21,69974.0,40001,2000.05,10026,69974
100000,21,87433.0,50001,2500.05,12567,87433
200000,21,174924.0,100001,5000.05,25076,174924
400000,21,349753.0,200001,10000.05,50247,349753
600000,21,524509.0,300001,15000.05,75491,524509
800000,21,699574.0,400001,20000.05,100426,699574
1000000,21,874552.0,500001,25000.05,125448,874552
2,22,1.0,2,0.1,1,1
3,22,2.0,2,0.1,1,2
100,22,85.0,7,0.35,15,85
200,22,173.0,7,0.35,27,173
2000,22,1813.0,7,0.35,187,1813
10000,22,8982.0,7,0.35,1018,8982
20000,22,18028.0,7,0.35,1972,18028
40000,22,36028.0,7,0.35,3972,36028
60000,22,54035.0,7,0.35,5965,54035
80000,22,72034.0,7,0.35,7966,72034
100000,22,90028.0,7,0.35,9972,90028
200000,22,180089.0,7,0.35,19911,180089
400000,22,360261.0,7,0.35,39739,360261
600000,22,540116.0,7,0.35,59884,540116
800000,22,720090.0,7,0.35,79910,720090
1000000,22,900059.0,7,0.35,99941,900059
2,23,2.0,2,0.1,0,2
3,23,3.0,2,0.1,0,3
100,23,89.0,52,2.6,11,89
200,23,182.0,102,5.1,18,182
2000,23,1746.0,1002,50.1,254,1746
10000,23,8735.0,5002,250.1,1265,8735
20000,23,17532.0,10002,500.1,2468,17532
40000,23,35039.0,20002,1000.1,4961,35039
60000,23,52515.0,30002,1500.1,7485,52515
80000,23,70026.0,40002,2000.1,9974,70026
100000,23,87526.0,50002,2500.1,12474,87526
200000,23,175060.0,100002,5000.1,24940,175060
400000,23,350243.0,200002,10000.1,49757,350243
600000,23,525304.0,300002,15000.1,74696,525304
800000,23,700307.0,400002,20000.1,99693,700307
1000000,23,875290.0,500002,25000.1,124710,875290
2,24,2.0,2,0.1,0,2
3,24,3.0,2,0.1,0,3
100,24,89.0,12,0.6,11,89
200,24,183.0,12,0.6,17,183
2000,24,1819.0,12,0.6,181,1819
10000,24,9010.0,12,0.6,990,9010
20000,24,17993.0,12,0.6,2007,17993
40000,24,35963.0,12,0.6,4037,35963
60000,24,53987.0,12,0.6,6013,53987
80000,24,71936.0,12,0.6,8064,71936
100000,24,89964.0,12,0.6,10036,89964
200000,24,180247.0,12,0.6,19753,180247
400000,24,360129.0,12,0.6,39871,360129
600000,24,540090.0,12,0.6,59910,540090
800000,24,720042.0,12,0.6,79958,720042
1000000,24,899909.0,12,0.6,100091,899909
2,25,1.0,2,0.1,1,1
3,25,2.0,2,0.1,1,2
100,25,88.0,3,0.15,12,88
200,25,183.0,3,0.15,17,183
2000,25,1797.0,3,0.15,203,1797
10000,25,9009.0,3,0.15,991,9009
20000,25,18011.0,3,0.15,1989,18011
40000,25,36001.0,3,0.15,3999,36001
60000,25,53948.0,3,0.15,6052,53948
80000,25,71916.0,3,0.15,8084,71916
100000,25,89965.0,3,0.15,10035,89965
200000,25,179912.0,3,0.15,20088,179912
400000,25,359688.0,3,0.15,40312,359688
600000,25,539776.0,3,0.15,60224,539776
800000,25,719752.0,3,0.15,80248,719752
1000000,25,899915.0,3,0.15,100085,899915
2,26,1.0,2,0.1,1,1
3,26,2.0,2,0.1,1,2
100,26,87.0,4,0.2,13,87
200,26,172.0,4,0.2,28,172
2000,26,1786.0,4,0.2,214,1786
10000,26,9043.0,4,0.2,957,9043
20000,26,18047.0,4,0.2,1953,18047
40000,26,36032.0,4,0.2,3968,36032
60000,26,53921.0,4,0.2,6079,53921
80000,26,71986.0,4,0.2,8014,71986
100000,26,89975.0,4,0.2,10025,89975
200000,26,179950.0,4,0.2,20050,179950
400000,26,359904.0,4,0.2,40096,359904
600000,26,539848.0,4,0.2,60152,539848
800000,26,719713.0,4,0.2,80287,719713
1000000,26,899547.0,4,0.2,100453,899547
2,27,2.0,2,0.1,0,2
3,27,3.0,2,0.1,0,3
100,27,85.0,54,2.7,15,85
200,27,172.0,104,5.2,28,172
2000,27,1741.0,1004,50.2,259,1741
10000,27,8704.0,5004,250.2,1296,8704
20000,27,17364.0,10004,500.2,2636,17364
40000,27,34884.0,20004,1000.2,5116,34884
60000,27,52343.0,30004,1500.2,7657,52343
80000,27,69857.0,40004,2000.2,10143,69857
100000,27,87417.0,50004,2500.2,12583,87417
200000,27,174966.0,100004,5000.2,25034,174966
400000,27,349845.0,200004,10000.2,50155,349845
600000,27,524958.0,300004,15000.2,75042,524958
800000,27,699979.0,400004,20000.2,100021,699979
1000000,27,874899.0,500004,25000.2,125101,874899
2,28,2.0,2,0.1,0,2
3,28,3.0,2,0.1,0,3
100,28,92.0,52,2.6,8,92
200,28,180.0,102,5.1,20,180
2000,28,1775.0,1002,50.1,225,1775
10000,28,8750.0,5002,250.1,1250,8750
20000,28,17439.0,10002,500.1,2561,17439
40000,28,34950.0,20002,1000.1,5050,34950
60000,28,52538.0,30002,1500.1,7462,52538
80000,28,70043.0,40002,2000.1,9957,70043
100000,28,87514.0,50002,2500.1,12486,87514
200000,28,174959.0,100002,5000.1,25041,174959
400000,28,349501.0,200002,10000.1,50499,349501
600000,28,524634.0,300002,15000.1,75366,524634
800000,28,699651.0,400002,20000.1,100349,699651
1000000,28,874873.0,500002,25000.1,125127,874873
2,29,0.0,2,0.1,2,0
3,29,1.0,2,0.1,2,1
100,29,88.0,2,0.1,12,88
200,29,177.0,2,0.1,23,177
2000,29,1795.0,2,0.1,205,1795
10000,29,9009.0,2,0.1,991,9009
20000,29,18030.0,2,0.1,1970,18030
40000,29,35990.0,2,0.1,4010,35990
60000,29,54025.0,2,0.1,5975,54025
80000,29,71988.0,2,0.1,8012,71988
100000,29,90016.0,2,0.1,9984,90016
200000,29,179916.0,2,0.1,20084,179916
400000,29,359892.0,2,0.1,40108,359892
600000,29,539942.0,2,0.1,60058,539942
800000,29,720259.0,2,0.1,79741,720259
1000000,29,900285.0,2,0.1,99715,900285
2,30,2.0,2,0.1,0,2
3,30,3.0,2,0.1,0,3
100,30,94.0,92,4.6,6,94
200,30,184.0,192,9.6,16,184
2000,30,1697.0,1992,99.6,303,1697
10000,30,8526.0,9992,499.6,1474,8526
20000,30,17061.0,19992,999.6,2939,17061
40000,30,34034.0,39992,1999.6,5966,34034
60000,30,50929.0,59992,2999.6,9071,50929
80000,30,67964.0,79992,3999.6,12036,67964
100000,30,84985.0,99992,4999.6,15015,84985
200000,30,170051.0,199992,9999.6,29949,170051
400000,30,340141.0,399992,19999.6,59859,340141
600000,30,510078.0,599992,29999.6,89922,510078
800000,30,680280.0,799992,39999.6,119720,680280
1000000,30,850118.0,999992,49999.6,149882,850118
2,31,2.0,2,0.1,0,2
3,31,3.0,2,0.1,0,3
100,31,87.0,98,4.9,13,87
200,31,175.0,198,9.9,25,175
2000,31,1703.0,1998,99.9,297,1703
10000,31,8544.0,9998,499.9,1456,8544
20000,31,17113.0,19998,999.9,2887,17113
40000,31,34104.0,39998,1999.9,5896,34104
60000,31,51151.0,59998,2999.9,8849,51151
80000,31,68098.0,79998,3999.9,11902,68098
100000,31,85044.0,99998,4999.9,14956,85044
200000,31,170155.0,199998,9999.9,29845,170155
400000,31,340324.0,399998,19999.9,59676,340324
600000,31,510368.0,599998,29999.9,89632,510368
800000,31,680492.0,799998,39999.9,119508,680492
1000000,31,850260.0,999998,49999.9,149740,850260
2,32,1.0,2,0.1,1,1
3,32,1.0,2,0.1,2,1
100,32,83.0,99,4.95,17,83
200,32,162.0,199,9.95,38,162
2000,32,1712.0,1999,99.95,288,1712
10000,32,8546.0,9999,499.95,1454,8546
20000,32,17090.0,19999,999.95,2910,17090
40000,32,34093.0,39999,1999.95,5907,34093
60000,32,51169.0,59999,2999.95,8831,51169
80000,32,68184.0,79999,3999.95,11816,68184
100000,32,85216.0,99999,4999.95,14784,85216
200000,32,170220.0,199999,9999.95,29780,170220
400000,32,340072.0,399999,19999.95,59928,340072
600000,32,509940.0,599999,29999.95,90060,509940
800000,32,679992.0,799999,39999.95,120008,679992
1000000,32,849978.0,999999,49999.95,150022,849978
2,33,2.0,2,0.1,0,2
3,33,3.0,2,0.1,0,3
100,33,96.0,53,2.65,4,96
200,33,181.0,103,5.15,19,181
2000,33,1737.0,1003,50.15,263,1737
10000,33,8673.0,5003,250.15,1327,8673
20000,33,17455.0,10003,500.15,2545,17455
40000,33,34970.0,20003,1000.15,5030,34970
60000,33,52476.0,30003,1500.15,7524,52476
80000,33,69937.0,40003,2000.15,10063,69937
100000,33,87420.0,50003,2500.15,12580,87420
200000,33,175046.0,100003,5000.15,24954,175046
400000,33,350113.0,200003,10000.15,49887,350113
600000,33,525135.0,300003,15000.15,74865,525135
800000,33,700224.0,400003,20000.15,99776,700224
1000000,33,875081.0,500003,25000.15,124919,875081
2,34,2.0,2,0.1,0,2
3,34,3.0,2,0.1,0,3
100,34,92.0,54,2.7,8,92
200,34,175.0,104,5.2,25,175
2000,34,1755.0,1004,50.2,245,1755
10000,34,8782.0,5004,250.2,1218,8782
20000,34,17558.0,10004,500.2,2442,17558
40000,34,35114.0,20004,1000.2,4886,35114
60000,34,52538.0,30004,1500.2,7462,52538
80000,34,69996.0,40004,2000.2,10004,69996
100000,34,87456.0,50004,2500.2,12544,87456
200000,34,175118.0,100004,5000.2,24882,175118
400000,34,350151.0,200004,10000.2,49849,350151
600000,34,525108.0,300004,15000.2,74892,525108
800000,34,700206.0,400004,20000.2,99794,700206
1000000,34,875615.0,500004,25000.2,124385,875615
2,35,1.0,2,0.1,1,1
3,35,2.0,2,0.1,1,2
100,35,85.0,98,4.9,15,85
200,35,168.0,198,9.9,32,168
2000,35,1682.0,1998,99.9,318,1682
10000,35,8490.0,9998,499.9,1510,8490
20000,35,16965.0,19998,999.9,3035,16965
40000,35,33893.0,39998,1999.9,6107,33893
60000,35,50946.0,59998,2999.9,9054,50946
80000,35,67884.0,79998,3999.9,12116,67884
100000,35,84865.0,99998,4999.9,15135,84865
200000,35,169926.0,199998,9999.9,30074,169926
400000,35,339863.0,399998,19999.9,60137,339863
600000,35,509774.0,599998,29999.9,90226,509774
800000,35,679752.0,799998,39999.9,120248,679752
1000000,35,849678.0,999998,49999.9,150322,849678
2,36,1.0,2,0.1,1,1
3,36,2.0,2,0.1,1,2
100,36,87.0,51,2.55,13,87
200,36,172.0,101,5.05,28,172
2000,36,1739.0,1001,50.05,261,1739
10000,36,8715.0,5001,250.05,1285,8715
20000,36,17446.0,10001,500.05,2554,17446
40000,36,34970.0,20001,1000.05,5030,34970
60000,36,52478.0,30001,1500.05,7522,52478
80000,36,69961.0,40001,2000.05,10039,69961
100000,36,87482.0,50001,2500.05,12518,87482
200000,36,175039.0,100001,5000.05,24961,175039
400000,36,349918.0,200001,10000.05,50082,349918
600000,36,525019.0,300001,15000.05,74981,525019
800000,36,700237.0,400001,20000.05,99763,700237
1000000,36,875137.0,500001,25000.05,124863,875137
2,37,2.0,2,0.1,0,2
3,37,3.0,2,0.1,0,3
100,37,81.0,96,4.8,19,81
200,37,169.0,196,9.8,31,169
2000,37,1683.0,1996,99.8,317,1683
10000,37,8435.0,9996,499.8,1565,8435
20000,37,16898.0,19996,999.8,3102,16898
40000,37,33825.0,39996,1999.8,6175,33825
60000,37,50781.0,59996,2999.8,9219,50781
80000,37,67799.0,79996,3999.8,12201,67799
100000,37,84801.0,99996,4999.8,15199,84801
200000,37,169727.0,199996,9999.8,30273,169727
400000,37,339562.0,399996,19999.8,60438,339562
600000,37,509702.0,599996,29999.8,90298,509702
800000,37,679718.0,799996,39999.8,120282,679718
1000000,37,849801.0,999996,49999.8,150199,849801
2,38,2.0,2,0.1,0,2
3,38,2.0,2,0.1,1,2
100,38,86.0,99,4.95,14,86
200,38,168.0,199,9.95,32,168
2000,38,1698.0,1999,99.95,302,1698
10000,38,8464.0,9999,499.95,1536,8464
20000,38,16933.0,19999,999.95,3067,16933
40000,38,34022.0,39999,1999.95,5978,34022
60000,38,50935.0,59999,2999.95,9065,50935
80000,38,67928.0,79999,3999.95,12072,67928
100000,38,84855.0,99999,4999.95,15145,84855
200000,38,169894.0,199999,9999.95,30106,169894
400000,38,340062.0,399999,19999.95,59938,340062
600000,38,510115.0,599999,29999.95,89885,510115
800000,38,680091.0,799999,39999.95,119909,680091
1000000,38,849977.0,999999,49999.95,150023,849977
2,39,2.0,2,0.1,0,2
3,39,3.0,2,0.1,0,3
100,39,91.0,67,3.35,9,91
200,39,182.0,134,6.7,18,182
2000,39,1724.0,1334,66.7,276,1724
10000,39,8700.0,6667,333.35,1300,8700
20000,39,17356.0,13334,666.7,2644,17356
40000,39,34579.0,26667,1333.35,5421,34579
60000,39,51893.0,40000,2000.0,8107,51893
80000,39,69172.0,53334,2666.7,10828,69172
100000,39,86514.0,66667,3333.35,13486,86514
200000,39,173210.0,133334,6666.7,26790,173210
400000,39,346683.0,266667,13333.35,53317,346683
600000,39,520242.0,400000,20000.0,79758,520242
800000,39,693549.0,533334,26666.7,106451,693549
1000000,39,866913.0,666667,33333.35,133087,866913
2,40,2.0,2,0.1,0,2
3,40,3.0,2,0.1,0,3
100,40,91.0,96,4.8,9,91
200,40,177.0,196,9.8,23,177
2000,40,1723.0,1996,99.8,277,1723
10000,40,8568.0,9996,499.8,1432,8568
20000,40,17038.0,19996,999.8,2962,17038
40000,40,34037.0,39996,1999.8,5963,34037
60000,40,51046.0,59996,2999.8,8954,51046
80000,40,68066.0,79996,3999.8,11934,68066
100000,40,85020.0,99996,4999.8,14980,85020
200000,40,169923.0,199996,9999.8,30077,169923
400000,40,339733.0,399996,19999.8,60267,339733
600000,40,509729.0,599996,29999.8,90271,509729
800000,40,679870.0,799996,39999.8,120130,679870
1000000,40,849756.0,999996,49999.8,150244,849756
2,41,1.0,2,0.1,1,1
3,41,2.0,2,0.1,1,2
100,41,93.0,8,0.4,7,93
200,41,185.0,8,0.4,15,185
2000,41,1815.0,8,0.4,185,1815
10000,41,9046.0,8,0.4,954,9046
20000,41,18059.0,8,0.4,1941,18059
40000,41,36013.0,8,0.4,3987,36013
60000,41,54068.0,8,0.4,5932,54068
80000,41,72069.0,8,0.4,7931,72069
100000,41,90135.0,8,0.4,9865,90135
200000,41,180162.0,8,0.4,19838,180162
400000,41,360165.0,8,0.4,39835,360165
600000,41,540061.0,8,0.4,59939,540061
800000,41,720037.0,8,0.4,79963,720037
1000000,41,900040.0,8,0.4,99960,900040
2,42,1.0,2,0.1,1,1
3,42,2.0,2,0.1,1,2
100,42,86.0,51,2.55,14,86
200,42,179.0,101,5.05,21,179
2000,42,1790.0,1001,50.05,210,1790
10000,42,8770.0,5001,250.05,1230,8770
20000,42,17505.0,10001,500.05,2495,17505
40000,42,34942.0,20001,1000.05,5058,34942
60000,42,52496.0,30001,1500.05,7504,52496
80000,42,69991.0,40001,2000.05,10009,69991
100000,42,87490.0,50001,2500.05,12510,87490
200000,42,174986.0,100001,5000.05,25014,174986
400000,42,349999.0,200001,10000.05,50001,349999
600000,42,524999.0,300001,15000.05,75001,524999
800000,42,699968.0,400001,20000.05,100032,699968
1000000,42,874846.0,500001,25000.05,125154,874846
2,43,1.0,2,0.1,1,1
3,43,2.0,2,0.1,1,2
100,43,92.0,51,2.55,8,92
200,43,173.0,101,5.05,27,173
2000,43,1740.0,1001,50.05,260,1740
10000,43,8676.0,5001,250.05,1324,8676
20000,43,17402.0,10001,500.05,2598,17402
40000,43,34911.0,20001,1000.05,5089,34911
60000,43,52359.0,30001,1500.05,7641,52359
80000,43,69804.0,40001,2000.05,10196,69804
100000,43,87350.0,50001,2500.05,12650,87350
200000,43,174698.0,100001,5000.05,25302,174698
400000,43,349682.0,200001,10000.05,50318,349682
600000,43,524462.0,300001,15000.05,75538,524462
800000,43,699544.0,400001,20000.05,100456,699544
1000000,43,874739.0,500001,25000.05,125261,874739
2,44,2.0,2,0.1,0,2
3,44,3.0,2,0.1,0,3
100,44,92.0,52,2.6,8,92
200,44,182.0,102,5.1,18,182
2000,44,1740.0,1002,50.1,260,1740
10000,44,8751.0,5002,250.1,1249,8751
20000,44,17514.0,10002,500.1,2486,17514
40000,44,35025.0,20002,1000.1,4975,35025
60000,44,52535.0,30002,1500.1,7465,52535
80000,44,70091.0,40002,2000.1,9909,70091
100000,44,87655.0,50002,2500.1,12345,87655
200000,44,175120.0,100002,5000.1,24880,175120
400000,44,350075.0,200002,10000.1,49925,350075
600000,44,524993.0,300002,15000.1,75007,524993
800000,44,700036.0,400002,20000.1,99964,700036
1000000,44,875017.0,500002,25000.1,124983,875017
2,45,0.0,2,0.1,2,0
3,45,1.0,2,0.1,2,1
100,45,89.0,2,0.1,11,89
200,45,174.0,2,0.1,26,174
2000,45,1794.0,2,0.1,206,1794
10000,45,8965.0,2,0.1,1035,8965
20000,45,18001.0,2,0.1,1999,18001
40000,45,35993.0,2,0.1,4007,35993
60000,45,54020.0,2,0.1,5980,54020
80000,45,72002.0,2,0.1,7998,72002
100000,45,90012.0,2,0.1,9988,90012
200000,45,180067.0,2,0.1,19933,180067
400000,45,360194.0,2,0.1,39806,360194
600000,45,540141.0,2,0.1,59859,540141
800000,45,719978.0,2,0.1,80022,719978
1000000,45,899958.0,2,0.1,100042,899958
2,46,2.0,2,0.1,0,2
3,46,3.0,2,0.1,0,3
100,46,90.0,9,0.45,10,90
200,46,175.0,9,0.45,25,175
2000,46,1810.0,9,0.45,190,1810
10000,46,9015.0,9,0.45,985,9015
20000,46,18020.0,9,0.45,1980,18020
40000,46,35974.0,9,0.45,4026,35974
60000,46,53999.0,9,0.45,6001,53999
80000,46,71994.0,9,0.45,8006,71994
100000,46,90005.0,9,0.45,9995,90005
200000,46,179976.0,9,0.45,20024,179976
400000,46,359823.0,9,0.45,40177,359823
600000,46,539924.0,9,0.45,60076,539924
800000,46,719800.0,9,0.45,80200,719800
1000000,46,899804.0,9,0.45,100196,899804
2,47,2.0,2,0.1,0,2
3,47,3.0,2,0.1,0,3
100,47,89.0,9,0.45,11,89
200,47,179.0,9,0.45,21,179
2000,47,1776.0,9,0.45,224,1776
10000,47,9003.0,9,0.45,997,9003
20000,47,17965.0,9,0.45,2035,17965
40000,47,36015.0,9,0.45,3985,36015
60000,47,53981.0,9,0.45,6019,53981
80000,47,71987.0,9,0.45,8013,71987
100000,47,90015.0,9,0.45,9985,90015
200000,47,179868.0,9,0.45,20132,179868
400000,47,359936.0,9,0.45,40064,359936
600000,47,539929.0,9,0.45,60071,539929
800000,47,719919.0,9,0.45,80081,719919
1000000,47,900071.0,9,0.45,99929,900071
2,48,1.0,2,0.1,1,1
3,48,2.0,2,0.1,1,2
100,48,89.0,4,0.2,11,89
200,48,179.0,4,0.2,21,179
2000,48,1799.0,4,0.2,201,1799
10000,48,8962.0,4,0.2,1038,8962
20000,48,17922.0,4,0.2,2078,17922
40000,48,36001.0,4,0.2,3999,36001
60000,48,53995.0,4,0.2,6005,53995
80000,48,71892.0,4,0.2,8108,71892
100000,48,89974.0,4,0.2,10026,89974
200000,48,180047.0,4,0.2,19953,180047
400000,48,360089.0,4,0.2,39911,360089
600000,48,539764.0,4,0.2,60236,539764
800000,48,719892.0,4,0.2,80108,719892
1000000,48,899991.0,4,0.2,100009,899991
2,49,2.0,2,0.1,0,2
3,49,3.0,2,0.1,0,3
100,49,90.0,94,4.7,10,90
200,49,175.0,194,9.7,25,175
2000,49,1701.0,1994,99.7,299,1701
10000,49,8473.0,9994,499.7,1527,8473
20000,49,17006.0,19994,999.7,2994,17006
40000,49,34030.0,39994,1999.7,5970,34030
60000,49,51133.0,59994,2999.7,8867,51133
80000,49,68081.0,79994,3999.7,11919,68081
100000,49,85205.0,99994,4999.7,14795,85205
200000,49,170051.0,199994,9999.7,29949,170051
400000,49,340159.0,399994,19999.7,59841,340159
600000,49,510414.0,599994,29999.7,89586,510414
800000,49,680238.0,799994,39999.7,119762,680238
1000000,49,850131.0,999994,49999.7,149869,850131
2,50,2.0,2,0.1,0,2
3,50,3.0,2,0.1,0,3
100,50,87.0,98,4.9,13,87
200,50,167.0,198,9.9,33,167
2000,50,1677.0,1998,99.9,323,1677
10000,50,8507.0,9998,499.9,1493,8507
20000,50,17011.0,19998,999.9,2989,17011
40000,50,33985.0,39998,1999.9,6015,33985
60000,50,51006.0,59998,2999.9,8994,51006
80000,50,67954.0,79998,3999.9,12046,67954
100000,50,84894.0,99998,4999.9,15106,84894
200000,50,169993.0,199998,9999.9,30007,169993
400000,50,339678.0,399998,19999.9,60322,339678
600000,50,509542.0,599998,29999.9,90458,509542
800000,50,679537.0,799998,39999.9,120463,679537
1000000,50,849566.0,999998,49999.9,150434,849566
2,51,2.0,2,0.1,0,2
3,51,3.0,2,0.1,0,3
100,51,94.0,7,0.35,6,94
200,51,187.0,7,0.35,13,187
2000,51,1822.0,7,0.35,178,1822
10000,51,9060.0,7,0.35,940,9060
20000,51,17994.0,7,0.35,2006,17994
40000,51,36009.0,7,0.35,3991,36009
60000,51,53966.0,7,0.35,6034,53966
80000,51,72030.0,7,0.35,7970,72030
100000,51,90079.0,7,0.35,9921,90079
200000,51,180051.0,7,0.35,19949,180051
400000,51,360021.0,7,0.35,39979,360021
600000,51,539934.0,7,0.35,60066,539934
800000,51,719919.0,7,0.35,80081,719919
1000000,51,899854.0,7,0.35,100146,899854
2,52,2.0,2,0.1,0,2
3,52,3.0,2,0.1,0,3
100,52,88.0,51,2.55,12,88
200,52,180.0,101,5.05,20,180
2000,52,1758.0,1001,50.05,242,1758
10000,52,8760.0,5001,250.05,1240,8760
20000,52,17547.0,10001,500.05,2453,17547
40000,52,35088.0,20001,1000.05,4912,35088
60000,52,52576.0,30001,1500.05,7424,52576
80000,52,70061.0,40001,2000.05,9939,70061
100000,52,87523.0,50001,2500.05,12477,87523
200000,52,175059.0,100001,5000.05,24941,175059
400000,52,350149.0,200001,10000.05,49851,350149
600000,52,525117.0,300001,15000.05,74883,525117
800000,52,700141.0,400001,20000.05,99859,700141
1000000,52,875243.0,500001,25000.05,124757,875243
2,53,2.0,2,0.1,0,2
3,53,3.0,2,0.1,0,3
100,53,82.0,97,4.85,18,82
200,53,168.0,197,9.85,32,168
2000,53,1701.0,1997,99.85,299,1701
10000,53,8531.0,9997,499.85,1469,8531
20000,53,17009.0,19997,999.85,2991,17009
40000,53,33985.0,39997,1999.85,6015,33985
60000,53,50945.0,59997,2999.85,9055,50945
80000,53,67998.0,79997,3999.85,12002,67998
100000,53,84951.0,99997,4999.85,15049,84951
200000,53,169979.0,199997,9999.85,30021,169979
400000,53,340111.0,399997,19999.85,59889,340111
600000,53,510069.0,599997,29999.85,89931,510069
800000,53,680095.0,799997,39999.85,119905,680095
1000000,53,850256.0,999997,49999.85,149744,850256
2,54,2.0,2,0.1,0,2
3,54,3.0,2,0.1,0,3
100,54,88.0,53,2.65,12,88
200,54,179.0,103,5.15,21,179
2000,54,1759.0,1003,50.15,241,1759
10000,54,8768.0,5003,250.15,1232,8768
20000,54,17542.0,10003,500.15,2458,17542
40000,54,35029.0,20003,1000.15,4971,35029
60000,54,52513.0,30003,1500.15,7487,52513
80000,54,70026.0,40003,2000.15,9974,70026
100000,54,87551.0,50003,2500.15,12449,87551
200000,54,174968.0,100003,5000.15,25032,174968
400000,54,349860.0,200003,10000.15,50140,349860
600000,54,525109.0,300003,15000.15,74891,525109
800000,54,700252.0,400003,20000.15,99748,700252
1000000,54,875407.0,500003,25000.15,124593,875407
2,55,2.0,2,0.1,0,2
3,55,3.0,2,0.1,0,3
100,55,88.0,52,2.6,12,88
200,55,168.0,102,5.1,32,168
2000,55,1767.0,1002,50.1,233,1767
10000,55,8747.0,5002,250.1,1253,8747
20000,55,17520.0,10002,500.1,2480,17520
40000,55,34984.0,20002,1000.1,5016,34984
60000,55,52528.0,30002,1500.1,7472,52528
80000,55,70059.0,40002,2000.1,9941,70059
100000,55,87555.0,50002,2500.1,12445,87555
200000,55,175100.0,100002,5000.1,24900,175100
400000,55,350147.0,200002,10000.1,49853,350147
600000,55,525309.0,300002,15000.1,74691,525309
800000,55,700240.0,400002,20000.1,99760,700240
1000000,55,875020.0,500002,25000.1,124980,875020
2,56,2.0,2,0.1,0,2
3,56,3.0,2,0.1,0,3
100,56,87.0,13,0.65,13,87
200,56,177.0,13,0.65,23,177
2000,56,1795.0,13,0.65,205,1795
10000,56,9053.0,13,0.65,947,9053
20000,56,18074.0,13,0.65,1926,18074
40000,56,36067.0,13,0.65,3933,36067
60000,56,54142.0,13,0.65,5858,54142
80000,56,72070.0,13,0.65,7930,72070
100000,56,90099.0,13,0.65,9901,90099
200000,56,180159.0,13,0.65,19841,180159
400000,56,360279.0,13,0.65,39721,360279
600000,56,540030.0,13,0.65,59970,540030
800000,56,719946.0,13,0.65,80054,719946
1000000,56,900169.0,13,0.65,99831,900169
2,57,2.0,2,0.1,0,2
3,57,2.0,2,0.1,1,2
100,57,84.0,99,4.95,16,84
200,57,165.0,199,9.95,35,165
2000,57,1689.0,1999,99.95,311,1689
10000,57,8456.0,9999,499.95,1544,8456
20000,57,16940.0,19999,999.95,3060,16940
40000,57,33946.0,39999,1999.95,6054,33946
60000,57,51011.0,59999,2999.95,8989,51011
80000,57,67974.0,79999,3999.95,12026,67974
100000,57,85003.0,99999,4999.95,14997,85003
200000,57,170078.0,199999,9999.95,29922,170078
400000,57,340217.0,399999,19999.95,59783,340217
600000,57,510205.0,599999,29999.95,89795,510205
800000,57,680240.0,799999,39999.95,119760,680240
1000000,57,850202.0,999999,49999.95,149798,850202
2,58,2.0,2,0.1,0,2
3,58,2.0,2,0.1,1,2
100,58,79.0,99,4.95,21,79
200,58,162.0,199,9.95,38,162
2000,58,1674.0,1999,99.95,326,1674
10000,58,8472.0,9999,499.95,1528,8472
20000,58,17037.0,19999,999.95,2963,17037
40000,58,34059.0,39999,1999.95,5941,34059
60000,58,51109.0,59999,2999.95,8891,51109
80000,58,68128.0,79999,3999.95,11872,68128
100000,58,85111.0,99999,4999.95,14889,85111
200000,58,170107.0,199999,9999.95,29893,170107
400000,58,340310.0,399999,19999.95,59690,340310
600000,58,510370.0,599999,29999.95,89630,510370
800000,58,680119.0,799999,39999.95,119881,680119
1000000,58,850363.0,999999,49999.95,149637,850363
2,59,2.0,2,0.1,0,2
3,59,3.0,2,0.1,0,3
100,59,91.0,54,2.7,9,91
200,59,179.0,104,5.2,21,179
2000,59,1738.0,1004,50.2,262,1738
10000,59,8681.0,5004,250.2,1319,8681
20000,59,17451.0,10004,500.2,2549,17451
40000,59,34940.0,20004,1000.2,5060,34940
60000,59,52381.0,30004,1500.2,7619,52381
80000,59,69888.0,40004,2000.2,10112,69888
100000,59,87352.0,50004,2500.2,12648,87352
200000,59,174895.0,100004,5000.2,25105,174895
400000,59,349870.0,200004,10000.2,50130,349870
600000,59,524852.0,300004,15000.2,75148,524852
800000,59,700147.0,400004,20000.2,99853,700147
1000000,59,875080.0,500004,25000.2,124920,875080
2,60,2.0,2,0.1,0,2
3,60,3.0,2,0.1,0,3
100,60,89.0,95,4.75,11,89
200,60,175.0,195,9.75,25,175
2000,60,1680.0,1995,99.75,320,1680
10000,60,8441.0,9995,499.75,1559,8441
20000,60,16917.0,19995,999.75,3083,16917
40000,60,33950.0,39995,1999.75,6050,33950
60000,60,50897.0,59995,2999.75,9103,50897
80000,60,67923.0,79995,3999.75,12077,67923
100000,60,84933.0,99995,4999.75,15067,84933
200000,60,169926.0,199995,9999.75,30074,169926
400000,60,339949.0,399995,19999.75,60051,339949
600000,60,509982.0,599995,29999.75,90018,509982
800000,60,680301.0,799995,39999.75,119699,680301
1000000,60,850457.0,999995,49999.75,149543,850457
2,61,2.0,2,0.1,0,2
3,61,3.0,2,0.1,0,3
100,61,93.0,12,0.6,7,93
200,61,178.0,12,0.6,22,178
2000,61,1790.0,12,0.6,210,1790
10000,61,8952.0,12,0.6,1048,8952
20000,61,17945.0,12,0.6,2055,17945
40000,61,35972.0,12,0.6,4028,35972
60000,61,54030.0,12,0.6,5970,54030
80000,61,71984.0,12,0.6,8016,71984
100000,61,90060.0,12,0.6,9940,90060
200000,61,180007.0,12,0.6,19993,180007
400000,61,359953.0,12,0.6,40047,359953
600000,61,540112.0,12,0.6,59888,540112
800000,61,719964.0,12,0.6,80036,719964
1000000,61,899917.0,12,0.6,100083,899917
2,62,2.0,2,0.1,0,2
3,62,3.0,2,0.1,0,3
100,62,86.0,15,0.75,14,86
200,62,174.0,15,0.75,26,174
2000,62,1795.0,15,0.75,205,1795
10000,62,9028.0,15,0.75,972,9028
20000,62,18053.0,15,0.75,1947,18053
40000,62,36015.0,15,0.75,3985,36015
60000,62,54039.0,15,0.75,5961,54039
80000,62,72026.0,15,0.75,7974,72026
100000,62,90016.0,15,0.75,9984,90016
200000,62,179981.0,15,0.75,20019,179981
400000,62,360256.0,15,0.75,39744,360256
600000,62,540424.0,15,0.75,59576,540424
800000,62,720252.0,15,0.75,79748,720252
1000000,62,900144.0,15,0.75,99856,900144
2,63,2.0,2,0.1,0,2
3,63,3.0,2,0.1,0,3
100,63,88.0,98,4.9,12,88
200,63,175.0,198,9.9,25,175
2000,63,1673.0,1998,99.9,327,1673
10000,63,8512.0,9998,499.9,1488,8512
20000,63,17040.0,19998,999.9,2960,17040
40000,63,34120.0,39998,1999.9,5880,34120
60000,63,51110.0,59998,2999.9,8890,51110
80000,63,68050.0,79998,3999.9,11950,68050
100000,63,84987.0,99998,4999.9,15013,84987
200000,63,169808.0,199998,9999.9,30192,169808
400000,63,339600.0,399998,19999.9,60400,339600
600000,63,509672.0,599998,29999.9,90328,509672
800000,63,679660.0,799998,39999.9,120340,679660
1000000,63,849706.0,999998,49999.9,150294,849706
2,64,2.0,2,0.1,0,2
3,64,3.0,2,0.1,0,3
100,64,86.0,93,4.65,14,86
200,64,171.0,193,9.65,29,171
2000,64,1734.0,1993,99.65,266,1734
10000,64,8475.0,9993,499.65,1525,8475
20000,64,16970.0,19993,999.65,3030,16970
40000,64,33862.0,39993,1999.65,6138,33862
60000,64,50867.0,59993,2999.65,9133,50867
80000,64,67796.0,79993,3999.65,12204,67796
100000,64,84816.0,99993,4999.65,15184,84816
200000,64,169672.0,199993,9999.65,30328,169672
400000,64,339396.0,399993,19999.65,60604,339396
600000,64,509241.0,599993,29999.65,90759,509241
800000,64,679273.0,799993,39999.65,120727,679273
1000000,64,849377.0,999993,49999.65,150623,849377
2,65,1.0,2,0.1,1,1
3,65,2.0,2,0.1,1,2
100,65,87.0,6,0.3,13,87
200,65,175.0,6,0.3,25,175
2000,65,1796.0,6,0.3,204,1796
10000,65,9001.0,6,0.3,999,9001
20000,65,17998.0,6,0.3,2002,17998
40000,65,36055.0,6,0.3,3945,36055
60000,65,54092.0,6,0.3,5908,54092
80000,65,72062.0,6,0.3,7938,72062
100000,65,90058.0,6,0.3,9942,90058
200000,65,180128.0,6,0.3,19872,180128
400000,65,360179.0,6,0.3,39821,360179
600000,65,540351.0,6,0.3,59649,540351
800000,65,720288.0,6,0.3,79712,720288
1000000,65,900459.0,6,0.3,99541,900459
2,66,2.0,2,0.1,0,2
3,66,3.0,2,0.1,0,3
100,66,86.0,13,0.65,14,86
200,66,178.0,13,0.65,22,178
2000,66,1824.0,13,0.65,176,1824
10000,66,9038.0,13,0.65,962,9038
20000,66,18054.0,13,0.65,1946,18054
40000,66,36066.0,13,0.65,3934,36066
60000,66,54122.0,13,0.65,5878,54122
80000,66,72112.0,13,0.65,7888,72112
100000,66,90128.0,13,0.65,9872,90128
200000,66,179877.0,13,0.65,20123,179877
400000,66,359778.0,13,0.65,40222,359778
600000,66,539567.0,13,0.65,60433,539567
800000,66,719406.0,13,0.65,80594,719406
1000000,66,899430.0,13,0.65,100570,899430
2,67,2.0,2,0.1,0,2
3,67,3.0,2,0.1,0,3
100,67,79.0,94,4.7,21,79
200,67,160.0,194,9.7,40,160
2000,67,1691.0,1994,99.7,309,1691
10000,67,8479.0,9994,499.7,1521,8479
20000,67,17008.0,19994,999.7,2992,17008
40000,67,34025.0,39994,1999.7,5975,34025
60000,67,50985.0,59994,2999.7,9015,50985
80000,67,67981.0,79994,3999.7,12019,67981
100000,67,84954.0,99994,4999.7,15046,84954
200000,67,169822.0,199994,9999.7,30178,169822
400000,67,339690.0,399994,19999.7,60310,339690
600000,67,509927.0,599994,29999.7,90073,509927
800000,67,679677.0,799994,39999.7,120323,679677
1000000,67,849538.0,999994,49999.7,150462,849538
2,68,1.0,2,0.1,1,1
3,68,2.0,2,0.1,1,2
100,68,80.0,97,4.85,20,80
200,68,163.0,197,9.85,37,163
2000,68,1698.0,1997,99.85,302,1698
10000,68,8491.0,9997,499.85,1509,8491
20000,68,17024.0,19997,999.85,2976,17024
40000,68,33960.0,39997,1999.85,6040,33960
60000,68,51000.0,59997,2999.85,9000,51000
80000,68,68051.0,79997,3999.85,11949,68051
100000,68,85110.0,99997,4999.85,14890,85110
200000,68,170069.0,199997,9999.85,29931,170069
400000,68,339980.0,399997,19999.85,60020,339980
600000,68,510015.0,599997,29999.85,89985,510015
800000,68,680108.0,799997,39999.85,119892,680108
1000000,68,850045.0,999997,49999.85,149955,850045
2,69,2.0,2,0.1,0,2
3,69,3.0,2,0.1,0,3
100,69,90.0,10,0.5,10,90
200,69,176.0,10,0.5,24,176
2000,69,1782.0,10,0.5,218,1782
10000,69,8990.0,10,0.5,1010,8990
20000,69,18017.0,10,0.5,1983,18017
40000,69,36032.0,10,0.5,3968,36032
60000,69,54071.0,10,0.5,5929,54071
80000,69,72104.0,10,0.5,7896,72104
100000,69,90059.0,10,0.5,9941,90059
200000,69,179985.0,10,0.5,20015,179985
400000,69,359838.0,10,0.5,40162,359838
600000,69,539689.0,10,0.5,60311,539689
800000,69,719688.0,10,0.5,80312,719688
1000000,69,899563.0,10,0.5,100437,899563
2,70,2.0,2,0.1,0,2
3,70,3.0,2,0.1,0,3
100,70,92.0,11,0.55,8,92
200,70,174.0,11,0.55,26,174
2000,70,1795.0,11,0.55,205,1795
10000,70,8991.0,11,0.55,1009,8991
20000,70,17996.0,11,0.55,2004,17996
40000,70,35968.0,11,0.55,4032,35968
60000,70,53985.0,11,0.55,6015,53985
80000,70,71996.0,11,0.55,8004,71996
100000,70,89998.0,11,0.55,10002,89998
200000,70,180117.0,11,0.55,19883,180117
400000,70,360078.0,11,0.55,39922,360078
600000,70,539942.0,11,0.55,60058,539942
800000,70,719961.0,11,0.55,80039,719961
1000000,70,899817.0,11,0.55,100183,899817
2,71,2.0,2,0.1,0,2
3,71,3.0,2,0.1,0,3
100,71,92.0,7,0.35,8,92
200,71,179.0,7,0.35,21,179
2000,71,1802.0,7,0.35,198,1802
10000,71,9003.0,7,0.35,997,9003
20000,71,17977.0,7,0.35,2023,17977
40000,71,36018.0,7,0.35,3982,36018
60000,71,53981.0,7,0.35,6019,53981
80000,71,72009.0,7,0.35,7991,72009
100000,71,89910.0,7,0.35,10090,89910
200000,71,180009.0,7,0.35,19991,180009
400000,71,359676.0,7,0.35,40324,359676
600000,71,539665.0,7,0.35,60335,539665
800000,71,719659.0,7,0.35,80341,719659
1000000,71,899751.0,7,0.35,100249,899751
2,72,2.0,2,0.1,0,2
3,72,3.0,2,0.1,0,3
100,72,81.0,97,4.85,19,81
200,72,161.0,197,9.85,39,161
2000,72,1691.0,1997,99.85,309,1691
10000,72,8538.0,9997,499.85,1462,8538
20000,72,17032.0,19997,999.85,2968,17032
40000,72,34051.0,39997,1999.85,5949,34051
60000,72,51003.0,59997,2999.85,8997,51003
80000,72,67989.0,79997,3999.85,12011,67989
100000,72,85006.0,99997,4999.85,14994,85006
200000,72,170261.0,199997,9999.85,29739,170261
400000,72,340531.0,399997,19999.85,59469,340531
600000,72,510407.0,599997,29999.85,89593,510407
800000,72,680462.0,799997,39999.85,119538,680462
1000000,72,850510.0,999997,49999.85,149490,850510
2,73,2.0,2,0.1,0,2
3,73,3.0,2,0.1,0,3
100,73,89.0,98,4.9,11,89
200,73,181.0,198,9.9,19,181
2000,73,1731.0,1998,99.9,269,1731
10000,73,8526.0,9998,499.9,1474,8526
20000,73,16987.0,19998,999.9,3013,16987
40000,73,33957.0,39998,1999.9,6043,33957
60000,73,51013.0,59998,2999.9,8987,51013
80000,73,68016.0,79998,3999.9,11984,68016
100000,73,84965.0,99998,4999.9,15035,84965
200000,73,169937.0,199998,9999.9,30063,169937
400000,73,340006.0,399998,19999.9,59994,340006
600000,73,510148.0,599998,29999.9,89852,510148
800000,73,680225.0,799998,39999.9,119775,680225
1000000,73,850078.0,999998,49999.9,149922,850078
2,74,1.0,2,0.1,1,1
3,74,2.0,2,0.1,1,2
100,74,85.0,91,4.55,15,85
200,74,169.0,191,9.55,31,169
2000,74,1692.0,1991,99.55,308,1692
10000,74,8528.0,9991,499.55,1472,8528
20000,74,17041.0,19991,999.55,2959,17041
40000,74,34072.0,39991,1999.55,5928,34072
60000,74,51066.0,59991,2999.55,8934,51066
80000,74,68012.0,79991,3999.55,11988,68012
100000,74,85039.0,99991,4999.55,14961,85039
200000,74,169990.0,199991,9999.55,30010,169990
400000,74,340230.0,399991,19999.55,59770,340230
600000,74,510305.0,599991,29999.55,89695,510305
800000,74,680413.0,799991,39999.55,119587,680413
1000000,74,850690.0,999991,49999.55,149310,850690
2,75,1.0,2,0.1,1,1
3,75,2.0,2,0.1,1,2
100,75,87.0,95,4.75,13,87
200,75,176.0,195,9.75,24,176
2000,75,1715.0,1995,99.75,285,1715
10000,75,8453.0,9995,499.75,1547,8453
20000,75,16902.0,19995,999.75,3098,16902
40000,75,33891.0,39995,1999.75,6109,33891
60000,75,50960.0,59995,2999.75,9040,50960
80000,75,68002.0,79995,3999.75,11998,68002
100000,75,84967.0,99995,4999.75,15033,84967
200000,75,169929.0,199995,9999.75,30071,169929
400000,75,339953.0,399995,19999.75,60047,339953
600000,75,510186.0,599995,29999.75,89814,510186
800000,75,680325.0,799995,39999.75,119675,680325
1000000,75,850233.0,999995,49999.75,149767,850233
2,76,1.0,2,0.1,1,1
3,76,2.0,2,0.1,1,2
100,76,81.0,97,4.85,19,81
200,76,160.0,197,9.85,40,160
2000,76,1683.0,1997,99.85,317,1683
10000,76,8417.0,9997,499.85,1583,8417
20000,76,16852.0,19997,999.85,3148,16852
40000,76,33952.0,39997,1999.85,6048,33952
60000,76,51030.0,59997,2999.85,8970,51030
80000,76,68048.0,79997,3999.85,11952,68048
100000,76,85077.0,99997,4999.85,14923,85077
200000,76,170060.0,199997,9999.85,29940,170060
400000,76,340086.0,399997,19999.85,59914,340086
600000,76,510082.0,599997,29999.85,89918,510082
800000,76,680019.0,799997,39999.85,119981,680019
1000000,76,849969.0,999997,49999.85,150031,849969
2,77,2.0,2,0.1,0,2
3,77,3.0,2,0.1,0,3
100,77,82.0,6,0.3,18,82
200,77,173.0,6,0.3,27,173
2000,77,1801.0,6,0.3,199,1801
10000,77,8994.0,6,0.3,1006,8994
20000,77,18052.0,6,0.3,1948,18052
40000,77,36034.0,6,0.3,3966,36034
60000,77,54102.0,6,0.3,5898,54102
80000,77,72055.0,6,0.3,7945,72055
100000,77,90078.0,6,0.3,9922,90078
200000,77,180140.0,6,0.3,19860,180140
400000,77,360259.0,6,0.3,39741,360259
600000,77,540274.0,6,0.3,59726,540274
800000,77,720512.0,6,0.3,79488,720512
1000000,77,900462.0,6,0.3,99538,900462
2,78,2.0,2,0.1,0,2
3,78,3.0,2,0.1,0,3
100,78,79.0,98,4.9,21,79
200,78,166.0,198,9.9,34,166
2000,78,1686.0,1998,99.9,314,1686
10000,78,8422.0,9998,499.9,1578,8422
20000,78,16950.0,19998,999.9,3050,16950
40000,78,33960.0,39998,1999.9,6040,33960
60000,78,50966.0,59998,2999.9,9034,50966
80000,78,67944.0,79998,3999.9,12056,67944
100000,78,84932.0,99998,4999.9,15068,84932
200000,78,170089.0,199998,9999.9,29911,170089
400000,78,340102.0,399998,19999.9,59898,340102
600000,78,510029.0,599998,29999.9,89971,510029
800000,78,680047.0,799998,39999.9,119953,680047
1000000,78,850040.0,999998,49999.9,149960,850040
2,79,1.0,2,0.1,1,1
3,79,2.0,2,0.1,1,2
100,79,83.0,97,4.85,17,83
200,79,168.0,197,9.85,32,168
2000,79,1678.0,1997,99.85,322,1678
10000,79,8496.0,9997,499.85,1504,8496
20000,79,16987.0,19997,999.85,3013,16987
40000,79,33933.0,39997,1999.85,6067,33933
60000,79,50891.0,59997,2999.85,9109,50891
80000,79,67913.0,79997,3999.85,12087,67913
100000,79,84961.0,99997,4999.85,15039,84961
200000,79,169967.0,199997,9999.85,30033,169967
400000,79,340070.0,399997,19999.85,59930,340070
600000,79,510146.0,599997,29999.85,89854,510146
800000,79,679916.0,799997,39999.85,120084,679916
1000000,79,850036.0,999997,49999.85,149964,850036
2,80,1.0,2,0.1,1,1
3,80,2.0,2,0.1,1,2
100,80,92.0,6,0.3,8,92
200,80,185.0,6,0.3,15,185
2000,80,1812.0,6,0.3,188,1812
10000,80,9007.0,6,0.3,993,9007
20000,80,18060.0,6,0.3,1940,18060
40000,80,36057.0,6,0.3,3943,36057
60000,80,54002.0,6,0.3,5998,54002
80000,80,72018.0,6,0.3,7982,72018
100000,80,89986.0,6,0.3,10014,89986
200000,80,179686.0,6,0.3,20314,179686
400000,80,359664.0,6,0.3,40336,359664
600000,80,539760.0,6,0.3,60240,539760
800000,80,719775.0,6,0.3,80225,719775
1000000,80,899869.0,6,0.3,100131,899869
2,81,2.0,2,0.1,0,2
3,81,3.0,2,0.1,0,3
100,81,91.0,54,2.7,9,91
200,81,179.0,104,5.2,21,179
2000,81,1751.0,1004,50.2,249,1751
10000,81,8740.0,5004,250.2,1260,8740
20000,81,17523.0,10004,500.2,2477,17523
40000,81,35004.0,20004,1000.2,4996,35004
60000,81,52389.0,30004,1500.2,7611,52389
80000,81,69847.0,40004,2000.2,10153,69847
100000,81,87314.0,50004,2500.2,12686,87314
200000,81,174831.0,100004,5000.2,25169,174831
400000,81,349530.0,200004,10000.2,50470,349530
600000,81,524410.0,300004,15000.2,75590,524410
800000,81,699274.0,400004,20000.2,100726,699274
1000000,81,874190.0,500004,25000.2,125810,874190
2,82,2.0,2,0.1,0,2
3,82,3.0,2,0.1,0,3
100,82,90.0,94,4.7,10,90
200,82,172.0,194,9.7,28,172
2000,82,1674.0,1994,99.7,326,1674
10000,82,8404.0,9994,499.7,1596,8404
20000,82,16923.0,19994,999.7,3077,16923
40000,82,33961.0,39994,1999.7,6039,33961
60000,82,50928.0,59994,2999.7,9072,50928
80000,82,67834.0,79994,3999.7,12166,67834
100000,82,84798.0,99994,4999.7,15202,84798
200000,82,169836.0,199994,9999.7,30164,169836
400000,82,339901.0,399994,19999.7,60099,339901
600000,82,509750.0,599994,29999.7,90250,509750
800000,82,680072.0,799994,39999.7,119928,680072
1000000,82,850119.0,999994,49999.7,149881,850119
2,83,2.0,2,0.1,0,2
3,83,3.0,2,0.1,0,3
100,83,81.0,97,4.85,19,81
200,83,164.0,197,9.85,36,164
2000,83,1695.0,1997,99.85,305,1695
10000,83,8490.0,9997,499.85,1510,8490
20000,83,17006.0,19997,999.85,2994,17006
40000,83,34060.0,39997,1999.85,5940,34060
60000,83,50939.0,59997,2999.85,9061,50939
80000,83,67930.0,79997,3999.85,12070,67930
100000,83,84910.0,99997,4999.85,15090,84910
200000,83,169848.0,199997,9999.85,30152,169848
400000,83,339886.0,399997,19999.85,60114,339886
600000,83,509738.0,599997,29999.85,90262,509738
800000,83,680087.0,799997,39999.85,119913,680087
1000000,83,849856.0,999997,49999.85,150144,849856
2,84,2.0,2,0.1,0,2
3,84,3.0,2,0.1,0,3
100,84,87.0,9,0.45,13,87
200,84,177.0,9,0.45,23,177
2000,84,1790.0,9,0.45,210,1790
10000,84,8981.0,9,0.45,1019,8981
20000,84,17956.0,9,0.45,2044,17956
40000,84,35824.0,9,0.45,4176,35824
60000,84,53818.0,9,0.45,6182,53818
80000,84,71810.0,9,0.45,8190,71810
100000,84,89830.0,9,0.45,10170,89830
200000,84,179847.0,9,0.45,20153,179847
400000,84,359883.0,9,0.45,40117,359883
600000,84,539732.0,9,0.45,60268,539732
800000,84,719688.0,9,0.45,80312,719688
1000000,84,899771.0,9,0.45,100229,899771
2,85,2.0,2,0.1,0,2
3,85,3.0,2,0.1,0,3
100,85,84.0,93,4.65,16,84
200,85,165.0,193,9.65,35,165
2000,85,1674.0,1993,99.65,326,1674
10000,85,8473.0,9993,499.65,1527,8473
20000,85,17010.0,19993,999.65,2990,17010
40000,85,33949.0,39993,1999.65,6051,33949
60000,85,50951.0,59993,2999.65,9049,50951
80000,85,67890.0,79993,3999.65,12110,67890
100000,85,84968.0,99993,4999.65,15032,84968
200000,85,170065.0,199993,9999.65,29935,170065
400000,85,339685.0,399993,19999.65,60315,339685
600000,85,509576.0,599993,29999.65,90424,509576
800000,85,679552.0,799993,39999.65,120448,679552
1000000,85,849501.0,999993,49999.65,150499,849501
2,86,1.0,2,0.1,1,1
3,86,1.0,2,0.1,2,1
100,86,87.0,99,4.95,13,87
200,86,171.0,199,9.95,29,171
2000,86,1688.0,1999,99.95,312,1688
10000,86,8487.0,9999,499.95,1513,8487
20000,86,16984.0,19999,999.95,3016,16984
40000,86,33833.0,39999,1999.95,6167,33833
60000,86,50827.0,59999,2999.95,9173,50827
80000,86,67851.0,79999,3999.95,12149,67851
100000,86,84807.0,99999,4999.95,15193,84807
200000,86,169854.0,199999,9999.95,30146,169854
400000,86,339703.0,399999,19999.95,60297,339703
600000,86,509888.0,599999,29999.95,90112,509888
800000,86,679916.0,799999,39999.95,120084,679916
1000000,86,850232.0,999999,49999.95,149768,850232
2,87,2.0,2,0.1,0,2
3,87,2.0,2,0.1,1,2
100,87,84.0,99,4.95,16,84
200,87,170.0,199,9.95,30,170
2000,87,1703.0,1999,99.95,297,1703
10000,87,8511.0,9999,499.95,1489,8511
20000,87,16998.0,19999,999.95,3002,16998
40000,87,34119.0,39999,1999.95,5881,34119
60000,87,51233.0,59999,2999.95,8767,51233
80000,87,68341.0,79999,3999.95,11659,68341
100000,87,85293.0,99999,4999.95,14707,85293
200000,87,170195.0,199999,9999.95,29805,170195
400000,87,340382.0,399999,19999.95,59618,340382
600000,87,510312.0,599999,29999.95,89688,510312
800000,87,680187.0,799999,39999.95,119813,680187
1000000,87,849859.0,999999,49999.95,150141,849859
2,88,1.0,2,0.1,1,1
3,88,2.0,2,0.1,1,2
100,88,77.0,10,0.5,23,77
200,88,167.0,10,0.5,33,167
2000,88,1778.0,10,0.5,222,1778
10000,88,8990.0,10,0.5,1010,8990
20000,88,18046.0,10,0.5,1954,18046
40000,88,36052.0,10,0.5,3948,36052
60000,88,54028.0,10,0.5,5972,54028
80000,88,71995.0,10,0.5,8005,71995
100000,88,89950.0,10,0.5,10050,89950
200000,88,179848.0,10,0.5,20152,179848
400000,88,359719.0,10,0.5,40281,359719
600000,88,539793.0,10,0.5,60207,539793
800000,88,719595.0,10,0.5,80405,719595
1000000,88,899455.0,10,0.5,100545,899455
2,89,1.0,2,0.1,1,1
3,89,2.0,2,0.1,1,2
100,89,91.0,51,2.55,9,91
200,89,178.0,101,5.05,22,178
2000,89,1750.0,1001,50.05,250,1750
10000,89,8745.0,5001,250.05,1255,8745
20000,89,17521.0,10001,500.05,2479,17521
40000,89,35066.0,20001,1000.05,4934,35066
60000,89,52578.0,30001,1500.05,7422,52578
80000,89,70085.0,40001,2000.05,9915,70085
100000,89,87535.0,50001,2500.05,12465,87535
200000,89,174832.0,100001,5000.05,25168,174832
400000,89,349775.0,200001,10000.05,50225,349775
600000,89,524885.0,300001,15000.05,75115,524885
800000,89,699900.0,400001,20000.05,100100,699900
1000000,89,875035.0,500001,25000.05,124965,875035
2,90,2.0,2,0.1,0,2
3,90,3.0,2,0.1,0,3
100,90,88.0,10,0.5,12,88
200,90,178.0,10,0.5,22,178
2000,90,1794.0,10,0.5,206,1794
10000,90,8970.0,10,0.5,1030,8970
20000,90,17943.0,10,0.5,2057,17943
40000,90,35970.0,10,0.5,4030,35970
60000,90,53965.0,10,0.5,6035,53965
80000,90,71942.0,10,0.5,8058,71942
100000,90,89968.0,10,0.5,10032,89968
200000,90,179967.0,10,0.5,20033,179967
400000,90,360114.0,10,0.5,39886,360114
600000,90,540041.0,10,0.5,59959,540041
800000,90,720006.0,10,0.5,79994,720006
1000000,90,899975.0,10,0.5,100025,899975
2,91,2.0,2,0.1,0,2
3,91,3.0,2,0.1,0,3
100,91,83.0,94,4.7,17,83
200,91,168.0,194,9.7,32,168
2000,91,1695.0,1994,99.7,305,1695
10000,91,8504.0,9994,499.7,1496,8504
20000,91,17044.0,19994,999.7,2956,17044
40000,91,34036.0,39994,1999.7,5964,34036
60000,91,51077.0,59994,2999.7,8923,51077
80000,91,68041.0,79994,3999.7,11959,68041
100000,91,85123.0,99994,4999.7,14877,85123
200000,91,170020.0,199994,9999.7,29980,170020
400000,91,339800.0,399994,19999.7,60200,339800
600000,91,509737.0,599994,29999.7,90263,509737
800000,91,679603.0,799994,39999.7,120397,679603
1000000,91,849684.0,999994,49999.7,150316,849684
2,92,1.0,2,0.1,1,1
3,92,2.0,2,0.1,1,2
100,92,85.0,7,0.35,15,85
200,92,174.0,7,0.35,26,174
2000,92,1795.0,7,0.35,205,1795
10000,92,9009.0,7,0.35,991,9009
20000,92,18007.0,7,0.35,1993,18007
40000,92,35998.0,7,0.35,4002,35998
60000,92,53929.0,7,0.35,6071,53929
80000,92,71964.0,7,0.35,8036,71964
100000,92,89971.0,7,0.35,10029,89971
200000,92,179949.0,7,0.35,20051,179949
400000,92,360028.0,7,0.35,39972,360028
600000,92,540040.0,7,0.35,59960,540040
800000,92,720028.0,7,0.35,79972,720028
1000000,92,900046.0,7,0.35,99954,900046
2,93,2.0,2,0.1,0,2
3,93,3.0,2,0.1,0,3
100,93,89.0,95,4.75,11,89
200,93,173.0,195,9.75,27,173
2000,93,1714.0,1995,99.75,286,1714
10000,93,8455.0,9995,499.75,1545,8455
20000,93,16964.0,19995,999.75,3036,16964
40000,93,34004.0,39995,1999.75,5996,34004
60000,93,50895.0,59995,2999.75,9105,50895
80000,93,67881.0,79995,3999.75,12119,67881
100000,93,84858.0,99995,4999.75,15142,84858
200000,93,169924.0,199995,9999.75,30076,169924
400000,93,339609.0,399995,19999.75,60391,339609
600000,93,509681.0,599995,29999.75,90319,509681
800000,93,679520.0,799995,39999.75,120480,679520
1000000,93,849625.0,999995,49999.75,150375,849625
2,94,2.0,2,0.1,0,2
3,94,3.0,2,0.1,0,3
100,94,80.0,97,4.85,20,80
200,94,169.0,197,9.85,31,169
2000,94,1713.0,1997,99.85,287,1713
10000,94,8514.0,9997,499.85,1486,8514
20000,94,16933.0,19997,999.85,3067,16933
40000,94,33896.0,39997,1999.85,6104,33896
60000,94,50868.0,59997,2999.85,9132,50868
80000,94,67874.0,79997,3999.85,12126,67874
100000,94,84805.0,99997,4999.85,15195,84805
200000,94,169777.0,199997,9999.85,30223,169777
400000,94,339886.0,399997,19999.85,60114,339886
600000,94,509860.0,599997,29999.85,90140,509860
800000,94,679898.0,799997,39999.85,120102,679898
1000000,94,849843.0,999997,49999.85,150157,849843
2,95,2.0,2,0.1,0,2
3,95,3.0,2,0.1,0,3
100,95,92.0,11,0.55,8,92
200,95,180.0,11,0.55,20,180
2000,95,1813.0,11,0.55,187,1813
10000,95,8983.0,11,0.55,1017,8983
20000,95,17979.0,11,0.55,2021,17979
40000,95,35991.0,11,0.55,4009,35991
60000,95,53976.0,11,0.55,6024,53976
80000,95,71965.0,11,0.55,8035,71965
100000,95,89960.0,11,0.55,10040,89960
200000,95,179886.0,11,0.55,20114,179886
400000,95,359662.0,11,0.55,40338,359662
600000,95,539518.0,11,0.55,60482,539518
800000,95,719338.0,11,0.55,80662,719338
1000000,95,899227.0,11,0.55,100773,899227
2,96,2.0,2,0.1,0,2
3,96,3.0,2,0.1,0,3
100,96,88.0,98,4.9,12,88
200,96,165.0,198,9.9,35,165
2000,96,1711.0,1998,99.9,289,1711
10000,96,8506.0,9998,499.9,1494,8506
20000,96,17019.0,19998,999.9,2981,17019
40000,96,34102.0,39998,1999.9,5898,34102
60000,96,51132.0,59998,2999.9,8868,51132
80000,96,68173.0,79998,3999.9,11827,68173
100000,96,85268.0,99998,4999.9,14732,85268
200000,96,170330.0,199998,9999.9,29670,170330
400000,96,340507.0,399998,19999.9,59493,340507
600000,96,510580.0,599998,29999.9,89420,510580
800000,96,680351.0,799998,39999.9,119649,680351
1000000,96,850214.0,999998,49999.9,149786,850214
2,97,1.0,2,0.1,1,1
3,97,2.0,2,0.1,1,2
100,97,93.0,6,0.3,7,93
200,97,184.0,6,0.3,16,184
2000,97,1817.0,6,0.3,183,1817
10000,97,8960.0,6,0.3,1040,8960
20000,97,17934.0,6,0.3,2066,17934
40000,97,35958.0,6,0.3,4042,35958
60000,97,53980.0,6,0.3,6020,53980
80000,97,71988.0,6,0.3,8012,71988
100000,97,89975.0,6,0.3,10025,89975
200000,97,179970.0,6,0.3,20030,179970
400000,97,359758.0,6,0.3,40242,359758
600000,97,540099.0,6,0.3,59901,540099
800000,97,720131.0,6,0.3,79869,720131
1000000,97,900067.0,6,0.3,99933,900067
2,98,1.0,2,0.1,1,1
3,98,2.0,2,0.1,1,2
100,98,89.0,3,0.15,11,89
200,98,181.0,3,0.15,19,181
2000,98,1806.0,3,0.15,194,1806
10000,98,9056.0,3,0.15,944,9056
20000,98,17997.0,3,0.15,2003,17997
40000,98,36047.0,3,0.15,3953,36047
60000,98,54116.0,3,0.15,5884,54116
80000,98,72198.0,3,0.15,7802,72198
100000,98,90115.0,3,0.15,9885,90115
200000,98,180059.0,3,0.15,19941,180059
400000,98,360168.0,3,0.15,39832,360168
600000,98,540198.0,3,0.15,59802,540198
800000,98,720332.0,3,0.15,79668,720332
1000000,98,900526.0,3,0.15,99474,900526
2,99,2.0,2,0.1,0,2
3,99,3.0,2,0.1,0,3
100,99,79.0,97,4.85,21,79
200,99,168.0,197,9.85,32,168
2000,99,1710.0,1997,99.85,290,1710
10000,99,8514.0,9997,499.85,1486,8514
20000,99,17059.0,19997,999.85,2941,17059
40000,99,34078.0,39997,1999.85,5922,34078
60000,99,51109.0,59997,2999.85,8891,51109
80000,99,68055.0,79997,3999.85,11945,68055
100000,99,85071.0,99997,4999.85,14929,85071
200000,99,169918.0,199997,9999.85,30082,169918
400000,99,339801.0,399997,19999.85,60199,339801
600000,99,510048.0,599997,29999.85,89952,510048
800000,99,680014.0,799997,39999.85,119986,680014
1000000,99,850129.0,999997,49999.85,149871,850129
2,100,2.0,2,0.1,0,2
3,100,3.0,2,0.1,0,3
100,100,90.0,9,0.45,10,90
200,100,178.0,9,0.45,22,178
2000,100,1804.0,9,0.45,196,1804
10000,100,9022.0,9,0.45,978,9022
20000,100,17995.0,9,0.45,2005,17995
40000,100,35944.0,9,0.45,4056,35944
60000,100,53953.0,9,0.45,6047,53953
80000,100,72012.0,9,0.45,7988,72012
100000,100,90056.0,9,0.45,9944,90056
200000,100,180211.0,9,0.45,19789,180211
400000,100,360160.0,9,0.45,39840,360160
600000,100,540107.0,9,0.45,59893,540107
800000,100,720008.0,9,0.45,79992,720008
1000000,100,900009.0,9,0.45,99991,900009
