Timestep,Iteration,Total Reward,Suboptimal Arms,Total Regret,Zeros Count,Ones Count
2,1,2.0,1,0.05,0,2
3,1,3.0,2,0.06,0,3
100,1,93.0,13,0.34,7,93
200,1,183.0,13,0.34,17,183
2000,1,1810.0,13,0.34,190,1810
10000,1,9034.0,13,0.34,966,9034
20000,1,18096.0,13,0.34,1904,18096
40000,1,36095.0,13,0.34,3905,36095
60000,1,54166.0,13,0.34,5834,54166
80000,1,72113.0,13,0.34,7887,72113
100000,1,90258.0,13,0.34,9742,90258
200000,1,180245.0,13,0.34,19755,180245
400000,1,360456.0,13,0.34,39544,360456
600000,1,540481.0,13,0.34,59519,540481
800000,1,720435.0,13,0.34,79565,720435
1000000,1,900477.0,13,0.34,99523,900477
2,2,2.0,1,0.05,0,2
3,2,3.0,2,0.06,0,3
100,2,88.0,10,0.41,12,88
200,2,179.0,10,0.41,21,179
2000,2,1781.0,10,0.41,219,1781
10000,2,8916.0,10,0.41,1084,8916
20000,2,18001.0,10,0.41,1999,18001
40000,2,36059.0,10,0.41,3941,36059
60000,2,54094.0,10,0.41,5906,54094
80000,2,72049.0,10,0.41,7951,72049
100000,2,90118.0,10,0.41,9882,90118
200000,2,180179.0,10,0.41,19821,180179
400000,2,360239.0,10,0.41,39761,360239
600000,2,540371.0,10,0.41,59629,540371
800000,2,720412.0,10,0.41,79588,720412
1000000,2,900414.0,10,0.41,99586,900414
2,3,2.0,1,0.05,0,2
3,3,3.0,2,0.06,0,3
100,3,90.0,54,2.34,10,90
200,3,180.0,104,4.84,20,180
2000,3,1776.0,1004,49.84,224,1776
10000,3,8762.0,5004,249.84,1238,8762
20000,3,17520.0,10004,499.84,2480,17520
40000,3,35032.0,20004,999.84,4968,35032
60000,3,52486.0,30004,1499.84,7514,52486
80000,3,69982.0,40004,1999.84,10018,69982
100000,3,87491.0,50004,2499.84,12509,87491
200000,3,174979.0,100004,4999.84,25021,174979
400000,3,349993.0,200004,9999.84,50007,349993
600000,3,525344.0,300004,14999.84,74656,525344
800000,3,700321.0,400004,19999.84,99679,700321
1000000,3,875151.0,500004,24999.84,124849,875151
2,4,2.0,1,0.05,0,2
3,4,3.0,2,0.06,0,3
100,4,93.0,8,0.27,7,93
200,4,180.0,8,0.27,20,180
2000,4,1803.0,8,0.27,197,1803
10000,4,9034.0,8,0.27,966,9034
20000,4,18057.0,8,0.27,1943,18057
40000,4,36021.0,8,0.27,3979,36021
60000,4,54001.0,8,0.27,5999,54001
80000,4,72018.0,8,0.27,7982,72018
100000,4,89990.0,8,0.27,10010,89990
200000,4,180003.0,8,0.27,19997,180003
400000,4,359982.0,8,0.27,40018,359982
600000,4,539952.0,8,0.27,60048,539952
800000,4,719896.0,8,0.27,80104,719896
1000000,4,899878.0,8,0.27,100122,899878
2,5,2.0,1,0.05,0,2
3,5,3.0,2,0.06,0,3
100,5,89.0,93,0.56,11,89
200,5,176.0,193,1.05,24,176
2000,5,1798.0,1993,10.06,202,1798
10000,5,8923.0,9993,50.06,1077,8923
20000,5,17854.0,19993,100.05,2146,17854
40000,5,35794.0,39993,200.05,4206,35794
60000,5,53650.0,59993,300.05,6350,53650
80000,5,71511.0,79993,400.05,8489,71511
100000,5,89392.0,99993,500.05,10608,89392
200000,5,178858.0,199993,1000.05,21142,178858
400000,5,358004.0,399993,2000.06,41996,358004
600000,5,537164.0,599993,3000.06,62836,537164
800000,5,716088.0,799993,4000.06,83912,716088
1000000,5,894970.0,999993,5000.06,105030,894970
2,6,2.0,1,0.05,0,2
3,6,3.0,2,0.06,0,3
100,6,91.0,97,0.8,9,91
200,6,181.0,197,1.3,19,181
2000,6,1771.0,1997,10.3,229,1771
10000,6,8877.0,9997,50.3,1123,8877
20000,6,17826.0,19997,100.3,2174,17826
40000,6,35817.0,39997,200.3,4183,35817
60000,6,53773.0,59997,300.3,6227,53773
80000,6,71607.0,79997,400.3,8393,71607
100000,6,89504.0,99997,500.3,10496,89504
200000,6,178885.0,199997,1000.3,21115,178885
400000,6,357820.0,399997,2000.3,42180,357820
600000,6,536845.0,599997,3000.3,63155,536845
800000,6,715795.0,799997,4000.3,84205,715795
1000000,6,894800.0,999997,5000.3,105200,894800
2,7,2.0,1,0.05,0,2
3,7,3.0,2,0.06,0,3
100,7,89.0,95,4.66,11,89
200,7,175.0,195,9.66,25,175
2000,7,1703.0,1995,99.66,297,1703
10000,7,8540.0,9995,499.66,1460,8540
20000,7,17089.0,19995,999.66,2911,17089
40000,7,34109.0,39995,1999.66,5891,34109
60000,7,51113.0,59995,2999.66,8887,51113
80000,7,68218.0,79995,3999.66,11782,68218
100000,7,85185.0,99995,4999.66,14815,85185
200000,7,170329.0,199995,9999.66,29671,170329
400000,7,340410.0,399995,19999.66,59590,340410
600000,7,510362.0,599995,29999.66,89638,510362
800000,7,680702.0,799995,39999.66,119298,680702
1000000,7,850659.0,999995,49999.66,149341,850659
2,8,2.0,1,0.05,0,2
3,8,3.0,2,0.06,0,3
100,8,94.0,66,1.82,6,94
200,8,185.0,133,3.68,15,185
2000,8,1784.0,1333,36.68,216,1784
10000,8,8821.0,6666,183.31,1179,8821
20000,8,17658.0,13333,366.68,2342,17658
40000,8,35288.0,26666,733.31,4712,35288
60000,8,52922.0,40000,1100.0,7078,52922
80000,8,70536.0,53333,1466.68,9464,70536
100000,8,88115.0,66666,1833.32,11885,88115
200000,8,176423.0,133333,3666.68,23577,176423
400000,8,352619.0,266666,7333.32,47381,352619
600000,8,529110.0,400000,11000.0,70890,529110
800000,8,705711.0,533333,14666.68,94289,705711
1000000,8,881963.0,666666,18333.31,118037,881963
2,9,2.0,1,0.05,0,2
3,9,3.0,2,0.06,0,3
100,9,86.0,7,0.13,14,86
200,9,174.0,7,0.13,26,174
2000,9,1778.0,7,0.13,222,1778
10000,9,8959.0,7,0.13,1041,8959
20000,9,17956.0,7,0.13,2044,17956
40000,9,35981.0,7,0.13,4019,35981
60000,9,53938.0,7,0.13,6062,53938
80000,9,71991.0,7,0.13,8009,71991
100000,9,90012.0,7,0.13,9988,90012
200000,9,180212.0,7,0.13,19788,180212
400000,9,360304.0,7,0.13,39696,360304
600000,9,540206.0,7,0.13,59794,540206
800000,9,720139.0,7,0.13,79861,720139
1000000,9,900327.0,7,0.13,99673,900327
2,10,2.0,1,0.05,0,2
3,10,2.0,2,0.06,1,2
100,10,87.0,4,0.16,13,87
200,10,179.0,4,0.16,21,179
2000,10,1813.0,4,0.16,187,1813
10000,10,9021.0,4,0.16,979,9021
20000,10,17986.0,4,0.16,2014,17986
40000,10,36016.0,4,0.16,3984,36016
60000,10,54055.0,4,0.16,5945,54055
80000,10,72071.0,4,0.16,7929,72071
100000,10,90115.0,4,0.16,9885,90115
200000,10,180068.0,4,0.16,19932,180068
400000,10,360119.0,4,0.16,39881,360119
600000,10,539822.0,4,0.16,60178,539822
800000,10,719653.0,4,0.16,80347,719653
1000000,10,899799.0,4,0.16,100201,899799
2,11,2.0,1,0.05,0,2
3,11,3.0,2,0.06,0,3
100,11,90.0,98,4.76,10,90
200,11,178.0,198,9.77,22,178
2000,11,1665.0,1998,99.76,335,1665
10000,11,8477.0,9998,499.77,1523,8477
20000,11,16967.0,19998,999.76,3033,16967
40000,11,34070.0,39998,1999.76,5930,34070
60000,11,51009.0,59998,2999.77,8991,51009
80000,11,68017.0,79998,3999.77,11983,68017
100000,11,84948.0,99998,4999.77,15052,84948
200000,11,170161.0,199998,9999.76,29839,170161
400000,11,340087.0,399998,19999.76,59913,340087
600000,11,509907.0,599998,29999.76,90093,509907
800000,11,680085.0,799998,39999.77,119915,680085
1000000,11,850016.0,999998,49999.77,149984,850016
2,12,2.0,1,0.05,0,2
3,12,3.0,2,0.06,0,3
100,12,86.0,97,0.62,14,86
200,12,173.0,197,1.12,27,173
2000,12,1753.0,1997,10.12,247,1753
10000,12,8890.0,9997,50.12,1110,8890
20000,12,17862.0,19997,100.12,2138,17862
40000,12,35814.0,39997,200.12,4186,35814
60000,12,53755.0,59997,300.12,6245,53755
80000,12,71637.0,79997,400.12,8363,71637
100000,12,89557.0,99997,500.12,10443,89557
200000,12,179151.0,199997,1000.12,20849,179151
400000,12,358075.0,399997,2000.12,41925,358075
600000,12,536920.0,599997,3000.12,63080,536920
800000,12,715946.0,799997,4000.12,84054,715946
1000000,12,895092.0,999997,5000.12,104908,895092
2,13,2.0,1,0.05,0,2
3,13,3.0,2,0.06,0,3
100,13,87.0,6,0.12,13,87
200,13,179.0,6,0.12,21,179
2000,13,1801.0,6,0.12,199,1801
10000,13,9027.0,6,0.12,973,9027
20000,13,18033.0,6,0.12,1967,18033
40000,13,36002.0,6,0.12,3998,36002
60000,13,53939.0,6,0.12,6061,53939
80000,13,71957.0,6,0.12,8043,71957
100000,13,89971.0,6,0.12,10029,89971
200000,13,180103.0,6,0.12,19897,180103
400000,13,360213.0,6,0.12,39787,360213
600000,13,539963.0,6,0.12,60037,539963
800000,13,719997.0,6,0.12,80003,719997
1000000,13,900021.0,6,0.12,99979,900021
2,14,1.0,1,0.05,1,1
3,14,2.0,2,0.06,1,2
100,14,92.0,50,0.3,8,92
200,14,176.0,100,0.55,24,176
2000,14,1790.0,1000,5.04,210,1790
10000,14,8984.0,5000,25.04,1016,8984
20000,14,17978.0,10000,50.05,2022,17978
40000,14,35985.0,20000,100.04,4015,35985
60000,14,53937.0,30000,150.04,6063,53937
80000,14,71864.0,40000,200.04,8136,71864
100000,14,89819.0,50000,250.04,10181,89819
200000,14,179447.0,100000,500.04,20553,179447
400000,14,358829.0,200000,1000.04,41171,358829
600000,14,538459.0,300000,1500.05,61541,538459
800000,14,717769.0,400000,2000.05,82231,717769
1000000,14,897511.0,500000,2500.05,102489,897511
2,15,2.0,1,0.05,0,2
3,15,3.0,2,0.06,0,3
100,15,87.0,52,0.49,13,87
200,15,176.0,102,0.74,24,176
2000,15,1804.0,1002,5.23,196,1804
10000,15,9063.0,5002,25.23,937,9063
20000,15,18079.0,10002,50.24,1921,18079
40000,15,36060.0,20002,100.23,3940,36060
60000,15,54041.0,30002,150.23,5959,54041
80000,15,71924.0,40002,200.23,8076,71924
100000,15,89791.0,50002,250.23,10209,89791
200000,15,179508.0,100002,500.23,20492,179508
400000,15,359086.0,200002,1000.23,40914,359086
600000,15,538610.0,300002,1500.24,61390,538610
800000,15,718147.0,400002,2000.24,81853,718147
1000000,15,897806.0,500002,2500.24,102194,897806
2,16,2.0,1,0.05,0,2
3,16,3.0,2,0.06,0,3
100,16,94.0,52,0.44,6,94
200,16,186.0,102,0.69,14,186
2000,16,1798.0,1002,5.19,202,1798
10000,16,8997.0,5002,25.19,1003,8997
20000,16,17971.0,10002,50.19,2029,17971
40000,16,35928.0,20002,100.19,4072,35928
60000,16,53849.0,30002,150.19,6151,53849
80000,16,71890.0,40002,200.19,8110,71890
100000,16,89871.0,50002,250.19,10129,89871
200000,16,179685.0,100002,500.19,20315,179685
400000,16,359238.0,200002,1000.19,40762,359238
600000,16,538847.0,300002,1500.19,61153,538847
800000,16,718074.0,400002,2000.19,81926,718074
1000000,16,897635.0,500002,2500.19,102365,897635
2,17,2.0,1,0.05,0,2
3,17,3.0,2,0.06,0,3
100,17,83.0,98,4.49,17,83
200,17,170.0,198,9.5,30,170
2000,17,1683.0,1998,99.49,317,1683
10000,17,8466.0,9998,499.5,1534,8466
20000,17,16971.0,19998,999.49,3029,16971
40000,17,34101.0,39998,1999.49,5899,34101
60000,17,51188.0,59998,2999.5,8812,51188
80000,17,68273.0,79998,3999.5,11727,68273
100000,17,85263.0,99998,4999.5,14737,85263
200000,17,170129.0,199998,9999.49,29871,170129
400000,17,340103.0,399998,19999.49,59897,340103
600000,17,510161.0,599998,29999.49,89839,510161
800000,17,679440.0,799998,39999.5,120560,679440
1000000,17,849232.0,999998,49999.5,150768,849232
2,18,2.0,1,0.05,0,2
3,18,3.0,2,0.06,0,3
100,18,89.0,94,2.59,11,89
200,18,177.0,194,5.33,23,177
2000,18,1755.0,1994,54.83,245,1755
10000,18,8699.0,9994,274.84,1301,8699
20000,18,17409.0,19994,549.84,2591,17409
40000,18,34859.0,39994,1099.83,5141,34859
60000,18,52239.0,59994,1649.84,7761,52239
80000,18,69633.0,79994,2199.84,10367,69633
100000,18,87037.0,99994,2749.84,12963,87037
200000,18,174081.0,199994,5499.84,25919,174081
400000,18,348738.0,399994,10999.83,51262,348738
600000,18,523360.0,599994,16499.83,76640,523360
800000,18,697611.0,799994,21999.83,102389,697611
1000000,18,872020.0,999994,27499.83,127980,872020
2,19,1.0,1,0.05,1,1
3,19,2.0,2,0.06,1,2
100,19,92.0,5,0.07,8,92
200,19,176.0,5,0.07,24,176
2000,19,1778.0,5,0.07,222,1778
10000,19,8958.0,5,0.07,1042,8958
20000,19,17958.0,5,0.07,2042,17958
40000,19,35955.0,5,0.07,4045,35955
60000,19,54000.0,5,0.07,6000,54000
80000,19,72017.0,5,0.07,7983,72017
100000,19,90115.0,5,0.07,9885,90115
200000,19,180262.0,5,0.07,19738,180262
400000,19,360270.0,5,0.07,39730,360270
600000,19,540362.0,5,0.07,59638,540362
800000,19,720439.0,5,0.07,79561,720439
1000000,19,900355.0,5,0.07,99645,900355
2,20,2.0,1,0.05,0,2
3,20,3.0,2,0.06,0,3
100,20,89.0,13,0.29,11,89
200,20,178.0,13,0.29,22,178
2000,20,1804.0,13,0.29,196,1804
10000,20,8995.0,13,0.29,1005,8995
20000,20,18066.0,13,0.29,1934,18066
40000,20,36105.0,13,0.29,3895,36105
60000,20,54079.0,13,0.29,5921,54079
80000,20,72078.0,13,0.29,7922,72078
100000,20,90092.0,13,0.29,9908,90092
200000,20,180128.0,13,0.29,19872,180128
400000,20,360155.0,13,0.29,39845,360155
600000,20,540150.0,13,0.29,59850,540150
800000,20,720156.0,13,0.29,79844,720156
1000000,20,899997.0,13,0.29,100003,899997
2,21,1.0,1,0.05,1,1
3,21,2.0,2,0.06,1,2
100,21,83.0,98,0.54,17,83
200,21,171.0,198,1.04,29,171
2000,21,1795.0,1998,10.04,205,1795
10000,21,8920.0,9998,50.04,1080,8920
20000,21,17915.0,19998,100.03,2085,17915
40000,21,35826.0,39998,200.03,4174,35826
60000,21,53748.0,59998,300.03,6252,53748
80000,21,71586.0,79998,400.03,8414,71586
100000,21,89474.0,99998,500.03,10526,89474
200000,21,179169.0,199998,1000.03,20831,179169
400000,21,358140.0,399998,2000.04,41860,358140
600000,21,537008.0,599998,3000.04,62992,537008
800000,21,716077.0,799998,4000.04,83923,716077
1000000,21,894986.0,999998,5000.04,105014,894986
2,22,1.0,1,0.05,1,1
3,22,2.0,2,0.06,1,2
100,22,87.0,99,0.63,13,87
200,22,182.0,199,1.13,18,182
2000,22,1799.0,1999,10.13,201,1799
10000,22,8967.0,9999,50.13,1033,8967
20000,22,17893.0,19999,100.13,2107,17893
40000,22,35834.0,39999,200.13,4166,35834
60000,22,53739.0,59999,300.13,6261,53739
80000,22,71656.0,79999,400.13,8344,71656
100000,22,89491.0,99999,500.13,10509,89491
200000,22,178864.0,199999,1000.13,21136,178864
400000,22,357978.0,399999,2000.13,42022,357978
600000,22,536953.0,599999,3000.13,63047,536953
800000,22,715856.0,799999,4000.13,84144,715856
1000000,22,895059.0,999999,5000.13,104941,895059
2,23,2.0,1,0.05,0,2
3,23,3.0,2,0.06,0,3
100,23,84.0,96,4.62,16,84
200,23,166.0,196,9.62,34,166
2000,23,1699.0,1996,99.62,301,1699
10000,23,8458.0,9996,499.62,1542,8458
20000,23,17033.0,19996,999.62,2967,17033
40000,23,34030.0,39996,1999.62,5970,34030
60000,23,51077.0,59996,2999.62,8923,51077
80000,23,68133.0,79996,3999.62,11867,68133
100000,23,85122.0,99996,4999.62,14878,85122
200000,23,170100.0,199996,9999.62,29900,170100
400000,23,340157.0,399996,19999.62,59843,340157
600000,23,510056.0,599996,29999.62,89944,510056
800000,23,680121.0,799996,39999.62,119879,680121
1000000,23,850226.0,999996,49999.62,149774,850226
2,24,2.0,1,0.05,0,2
3,24,2.0,2,0.06,1,2
100,24,92.0,3,0.11,8,92
200,24,184.0,3,0.11,16,184
2000,24,1801.0,3,0.11,199,1801
10000,24,8974.0,3,0.11,1026,8974
20000,24,17968.0,3,0.11,2032,17968
40000,24,36042.0,3,0.11,3958,36042
60000,24,54003.0,3,0.11,5997,54003
80000,24,72029.0,3,0.11,7971,72029
100000,24,90060.0,3,0.11,9940,90060
200000,24,180146.0,3,0.11,19854,180146
400000,24,359968.0,3,0.11,40032,359968
600000,24,539876.0,3,0.11,60124,539876
800000,24,720234.0,3,0.11,79766,720234
1000000,24,900188.0,3,0.11,99812,900188
2,25,2.0,1,0.05,0,2
3,25,3.0,2,0.06,0,3
100,25,89.0,96,0.75,11,89
200,25,177.0,196,1.25,23,177
2000,25,1798.0,1996,10.25,202,1798
10000,25,8899.0,9996,50.25,1101,8899
20000,25,17851.0,19996,100.25,2149,17851
40000,25,35750.0,39996,200.25,4250,35750
60000,25,53623.0,59996,300.25,6377,53623
80000,25,71499.0,79996,400.25,8501,71499
100000,25,89419.0,99996,500.25,10581,89419
200000,25,179017.0,199996,1000.25,20983,179017
400000,25,357953.0,399996,2000.25,42047,357953
600000,25,537176.0,599996,3000.25,62824,537176
800000,25,716015.0,799996,4000.25,83985,716015
1000000,25,895206.0,999996,5000.25,104794,895206
2,26,2.0,1,0.05,0,2
3,26,3.0,2,0.06,0,3
100,26,86.0,8,0.27,14,86
200,26,181.0,8,0.27,19,181
2000,26,1813.0,8,0.27,187,1813
10000,26,9001.0,8,0.27,999,9001
20000,26,18029.0,8,0.27,1971,18029
40000,26,36066.0,8,0.27,3934,36066
60000,26,53983.0,8,0.27,6017,53983
80000,26,71992.0,8,0.27,8008,71992
100000,26,89964.0,8,0.27,10036,89964
200000,26,179996.0,8,0.27,20004,179996
400000,26,360018.0,8,0.27,39982,360018
600000,26,540224.0,8,0.27,59776,540224
800000,26,720646.0,8,0.27,79354,720646
1000000,26,900956.0,8,0.27,99044,900956
2,27,0.0,1,0.05,2,0
3,27,1.0,2,0.06,2,1
100,27,89.0,99,0.54,11,89
200,27,182.0,199,1.04,18,182
2000,27,1779.0,1999,10.04,221,1779
10000,27,8944.0,9999,50.04,1056,8944
20000,27,17884.0,19999,100.04,2116,17884
40000,27,35853.0,39999,200.04,4147,35853
60000,27,53737.0,59999,300.04,6263,53737
80000,27,71592.0,79999,400.04,8408,71592
100000,27,89434.0,99999,500.04,10566,89434
200000,27,178910.0,199999,1000.04,21090,178910
400000,27,358170.0,399999,2000.04,41830,358170
600000,27,537040.0,599999,3000.04,62960,537040
800000,27,716075.0,799999,4000.04,83925,716075
1000000,27,895118.0,999999,5000.04,104882,895118
2,28,2.0,1,0.05,0,2
3,28,3.0,2,0.06,0,3
100,28,92.0,10,0.32,8,92
200,28,183.0,10,0.32,17,183
2000,28,1794.0,10,0.32,206,1794
10000,28,9046.0,10,0.32,954,9046
20000,28,18030.0,10,0.32,1970,18030
40000,28,36014.0,10,0.32,3986,36014
60000,28,54074.0,10,0.32,5926,54074
80000,28,72070.0,10,0.32,7930,72070
100000,28,90062.0,10,0.32,9938,90062
200000,28,180019.0,10,0.32,19981,180019
400000,28,360106.0,10,0.32,39894,360106
600000,28,540284.0,10,0.32,59716,540284
800000,28,720362.0,10,0.32,79638,720362
1000000,28,900365.0,10,0.32,99635,900365
2,29,2.0,1,0.05,0,2
3,29,3.0,2,0.06,0,3
100,29,88.0,66,1.82,12,88
200,29,174.0,133,3.68,26,174
2000,29,1776.0,1333,36.68,224,1776
10000,29,8901.0,6666,183.31,1099,8901
20000,29,17748.0,13333,366.68,2252,17748
40000,29,35454.0,26666,733.31,4546,35454
60000,29,53126.0,40000,1100.0,6874,53126
80000,29,70785.0,53333,1466.68,9215,70785
100000,29,88562.0,66666,1833.32,11438,88562
200000,29,176756.0,133333,3666.68,23244,176756
400000,29,353052.0,266666,7333.32,46948,353052
600000,29,529378.0,400000,11000.0,70622,529378
800000,29,705896.0,533333,14666.68,94104,705896
1000000,29,882257.0,666666,18333.31,117743,882257
2,30,2.0,1,0.05,0,2
3,30,3.0,2,0.06,0,3
100,30,90.0,93,4.51,10,90
200,30,169.0,193,9.52,31,169
2000,30,1690.0,1993,99.51,310,1690
10000,30,8534.0,9993,499.52,1466,8534
20000,30,17042.0,19993,999.51,2958,17042
40000,30,34075.0,39993,1999.51,5925,34075
60000,30,51081.0,59993,2999.52,8919,51081
80000,30,68102.0,79993,3999.52,11898,68102
100000,30,85257.0,99993,4999.52,14743,85257
200000,30,170249.0,199993,9999.51,29751,170249
400000,30,340445.0,399993,19999.51,59555,340445
600000,30,510444.0,599993,29999.51,89556,510444
800000,30,680295.0,799993,39999.52,119705,680295
1000000,30,850552.0,999993,49999.52,149448,850552
2,31,1.0,1,0.05,1,1
3,31,2.0,2,0.06,1,2
100,31,91.0,10,0.1,9,91
200,31,181.0,10,0.1,19,181
2000,31,1812.0,10,0.1,188,1812
10000,31,8997.0,10,0.1,1003,8997
20000,31,17975.0,10,0.1,2025,17975
40000,31,35941.0,10,0.1,4059,35941
60000,31,54018.0,10,0.1,5982,54018
80000,31,72002.0,10,0.1,7998,72002
100000,31,89991.0,10,0.1,10009,89991
200000,31,179861.0,10,0.1,20139,179861
400000,31,359713.0,10,0.1,40287,359713
600000,31,539579.0,10,0.1,60421,539579
800000,31,719649.0,10,0.1,80351,719649
1000000,31,899796.0,10,0.1,100204,899796
2,32,2.0,1,0.05,0,2
3,32,3.0,2,0.06,0,3
100,32,90.0,9,0.32,10,90
200,32,177.0,9,0.32,23,177
2000,32,1785.0,9,0.32,215,1785
10000,32,8923.0,9,0.32,1077,8923
20000,32,17888.0,9,0.32,2112,17888
40000,32,35871.0,9,0.32,4129,35871
60000,32,53830.0,9,0.32,6170,53830
80000,32,71936.0,9,0.32,8064,71936
100000,32,89945.0,9,0.32,10055,89945
200000,32,180015.0,9,0.32,19985,180015
400000,32,359816.0,9,0.32,40184,359816
600000,32,539608.0,9,0.32,60392,539608
800000,32,719474.0,9,0.32,80526,719474
1000000,32,899105.0,9,0.32,100895,899105
2,33,2.0,1,0.05,0,2
3,33,3.0,2,0.06,0,3
100,33,89.0,53,2.38,11,89
200,33,178.0,103,4.88,22,178
2000,33,1776.0,1003,49.88,224,1776
10000,33,8816.0,5003,249.88,1184,8816
20000,33,17559.0,10003,499.88,2441,17559
40000,33,35087.0,20003,999.88,4913,35087
60000,33,52637.0,30003,1499.88,7363,52637
80000,33,70125.0,40003,1999.88,9875,70125
100000,33,87552.0,50003,2499.88,12448,87552
200000,33,175019.0,100003,4999.88,24981,175019
400000,33,350066.0,200003,9999.88,49934,350066
600000,33,525019.0,300003,14999.88,74981,525019
800000,33,699994.0,400003,19999.88,100006,699994
1000000,33,874897.0,500003,24999.88,125103,874897
2,34,2.0,1,0.05,0,2
3,34,3.0,2,0.06,0,3
100,34,88.0,11,0.15,12,88
200,34,181.0,11,0.15,19,181
2000,34,1808.0,11,0.15,192,1808
10000,34,9023.0,11,0.15,977,9023
20000,34,18017.0,11,0.15,1983,18017
40000,34,36024.0,11,0.15,3976,36024
60000,34,54010.0,11,0.15,5990,54010
80000,34,72013.0,11,0.15,7987,72013
100000,34,90045.0,11,0.15,9955,90045
200000,34,180099.0,11,0.15,19901,180099
400000,34,360012.0,11,0.15,39988,360012
600000,34,539913.0,11,0.15,60087,539913
800000,34,719934.0,11,0.15,80066,719934
1000000,34,900041.0,11,0.15,99959,900041
2,35,2.0,1,0.05,0,2
3,35,3.0,2,0.06,0,3
100,35,86.0,51,0.35,14,86
200,35,166.0,101,0.6,34,166
2000,35,1772.0,1001,5.09,228,1772
10000,35,8928.0,5001,25.09,1072,8928
20000,35,17885.0,10001,50.1,2115,17885
40000,35,35792.0,20001,100.09,4208,35792
60000,35,53769.0,30001,150.09,6231,53769
80000,35,71685.0,40001,200.09,8315,71685
100000,35,89623.0,50001,250.09,10377,89623
200000,35,179388.0,100001,500.09,20612,179388
400000,35,358821.0,200001,1000.09,41179,358821
600000,35,538333.0,300001,1500.1,61667,538333
800000,35,717935.0,400001,2000.1,82065,717935
1000000,35,897354.0,500001,2500.1,102646,897354
2,36,2.0,1,0.05,0,2
3,36,3.0,2,0.06,0,3
100,36,91.0,9,0.27,9,91
200,36,182.0,9,0.27,18,182
2000,36,1786.0,9,0.27,214,1786
10000,36,9010.0,9,0.27,990,9010
20000,36,18028.0,9,0.27,1972,18028
40000,36,35962.0,9,0.27,4038,35962
60000,36,53992.0,9,0.27,6008,53992
80000,36,72003.0,9,0.27,7997,72003
100000,36,90003.0,9,0.27,9997,90003
200000,36,180052.0,9,0.27,19948,180052
400000,36,360051.0,9,0.27,39949,360051
600000,36,540066.0,9,0.27,59934,540066
800000,36,719937.0,9,0.27,80063,719937
1000000,36,899908.0,9,0.27,100092,899908
2,37,1.0,1,0.05,1,1
3,37,2.0,2,0.06,1,2
100,37,87.0,10,0.1,13,87
200,37,174.0,10,0.1,26,174
2000,37,1813.0,10,0.1,187,1813
10000,37,8993.0,10,0.1,1007,8993
20000,37,17996.0,10,0.1,2004,17996
40000,37,35928.0,10,0.1,4072,35928
60000,37,53931.0,10,0.1,6069,53931
80000,37,71951.0,10,0.1,8049,71951
100000,37,89893.0,10,0.1,10107,89893
200000,37,179895.0,10,0.1,20105,179895
400000,37,359938.0,10,0.1,40062,359938
600000,37,539916.0,10,0.1,60084,539916
800000,37,719764.0,10,0.1,80236,719764
1000000,37,899666.0,10,0.1,100334,899666
2,38,2.0,1,0.05,0,2
3,38,3.0,2,0.06,0,3
100,38,90.0,51,2.46,10,90
200,38,183.0,101,4.96,17,183
2000,38,1766.0,1001,49.96,234,1766
10000,38,8790.0,5001,249.96,1210,8790
20000,38,17545.0,10001,499.96,2455,17545
40000,38,35088.0,20001,999.96,4912,35088
60000,38,52557.0,30001,1499.96,7443,52557
80000,38,70025.0,40001,1999.96,9975,70025
100000,38,87515.0,50001,2499.96,12485,87515
200000,38,174790.0,100001,4999.96,25210,174790
400000,38,349787.0,200001,9999.96,50213,349787
600000,38,524967.0,300001,14999.96,75033,524967
800000,38,699814.0,400001,19999.96,100186,699814
1000000,38,874659.0,500001,24999.96,125341,874659
2,39,2.0,1,0.05,0,2
3,39,3.0,2,0.06,0,3
100,39,87.0,52,0.44,13,87
200,39,174.0,102,0.69,26,174
2000,39,1790.0,1002,5.19,210,1790
10000,39,8953.0,5002,25.19,1047,8953
20000,39,17938.0,10002,50.19,2062,17938
40000,39,35961.0,20002,100.19,4039,35961
60000,39,53876.0,30002,150.19,6124,53876
80000,39,71769.0,40002,200.19,8231,71769
100000,39,89710.0,50002,250.19,10290,89710
200000,39,179419.0,100002,500.19,20581,179419
400000,39,358884.0,200002,1000.19,41116,358884
600000,39,538363.0,300002,1500.19,61637,538363
800000,39,717945.0,400002,2000.19,82055,717945
1000000,39,897220.0,500002,2500.19,102780,897220
2,40,2.0,1,0.05,0,2
3,40,3.0,2,0.06,0,3
100,40,88.0,5,0.12,12,88
200,40,180.0,5,0.12,20,180
2000,40,1805.0,5,0.12,195,1805
10000,40,9040.0,5,0.12,960,9040
20000,40,18062.0,5,0.12,1938,18062
40000,40,36029.0,5,0.12,3971,36029
60000,40,54002.0,5,0.12,5998,54002
80000,40,72052.0,5,0.12,7948,72052
100000,40,90072.0,5,0.12,9928,90072
200000,40,180080.0,5,0.12,19920,180080
400000,40,360038.0,5,0.12,39962,360038
600000,40,540011.0,5,0.12,59989,540011
800000,40,720026.0,5,0.12,79974,720026
1000000,40,899899.0,5,0.12,100101,899899
2,41,1.0,1,0.05,1,1
3,41,2.0,2,0.06,1,2
100,41,83.0,99,4.63,17,83
200,41,166.0,199,9.64,34,166
2000,41,1704.0,1999,99.63,296,1704
10000,41,8559.0,9999,499.64,1441,8559
20000,41,17080.0,19999,999.63,2920,17080
40000,41,34129.0,39999,1999.63,5871,34129
60000,41,51108.0,59999,2999.64,8892,51108
80000,41,68145.0,79999,3999.64,11855,68145
100000,41,85245.0,99999,4999.64,14755,85245
200000,41,170199.0,199999,9999.63,29801,170199
400000,41,340436.0,399999,19999.63,59564,340436
600000,41,510217.0,599999,29999.63,89783,510217
800000,41,680127.0,799999,39999.64,119873,680127
1000000,41,850196.0,999999,49999.64,149804,850196
2,42,2.0,1,0.05,0,2
3,42,3.0,2,0.06,0,3
100,42,90.0,6,0.12,10,90
200,42,179.0,6,0.12,21,179
2000,42,1775.0,6,0.12,225,1775
10000,42,9002.0,6,0.12,998,9002
20000,42,17995.0,6,0.12,2005,17995
40000,42,36026.0,6,0.12,3974,36026
60000,42,53982.0,6,0.12,6018,53982
80000,42,71998.0,6,0.12,8002,71998
100000,42,90020.0,6,0.12,9980,90020
200000,42,180158.0,6,0.12,19842,180158
400000,42,359985.0,6,0.12,40015,359985
600000,42,540006.0,6,0.12,59994,540006
800000,42,720178.0,6,0.12,79822,720178
1000000,42,899899.0,6,0.12,100101,899899
2,43,2.0,1,0.05,0,2
3,43,3.0,2,0.06,0,3
100,43,91.0,52,0.44,9,91
200,43,185.0,102,0.69,15,185
2000,43,1813.0,1002,5.19,187,1813
10000,43,8978.0,5002,25.19,1022,8978
20000,43,17942.0,10002,50.19,2058,17942
40000,43,35853.0,20002,100.19,4147,35853
60000,43,53832.0,30002,150.19,6168,53832
80000,43,71722.0,40002,200.19,8278,71722
100000,43,89642.0,50002,250.19,10358,89642
200000,43,179377.0,100002,500.19,20623,179377
400000,43,358922.0,200002,1000.19,41078,358922
600000,43,538418.0,300002,1500.19,61582,538418
800000,43,718012.0,400002,2000.19,81988,718012
1000000,43,897182.0,500002,2500.19,102818,897182
2,44,2.0,1,0.05,0,2
3,44,3.0,2,0.06,0,3
100,44,91.0,95,0.7,9,91
200,44,181.0,195,1.2,19,181
2000,44,1799.0,1995,10.2,201,1799
10000,44,8966.0,9995,50.2,1034,8966
20000,44,17925.0,19995,100.2,2075,17925
40000,44,35787.0,39995,200.2,4213,35787
60000,44,53690.0,59995,300.2,6310,53690
80000,44,71530.0,79995,400.2,8470,71530
100000,44,89390.0,99995,500.2,10610,89390
200000,44,178892.0,199995,1000.2,21108,178892
400000,44,357918.0,399995,2000.2,42082,357918
600000,44,536934.0,599995,3000.2,63066,536934
800000,44,715892.0,799995,4000.2,84108,715892
1000000,44,894892.0,999995,5000.2,105108,894892
2,45,2.0,1,0.05,0,2
3,45,3.0,2,0.06,0,3
100,45,87.0,95,0.75,13,87
200,45,175.0,195,1.24,25,175
2000,45,1749.0,1995,10.25,251,1749
10000,45,8912.0,9995,50.25,1088,8912
20000,45,17852.0,19995,100.24,2148,17852
40000,45,35691.0,39995,200.24,4309,35691
60000,45,53633.0,59995,300.24,6367,53633
80000,45,71566.0,79995,400.24,8434,71566
100000,45,89484.0,99995,500.24,10516,89484
200000,45,178849.0,199995,1000.24,21151,178849
400000,45,357831.0,399995,2000.25,42169,357831
600000,45,536807.0,599995,3000.25,63193,536807
800000,45,715618.0,799995,4000.25,84382,715618
1000000,45,894428.0,999995,5000.25,105572,894428
2,46,2.0,1,0.05,0,2
3,46,3.0,2,0.06,0,3
100,46,92.0,8,0.22,8,92
200,46,183.0,8,0.22,17,183
2000,46,1793.0,8,0.22,207,1793
10000,46,9027.0,8,0.22,973,9027
20000,46,18032.0,8,0.22,1968,18032
40000,46,36109.0,8,0.22,3891,36109
60000,46,54064.0,8,0.22,5936,54064
80000,46,72068.0,8,0.22,7932,72068
100000,46,90082.0,8,0.22,9918,90082
200000,46,180020.0,8,0.22,19980,180020
400000,46,360095.0,8,0.22,39905,360095
600000,46,540061.0,8,0.22,59939,540061
800000,46,720191.0,8,0.22,79809,720191
1000000,46,899942.0,8,0.22,100058,899942
2,47,1.0,1,0.05,1,1
3,47,2.0,2,0.06,1,2
100,47,90.0,5,0.07,10,90
200,47,183.0,5,0.07,17,183
2000,47,1798.0,5,0.07,202,1798
10000,47,8972.0,5,0.07,1028,8972
20000,47,17981.0,5,0.07,2019,17981
40000,47,35950.0,5,0.07,4050,35950
60000,47,53906.0,5,0.07,6094,53906
80000,47,71912.0,5,0.07,8088,71912
100000,47,89951.0,5,0.07,10049,89951
200000,47,180017.0,5,0.07,19983,180017
400000,47,360181.0,5,0.07,39819,360181
600000,47,540114.0,5,0.07,59886,540114
800000,47,720252.0,5,0.07,79748,720252
1000000,47,900347.0,5,0.07,99653,900347
2,48,2.0,1,0.05,0,2
3,48,3.0,2,0.06,0,3
100,48,87.0,54,2.3,13,87
200,48,178.0,104,4.79,22,178
2000,48,1750.0,1004,49.79,250,1750
10000,48,8702.0,5004,249.8,1298,8702
20000,48,17437.0,10004,499.8,2563,17437
40000,48,34917.0,20004,999.79,5083,34917
60000,48,52433.0,30004,1499.79,7567,52433
80000,48,69966.0,40004,1999.79,10034,69966
100000,48,87457.0,50004,2499.8,12543,87457
200000,48,174967.0,100004,4999.8,25033,174967
400000,48,349999.0,200004,9999.79,50001,349999
600000,48,525283.0,300004,14999.79,74717,525283
800000,48,700109.0,400004,19999.79,99891,700109
1000000,48,875066.0,500004,24999.79,124934,875066
2,49,2.0,1,0.05,0,2
3,49,3.0,2,0.06,0,3
100,49,90.0,97,2.69,10,90
200,49,178.0,197,5.44,22,178
2000,49,1758.0,1997,54.94,242,1758
10000,49,8760.0,9997,274.94,1240,8760
20000,49,17469.0,19997,549.94,2531,17469
40000,49,34946.0,39997,1099.94,5054,34946
60000,49,52386.0,59997,1649.94,7614,52386
80000,49,69864.0,79997,2199.94,10136,69864
100000,49,87351.0,99997,2749.94,12649,87351
200000,49,174679.0,199997,5499.94,25321,174679
400000,49,349079.0,399997,10999.94,50921,349079
600000,49,523830.0,599997,16499.94,76170,523830
800000,49,698333.0,799997,21999.94,101667,698333
1000000,49,872797.0,999997,27499.94,127203,872797
2,50,2.0,1,0.05,0,2
3,50,3.0,2,0.06,0,3
100,50,85.0,11,0.42,15,85
200,50,176.0,11,0.42,24,176
2000,50,1809.0,11,0.42,191,1809
10000,50,9005.0,11,0.42,995,9005
20000,50,18011.0,11,0.42,1989,18011
40000,50,36001.0,11,0.42,3999,36001
60000,50,54002.0,11,0.42,5998,54002
80000,50,72056.0,11,0.42,7944,72056
100000,50,90053.0,11,0.42,9947,90053
200000,50,180136.0,11,0.42,19864,180136
400000,50,360176.0,11,0.42,39824,360176
600000,50,540454.0,11,0.42,59546,540454
800000,50,720441.0,11,0.42,79559,720441
1000000,50,900332.0,11,0.42,99668,900332
2,51,2.0,1,0.05,0,2
3,51,3.0,2,0.06,0,3
100,51,87.0,5,0.16,13,87
200,51,179.0,5,0.16,21,179
2000,51,1809.0,5,0.16,191,1809
10000,51,9006.0,5,0.16,994,9006
20000,51,17997.0,5,0.16,2003,17997
40000,51,36074.0,5,0.16,3926,36074
60000,51,54052.0,5,0.16,5948,54052
80000,51,72141.0,5,0.16,7859,72141
100000,51,90173.0,5,0.16,9827,90173
200000,51,180139.0,5,0.16,19861,180139
400000,51,360189.0,5,0.16,39811,360189
600000,51,540295.0,5,0.16,59705,540295
800000,51,720201.0,5,0.16,79799,720201
1000000,51,900040.0,5,0.16,99960,900040
2,52,1.0,1,0.05,1,1
3,52,2.0,2,0.06,1,2
100,52,90.0,6,0.08,10,90
200,52,183.0,6,0.08,17,183
2000,52,1828.0,6,0.08,172,1828
10000,52,9074.0,6,0.08,926,9074
20000,52,18067.0,6,0.08,1933,18067
40000,52,36116.0,6,0.08,3884,36116
60000,52,54017.0,6,0.08,5983,54017
80000,52,72083.0,6,0.08,7917,72083
100000,52,90143.0,6,0.08,9857,90143
200000,52,180236.0,6,0.08,19764,180236
400000,52,360132.0,6,0.08,39868,360132
600000,52,540210.0,6,0.08,59790,540210
800000,52,720273.0,6,0.08,79727,720273
1000000,52,900584.0,6,0.08,99416,900584
2,53,2.0,1,0.05,0,2
3,53,2.0,2,0.06,1,2
100,53,90.0,10,0.46,10,90
200,53,172.0,10,0.46,28,172
2000,53,1801.0,10,0.46,199,1801
10000,53,9000.0,10,0.46,1000,9000
20000,53,18013.0,10,0.46,1987,18013
40000,53,35963.0,10,0.46,4037,35963
60000,53,53922.0,10,0.46,6078,53922
80000,53,71977.0,10,0.46,8023,71977
100000,53,89958.0,10,0.46,10042,89958
200000,53,179923.0,10,0.46,20077,179923
400000,53,359872.0,10,0.46,40128,359872
600000,53,539548.0,10,0.46,60452,539548
800000,53,719723.0,10,0.46,80277,719723
1000000,53,899832.0,10,0.46,100168,899832
2,54,0.0,1,0.05,2,0
3,54,1.0,2,0.06,2,1
100,54,91.0,99,0.54,9,91
200,54,182.0,199,1.04,18,182
2000,54,1797.0,1999,10.04,203,1797
10000,54,8974.0,9999,50.04,1026,8974
20000,54,17942.0,19999,100.04,2058,17942
40000,54,35857.0,39999,200.04,4143,35857
60000,54,53740.0,59999,300.04,6260,53740
80000,54,71643.0,79999,400.04,8357,71643
100000,54,89491.0,99999,500.04,10509,89491
200000,54,179068.0,199999,1000.04,20932,179068
400000,54,358274.0,399999,2000.04,41726,358274
600000,54,537106.0,599999,3000.04,62894,537106
800000,54,716096.0,799999,4000.04,83904,716096
1000000,54,894963.0,999999,5000.04,105037,894963
2,55,2.0,1,0.05,0,2
3,55,3.0,2,0.06,0,3
100,55,92.0,52,0.49,8,92
200,55,183.0,102,0.74,17,183
2000,55,1780.0,1002,5.23,220,1780
10000,55,8938.0,5002,25.23,1062,8938
20000,55,17909.0,10002,50.24,2091,17909
40000,55,35798.0,20002,100.23,4202,35798
60000,55,53769.0,30002,150.23,6231,53769
80000,55,71732.0,40002,200.23,8268,71732
100000,55,89640.0,50002,250.23,10360,89640
200000,55,179246.0,100002,500.23,20754,179246
400000,55,358981.0,200002,1000.23,41019,358981
600000,55,538781.0,300002,1500.24,61219,538781
800000,55,718456.0,400002,2000.24,81544,718456
1000000,55,897827.0,500002,2500.24,102173,897827
2,56,2.0,1,0.05,0,2
3,56,3.0,2,0.06,0,3
100,56,84.0,8,0.13,16,84
200,56,177.0,8,0.13,23,177
2000,56,1797.0,8,0.13,203,1797
10000,56,8998.0,8,0.13,1002,8998
20000,56,17987.0,8,0.13,2013,17987
40000,56,35986.0,8,0.13,4014,35986
60000,56,53960.0,8,0.13,6040,53960
80000,56,71981.0,8,0.13,8019,71981
100000,56,90007.0,8,0.13,9993,90007
200000,56,179897.0,8,0.13,20103,179897
400000,56,359903.0,8,0.13,40097,359903
600000,56,539996.0,8,0.13,60004,539996
800000,56,719900.0,8,0.13,80100,719900
1000000,56,899774.0,8,0.13,100226,899774
2,57,2.0,1,0.05,0,2
3,57,2.0,2,0.06,1,2
100,57,87.0,95,4.7,13,87
200,57,177.0,195,9.71,23,177
2000,57,1712.0,1995,99.7,288,1712
10000,57,8462.0,9995,499.71,1538,8462
20000,57,16968.0,19995,999.7,3032,16968
40000,57,33925.0,39995,1999.7,6075,33925
60000,57,50875.0,59995,2999.71,9125,50875
80000,57,67941.0,79995,3999.71,12059,67941
100000,57,84920.0,99995,4999.71,15080,84920
200000,57,169862.0,199995,9999.7,30138,169862
400000,57,339884.0,399995,19999.7,60116,339884
600000,57,509902.0,599995,29999.7,90098,509902
800000,57,679898.0,799995,39999.71,120102,679898
1000000,57,849901.0,999995,49999.71,150099,849901
2,58,1.0,1,0.05,1,1
3,58,1.0,2,0.06,2,1
100,58,88.0,2,0.06,12,88
200,58,171.0,2,0.06,29,171
2000,58,1784.0,2,0.06,216,1784
10000,58,9005.0,2,0.06,995,9005
20000,58,18043.0,2,0.06,1957,18043
40000,58,36043.0,2,0.06,3957,36043
60000,58,54052.0,2,0.06,5948,54052
80000,58,72056.0,2,0.06,7944,72056
100000,58,90079.0,2,0.06,9921,90079
200000,58,180159.0,2,0.06,19841,180159
400000,58,360129.0,2,0.06,39871,360129
600000,58,540388.0,2,0.06,59612,540388
800000,58,720419.0,2,0.06,79581,720419
1000000,58,900535.0,2,0.06,99465,900535
2,59,2.0,1,0.05,0,2
3,59,2.0,2,0.06,1,2
100,59,90.0,4,0.16,10,90
200,59,183.0,4,0.16,17,183
2000,59,1790.0,4,0.16,210,1790
10000,59,8986.0,4,0.16,1014,8986
20000,59,18007.0,4,0.16,1993,18007
40000,59,36070.0,4,0.16,3930,36070
60000,59,54103.0,4,0.16,5897,54103
80000,59,72079.0,4,0.16,7921,72079
100000,59,90048.0,4,0.16,9952,90048
200000,59,180006.0,4,0.16,19994,180006
400000,59,360122.0,4,0.16,39878,360122
600000,59,540046.0,4,0.16,59954,540046
800000,59,720069.0,4,0.16,79931,720069
1000000,59,899883.0,4,0.16,100117,899883
2,60,2.0,1,0.05,0,2
3,60,3.0,2,0.06,0,3
100,60,86.0,95,4.57,14,86
200,60,173.0,195,9.57,27,173
2000,60,1697.0,1995,99.57,303,1697
10000,60,8473.0,9995,499.57,1527,8473
20000,60,16942.0,19995,999.57,3058,16942
40000,60,33883.0,39995,1999.57,6117,33883
60000,60,50968.0,59995,2999.57,9032,50968
80000,60,68062.0,79995,3999.57,11938,68062
100000,60,85052.0,99995,4999.57,14948,85052
200000,60,170116.0,199995,9999.57,29884,170116
400000,60,339789.0,399995,19999.57,60211,339789
600000,60,509635.0,599995,29999.57,90365,509635
800000,60,679788.0,799995,39999.57,120212,679788
1000000,60,849621.0,999995,49999.57,150379,849621
2,61,1.0,1,0.05,1,1
3,61,2.0,2,0.06,1,2
100,61,90.0,99,0.59,10,90
200,61,179.0,199,1.08,21,179
2000,61,1811.0,1999,10.09,189,1811
10000,61,9042.0,9999,50.09,958,9042
20000,61,17970.0,19999,100.08,2030,17970
40000,61,35840.0,39999,200.08,4160,35840
60000,61,53754.0,59999,300.08,6246,53754
80000,61,71655.0,79999,400.08,8345,71655
100000,61,89495.0,99999,500.08,10505,89495
200000,61,178867.0,199999,1000.08,21133,178867
400000,61,357814.0,399999,2000.09,42186,357814
600000,61,536775.0,599999,3000.09,63225,536775
800000,61,715909.0,799999,4000.09,84091,715909
1000000,61,894776.0,999999,5000.09,105224,894776
2,62,2.0,1,0.05,0,2
3,62,3.0,2,0.06,0,3
100,62,82.0,98,0.58,18,82
200,62,172.0,198,1.08,28,172
2000,62,1789.0,1998,10.08,211,1789
10000,62,8882.0,9998,50.08,1118,8882
20000,62,17820.0,19998,100.08,2180,17820
40000,62,35769.0,39998,200.08,4231,35769
60000,62,53648.0,59998,300.08,6352,53648
80000,62,71507.0,79998,400.08,8493,71507
100000,62,89415.0,99998,500.08,10585,89415
200000,62,178771.0,199998,1000.08,21229,178771
400000,62,357701.0,399998,2000.08,42299,357701
600000,62,536664.0,599998,3000.08,63336,536664
800000,62,715863.0,799998,4000.08,84137,715863
1000000,62,894913.0,999998,5000.08,105087,894913
2,63,1.0,1,0.05,1,1
3,63,1.0,2,0.06,2,1
100,63,81.0,99,4.9,19,81
200,63,165.0,199,9.91,35,165
2000,63,1677.0,1999,99.9,323,1677
10000,63,8469.0,9999,499.91,1531,8469
20000,63,17000.0,19999,999.9,3000,17000
40000,63,33994.0,39999,1999.9,6006,33994
60000,63,50939.0,59999,2999.91,9061,50939
80000,63,67967.0,79999,3999.91,12033,67967
100000,63,85028.0,99999,4999.91,14972,85028
200000,63,170136.0,199999,9999.9,29864,170136
400000,63,340042.0,399999,19999.9,59958,340042
600000,63,510033.0,599999,29999.9,89967,510033
800000,63,680085.0,799999,39999.91,119915,680085
1000000,63,850183.0,999999,49999.91,149817,850183
2,64,2.0,1,0.05,0,2
3,64,3.0,2,0.06,0,3
100,64,88.0,91,0.73,12,88
200,64,184.0,191,1.22,16,184
2000,64,1801.0,1991,10.23,199,1801
10000,64,8977.0,9991,50.23,1023,8977
20000,64,17853.0,19991,100.22,2147,17853
40000,64,35810.0,39991,200.22,4190,35810
60000,64,53737.0,59991,300.22,6263,53737
80000,64,71605.0,79991,400.22,8395,71605
100000,64,89449.0,99991,500.22,10551,89449
200000,64,178814.0,199991,1000.22,21186,178814
400000,64,357776.0,399991,2000.23,42224,357776
600000,64,536828.0,599991,3000.23,63172,536828
800000,64,715799.0,799991,4000.23,84201,715799
1000000,64,894674.0,999991,5000.23,105326,894674
2,65,2.0,1,0.05,0,2
3,65,2.0,2,0.06,1,2
100,65,94.0,8,0.36,6,94
200,65,181.0,8,0.36,19,181
2000,65,1813.0,8,0.36,187,1813
10000,65,9038.0,8,0.36,962,9038
20000,65,18046.0,8,0.36,1954,18046
40000,65,36009.0,8,0.36,3991,36009
60000,65,53998.0,8,0.36,6002,53998
80000,65,72022.0,8,0.36,7978,72022
100000,65,90100.0,8,0.36,9900,90100
200000,65,179994.0,8,0.36,20006,179994
400000,65,360040.0,8,0.36,39960,360040
600000,65,539851.0,8,0.36,60149,539851
800000,65,719743.0,8,0.36,80257,719743
1000000,65,899876.0,8,0.36,100124,899876
2,66,2.0,1,0.05,0,2
3,66,3.0,2,0.06,0,3
100,66,87.0,52,0.44,13,87
200,66,179.0,102,0.69,21,179
2000,66,1797.0,1002,5.19,203,1797
10000,66,8957.0,5002,25.19,1043,8957
20000,66,17965.0,10002,50.19,2035,17965
40000,66,35937.0,20002,100.19,4063,35937
60000,66,53917.0,30002,150.19,6083,53917
80000,66,71841.0,40002,200.19,8159,71841
100000,66,89777.0,50002,250.19,10223,89777
200000,66,179598.0,100002,500.19,20402,179598
400000,66,359181.0,200002,1000.19,40819,359181
600000,66,538684.0,300002,1500.19,61316,538684
800000,66,718437.0,400002,2000.19,81563,718437
1000000,66,898111.0,500002,2500.19,101889,898111
2,67,2.0,1,0.05,0,2
3,67,3.0,2,0.06,0,3
100,67,93.0,51,0.35,7,93
200,67,184.0,101,0.6,16,184
2000,67,1816.0,1001,5.09,184,1816
10000,67,8972.0,5001,25.09,1028,8972
20000,67,17931.0,10001,50.1,2069,17931
40000,67,35880.0,20001,100.09,4120,35880
60000,67,53860.0,30001,150.09,6140,53860
80000,67,71779.0,40001,200.09,8221,71779
100000,67,89654.0,50001,250.09,10346,89654
200000,67,179537.0,100001,500.09,20463,179537
400000,67,359013.0,200001,1000.09,40987,359013
600000,67,538364.0,300001,1500.1,61636,538364
800000,67,718081.0,400001,2000.1,81919,718081
1000000,67,897480.0,500001,2500.1,102520,897480
2,68,2.0,1,0.05,0,2
3,68,2.0,2,0.06,1,2
100,68,81.0,91,4.5,19,81
200,68,162.0,191,9.51,38,162
2000,68,1719.0,1991,99.5,281,1719
10000,68,8479.0,9991,499.51,1521,8479
20000,68,16972.0,19991,999.5,3028,16972
40000,68,33915.0,39991,1999.5,6085,33915
60000,68,50993.0,59991,2999.51,9007,50993
80000,68,68002.0,79991,3999.51,11998,68002
100000,68,84987.0,99991,4999.51,15013,84987
200000,68,170041.0,199991,9999.5,29959,170041
400000,68,340003.0,399991,19999.5,59997,340003
600000,68,509886.0,599991,29999.5,90114,509886
800000,68,679970.0,799991,39999.51,120030,679970
1000000,68,850051.0,999991,49999.51,149949,850051
2,69,2.0,1,0.05,0,2
3,69,3.0,2,0.06,0,3
100,69,93.0,13,0.34,7,93
200,69,187.0,13,0.34,13,187
2000,69,1802.0,13,0.34,198,1802
10000,69,9022.0,13,0.34,978,9022
20000,69,17996.0,13,0.34,2004,17996
40000,69,35905.0,13,0.34,4095,35905
60000,69,53943.0,13,0.34,6057,53943
80000,69,71942.0,13,0.34,8058,71942
100000,69,89896.0,13,0.34,10104,89896
200000,69,179784.0,13,0.34,20216,179784
400000,69,359929.0,13,0.34,40071,359929
600000,69,539771.0,13,0.34,60229,539771
800000,69,719677.0,13,0.34,80323,719677
1000000,69,899608.0,13,0.34,100392,899608
2,70,2.0,1,0.05,0,2
3,70,3.0,2,0.06,0,3
100,70,87.0,93,0.69,13,87
200,70,176.0,193,1.19,24,176
2000,70,1791.0,1993,10.19,209,1791
10000,70,8938.0,9993,50.19,1062,8938
20000,70,17921.0,19993,100.19,2079,17921
40000,70,35867.0,39993,200.19,4133,35867
60000,70,53785.0,59993,300.19,6215,53785
80000,70,71760.0,79993,400.19,8240,71760
100000,70,89633.0,99993,500.19,10367,89633
200000,70,179071.0,199993,1000.19,20929,179071
400000,70,358153.0,399993,2000.19,41847,358153
600000,70,536953.0,599993,3000.19,63047,536953
800000,70,716296.0,799993,4000.19,83704,716296
1000000,70,895304.0,999993,5000.19,104696,895304
2,71,2.0,1,0.05,0,2
3,71,3.0,2,0.06,0,3
100,71,89.0,52,2.38,11,89
200,71,177.0,102,4.87,23,177
2000,71,1737.0,1002,49.87,263,1737
10000,71,8757.0,5002,249.88,1243,8757
20000,71,17536.0,10002,499.88,2464,17536
40000,71,35028.0,20002,999.87,4972,35028
60000,71,52562.0,30002,1499.87,7438,52562
80000,71,70097.0,40002,1999.87,9903,70097
100000,71,87527.0,50002,2499.88,12473,87527
200000,71,174973.0,100002,4999.88,25027,174973
400000,71,349871.0,200002,9999.87,50129,349871
600000,71,524922.0,300002,14999.87,75078,524922
800000,71,699734.0,400002,19999.87,100266,699734
1000000,71,874511.0,500002,24999.87,125489,874511
2,72,2.0,1,0.05,0,2
3,72,3.0,2,0.06,0,3
100,72,88.0,54,0.63,12,88
200,72,181.0,104,0.88,19,181
2000,72,1801.0,1004,5.38,199,1801
10000,72,8955.0,5004,25.38,1045,8955
20000,72,17949.0,10004,50.38,2051,17949
40000,72,35925.0,20004,100.38,4075,35925
60000,72,53849.0,30004,150.38,6151,53849
80000,72,71810.0,40004,200.38,8190,71810
100000,72,89736.0,50004,250.38,10264,89736
200000,72,179394.0,100004,500.38,20606,179394
400000,72,359119.0,200004,1000.38,40881,359119
600000,72,538548.0,300004,1500.38,61452,538548
800000,72,718052.0,400004,2000.38,81948,718052
1000000,72,897498.0,500004,2500.38,102502,897498
2,73,1.0,1,0.05,1,1
3,73,2.0,2,0.06,1,2
100,73,91.0,98,0.54,9,91
200,73,183.0,198,1.04,17,183
2000,73,1797.0,1998,10.04,203,1797
10000,73,8945.0,9998,50.04,1055,8945
20000,73,17878.0,19998,100.03,2122,17878
40000,73,35725.0,39998,200.03,4275,35725
60000,73,53607.0,59998,300.03,6393,53607
80000,73,71558.0,79998,400.03,8442,71558
100000,73,89437.0,99998,500.03,10563,89437
200000,73,178774.0,199998,1000.03,21226,178774
400000,73,357808.0,399998,2000.04,42192,357808
600000,73,536981.0,599998,3000.04,63019,536981
800000,73,715774.0,799998,4000.04,84226,715774
1000000,73,894426.0,999998,5000.04,105574,894426
2,74,1.0,1,0.05,1,1
3,74,2.0,2,0.06,1,2
100,74,90.0,99,2.74,10,90
200,74,174.0,199,5.49,26,174
2000,74,1757.0,1999,54.99,243,1757
10000,74,8748.0,9999,275.0,1252,8748
20000,74,17483.0,19999,550.0,2517,17483
40000,74,34938.0,39999,1099.99,5062,34938
60000,74,52359.0,59999,1650.0,7641,52359
80000,74,69737.0,79999,2200.0,10263,69737
100000,74,87276.0,99999,2750.0,12724,87276
200000,74,174333.0,199999,5500.0,25667,174333
400000,74,348840.0,399999,10999.99,51160,348840
600000,74,523416.0,599999,16499.99,76584,523416
800000,74,697746.0,799999,21999.99,102254,697746
1000000,74,872220.0,999999,27499.99,127780,872220
2,75,1.0,1,0.05,1,1
3,75,1.0,2,0.06,2,1
100,75,85.0,99,4.9,15,85
200,75,176.0,199,9.91,24,176
2000,75,1690.0,1999,99.9,310,1690
10000,75,8467.0,9999,499.91,1533,8467
20000,75,16981.0,19999,999.9,3019,16981
40000,75,34012.0,39999,1999.9,5988,34012
60000,75,51110.0,59999,2999.91,8890,51110
80000,75,68045.0,79999,3999.91,11955,68045
100000,75,84966.0,99999,4999.91,15034,84966
200000,75,169866.0,199999,9999.9,30134,169866
400000,75,339663.0,399999,19999.9,60337,339663
600000,75,509816.0,599999,29999.9,90184,509816
800000,75,679866.0,799999,39999.91,120134,679866
1000000,75,849795.0,999999,49999.91,150205,849795
2,76,2.0,1,0.05,0,2
3,76,3.0,2,0.06,0,3
100,76,88.0,97,2.69,12,88
200,76,174.0,197,5.44,26,174
2000,76,1738.0,1997,54.94,262,1738
10000,76,8728.0,9997,274.94,1272,8728
20000,76,17406.0,19997,549.94,2594,17406
40000,76,34862.0,39997,1099.94,5138,34862
60000,76,52266.0,59997,1649.94,7734,52266
80000,76,69677.0,79997,2199.94,10323,69677
100000,76,87138.0,99997,2749.94,12862,87138
200000,76,174241.0,199997,5499.94,25759,174241
400000,76,348748.0,399997,10999.94,51252,348748
600000,76,523283.0,599997,16499.94,76717,523283
800000,76,697701.0,799997,21999.94,102299,697701
1000000,76,872509.0,999997,27499.94,127491,872509
2,77,1.0,1,0.05,1,1
3,77,2.0,2,0.06,1,2
100,77,88.0,99,4.77,12,88
200,77,172.0,199,9.77,28,172
2000,77,1704.0,1999,99.77,296,1704
10000,77,8547.0,9999,499.77,1453,8547
20000,77,17006.0,19999,999.77,2994,17006
40000,77,33880.0,39999,1999.77,6120,33880
60000,77,50840.0,59999,2999.77,9160,50840
80000,77,67801.0,79999,3999.77,12199,67801
100000,77,84811.0,99999,4999.77,15189,84811
200000,77,169978.0,199999,9999.77,30022,169978
400000,77,339891.0,399999,19999.77,60109,339891
600000,77,509774.0,599999,29999.77,90226,509774
800000,77,679521.0,799999,39999.77,120479,679521
1000000,77,849262.0,999999,49999.77,150738,849262
2,78,1.0,1,0.05,1,1
3,78,2.0,2,0.06,1,2
100,78,89.0,99,0.68,11,89
200,78,181.0,199,1.17,19,181
2000,78,1802.0,1999,10.18,198,1802
10000,78,8969.0,9999,50.18,1031,8969
20000,78,17934.0,19999,100.17,2066,17934
40000,78,35903.0,39999,200.17,4097,35903
60000,78,53840.0,59999,300.17,6160,53840
80000,78,71731.0,79999,400.17,8269,71731
100000,78,89627.0,99999,500.17,10373,89627
200000,78,179184.0,199999,1000.17,20816,179184
400000,78,358094.0,399999,2000.18,41906,358094
600000,78,537170.0,599999,3000.18,62830,537170
800000,78,716201.0,799999,4000.18,83799,716201
1000000,78,895217.0,999999,5000.18,104783,895217
2,79,2.0,1,0.05,0,2
3,79,3.0,2,0.06,0,3
100,79,93.0,53,0.54,7,93
200,79,184.0,103,0.79,16,184
2000,79,1804.0,1003,5.28,196,1804
10000,79,8966.0,5003,25.28,1034,8966
20000,79,17990.0,10003,50.29,2010,17990
40000,79,35880.0,20003,100.28,4120,35880
60000,79,53908.0,30003,150.28,6092,53908
80000,79,71893.0,40003,200.28,8107,71893
100000,79,89890.0,50003,250.28,10110,89890
200000,79,179587.0,100003,500.28,20413,179587
400000,79,358980.0,200003,1000.28,41020,358980
600000,79,538594.0,300003,1500.29,61406,538594
800000,79,718210.0,400003,2000.29,81790,718210
1000000,79,897642.0,500003,2500.29,102358,897642
2,80,2.0,1,0.05,0,2
3,80,3.0,2,0.06,0,3
100,80,87.0,97,4.71,13,87
200,80,170.0,197,9.72,30,170
2000,80,1710.0,1997,99.71,290,1710
10000,80,8525.0,9997,499.72,1475,8525
20000,80,17018.0,19997,999.71,2982,17018
40000,80,33968.0,39997,1999.71,6032,33968
60000,80,50904.0,59997,2999.72,9096,50904
80000,80,67971.0,79997,3999.72,12029,67971
100000,80,85048.0,99997,4999.72,14952,85048
200000,80,170175.0,199997,9999.71,29825,170175
400000,80,340323.0,399997,19999.71,59677,340323
600000,80,510274.0,599997,29999.71,89726,510274
800000,80,680216.0,799997,39999.72,119784,680216
1000000,80,850422.0,999997,49999.72,149578,850422
2,81,2.0,1,0.05,0,2
3,81,3.0,2,0.06,0,3
100,81,89.0,98,0.85,11,89
200,81,176.0,198,1.35,24,176
2000,81,1788.0,1998,10.35,212,1788
10000,81,8940.0,9998,50.35,1060,8940
20000,81,17879.0,19998,100.35,2121,17879
40000,81,35724.0,39998,200.35,4276,35724
60000,81,53625.0,59998,300.35,6375,53625
80000,81,71466.0,79998,400.35,8534,71466
100000,81,89377.0,99998,500.35,10623,89377
200000,81,178947.0,199998,1000.35,21053,178947
400000,81,358093.0,399998,2000.35,41907,358093
600000,81,536958.0,599998,3000.35,63042,536958
800000,81,716102.0,799998,4000.35,83898,716102
1000000,81,895225.0,999998,5000.35,104775,895225
2,82,1.0,1,0.05,1,1
3,82,2.0,2,0.06,1,2
100,82,88.0,99,0.9,12,88
200,82,175.0,199,1.4,25,175
2000,82,1767.0,1999,10.4,233,1767
10000,82,8960.0,9999,50.4,1040,8960
20000,82,17929.0,19999,100.4,2071,17929
40000,82,35840.0,39999,200.4,4160,35840
60000,82,53793.0,59999,300.4,6207,53793
80000,82,71718.0,79999,400.4,8282,71718
100000,82,89654.0,99999,500.4,10346,89654
200000,82,179311.0,199999,1000.4,20689,179311
400000,82,358401.0,399999,2000.4,41599,358401
600000,82,537351.0,599999,3000.4,62649,537351
800000,82,716423.0,799999,4000.4,83577,716423
1000000,82,895650.0,999999,5000.4,104350,895650
2,83,2.0,1,0.05,0,2
3,83,2.0,2,0.06,1,2
100,83,89.0,5,0.21,11,89
200,83,179.0,5,0.21,21,179
2000,83,1804.0,5,0.21,196,1804
10000,83,8976.0,5,0.21,1024,8976
20000,83,17962.0,5,0.21,2038,17962
40000,83,36035.0,5,0.21,3965,36035
60000,83,54085.0,5,0.21,5915,54085
80000,83,72137.0,5,0.21,7863,72137
100000,83,90172.0,5,0.21,9828,90172
200000,83,180340.0,5,0.21,19660,180340
400000,83,360229.0,5,0.21,39771,360229
600000,83,540422.0,5,0.21,59578,540422
800000,83,720548.0,5,0.21,79452,720548
1000000,83,900720.0,5,0.21,99280,900720
2,84,1.0,1,0.05,1,1
3,84,2.0,2,0.06,1,2
100,84,85.0,99,2.74,15,85
200,84,173.0,199,5.49,27,173
2000,84,1742.0,1999,54.99,258,1742
10000,84,8718.0,9999,275.0,1282,8718
20000,84,17467.0,19999,550.0,2533,17467
40000,84,34967.0,39999,1099.99,5033,34967
60000,84,52409.0,59999,1650.0,7591,52409
80000,84,69823.0,79999,2200.0,10177,69823
100000,84,87291.0,99999,2750.0,12709,87291
200000,84,174575.0,199999,5500.0,25425,174575
400000,84,349304.0,399999,10999.99,50696,349304
600000,84,523726.0,599999,16499.99,76274,523726
800000,84,698150.0,799999,21999.99,101850,698150
1000000,84,872854.0,999999,27499.99,127146,872854
2,85,2.0,1,0.05,0,2
3,85,3.0,2,0.06,0,3
100,85,91.0,96,0.57,9,91
200,85,178.0,196,1.07,22,178
2000,85,1786.0,1996,10.07,214,1786
10000,85,8901.0,9996,50.07,1099,8901
20000,85,17888.0,19996,100.07,2112,17888
40000,85,35701.0,39996,200.07,4299,35701
60000,85,53553.0,59996,300.07,6447,53553
80000,85,71376.0,79996,400.07,8624,71376
100000,85,89300.0,99996,500.07,10700,89300
200000,85,178720.0,199996,1000.07,21280,178720
400000,85,357605.0,399996,2000.07,42395,357605
600000,85,536815.0,599996,3000.07,63185,536815
800000,85,715947.0,799996,4000.07,84053,715947
1000000,85,894695.0,999996,5000.07,105305,894695
2,86,2.0,1,0.05,0,2
3,86,3.0,2,0.06,0,3
100,86,92.0,98,0.63,8,92
200,86,185.0,198,1.12,15,185
2000,86,1776.0,1998,10.13,224,1776
10000,86,8876.0,9998,50.13,1124,8876
20000,86,17804.0,19998,100.12,2196,17804
40000,86,35728.0,39998,200.12,4272,35728
60000,86,53586.0,59998,300.12,6414,53586
80000,86,71429.0,79998,400.12,8571,71429
100000,86,89398.0,99998,500.12,10602,89398
200000,86,178899.0,199998,1000.12,21101,178899
400000,86,357943.0,399998,2000.13,42057,357943
600000,86,536968.0,599998,3000.13,63032,536968
800000,86,715923.0,799998,4000.13,84077,715923
1000000,86,894896.0,999998,5000.13,105104,894896
2,87,2.0,1,0.05,0,2
3,87,3.0,2,0.06,0,3
100,87,84.0,98,4.81,16,84
200,87,171.0,198,9.81,29,171
2000,87,1721.0,1998,99.81,279,1721
10000,87,8531.0,9998,499.81,1469,8531
20000,87,17011.0,19998,999.81,2989,17011
40000,87,33935.0,39998,1999.81,6065,33935
60000,87,50987.0,59998,2999.81,9013,50987
80000,87,68085.0,79998,3999.81,11915,68085
100000,87,85020.0,99998,4999.81,14980,85020
200000,87,170178.0,199998,9999.81,29822,170178
400000,87,340099.0,399998,19999.81,59901,340099
600000,87,510035.0,599998,29999.81,89965,510035
800000,87,680047.0,799998,39999.81,119953,680047
1000000,87,850070.0,999998,49999.81,149930,850070
2,88,2.0,1,0.05,0,2
3,88,3.0,2,0.06,0,3
100,88,87.0,98,2.7,13,87
200,88,174.0,198,5.44,26,174
2000,88,1724.0,1998,54.94,276,1724
10000,88,8689.0,9998,274.95,1311,8689
20000,88,17424.0,19998,549.95,2576,17424
40000,88,34856.0,39998,1099.94,5144,34856
60000,88,52389.0,59998,1649.95,7611,52389
80000,88,69907.0,79998,2199.95,10093,69907
100000,88,87337.0,99998,2749.95,12663,87337
200000,88,174595.0,199998,5499.95,25405,174595
400000,88,348998.0,399998,10999.94,51002,348998
600000,88,523339.0,599998,16499.94,76661,523339
800000,88,697862.0,799998,21999.94,102138,697862
1000000,88,872462.0,999998,27499.94,127538,872462
2,89,2.0,1,0.05,0,2
3,89,3.0,2,0.06,0,3
100,89,90.0,10,0.14,10,90
200,89,183.0,10,0.14,17,183
2000,89,1789.0,10,0.14,211,1789
10000,89,8997.0,10,0.14,1003,8997
20000,89,17957.0,10,0.14,2043,17957
40000,89,35994.0,10,0.14,4006,35994
60000,89,54020.0,10,0.14,5980,54020
80000,89,71958.0,10,0.14,8042,71958
100000,89,89922.0,10,0.14,10078,89922
200000,89,179984.0,10,0.14,20016,179984
400000,89,359985.0,10,0.14,40015,359985
600000,89,539983.0,10,0.14,60017,539983
800000,89,719983.0,10,0.14,80017,719983
1000000,89,900179.0,10,0.14,99821,900179
2,90,2.0,1,0.05,0,2
3,90,3.0,2,0.06,0,3
100,90,91.0,12,0.42,9,91
200,90,179.0,12,0.42,21,179
2000,90,1820.0,12,0.42,180,1820
10000,90,9017.0,12,0.42,983,9017
20000,90,18049.0,12,0.42,1951,18049
40000,90,36019.0,12,0.42,3981,36019
60000,90,53974.0,12,0.42,6026,53974
80000,90,71997.0,12,0.42,8003,71997
100000,90,90033.0,12,0.42,9967,90033
200000,90,180246.0,12,0.42,19754,180246
400000,90,360343.0,12,0.42,39657,360343
600000,90,540319.0,12,0.42,59681,540319
800000,90,720263.0,12,0.42,79737,720263
1000000,90,900541.0,12,0.42,99459,900541
2,91,1.0,1,0.05,1,1
3,91,2.0,2,0.06,1,2
100,91,88.0,7,0.08,12,88
200,91,179.0,7,0.08,21,179
2000,91,1780.0,7,0.08,220,1780
10000,91,8991.0,7,0.08,1009,8991
20000,91,17970.0,7,0.08,2030,17970
40000,91,35971.0,7,0.08,4029,35971
60000,91,54032.0,7,0.08,5968,54032
80000,91,72024.0,7,0.08,7976,72024
100000,91,90119.0,7,0.08,9881,90119
200000,91,180145.0,7,0.08,19855,180145
400000,91,360060.0,7,0.08,39940,360060
600000,91,540069.0,7,0.08,59931,540069
800000,91,720055.0,7,0.08,79945,720055
1000000,91,900146.0,7,0.08,99854,900146
2,92,2.0,1,0.05,0,2
3,92,3.0,2,0.06,0,3
100,92,89.0,97,2.69,11,89
200,92,175.0,197,5.44,25,175
2000,92,1721.0,1997,54.94,279,1721
10000,92,8674.0,9997,274.94,1326,8674
20000,92,17431.0,19997,549.94,2569,17431
40000,92,34787.0,39997,1099.94,5213,34787
60000,92,52351.0,59997,1649.94,7649,52351
80000,92,69820.0,79997,2199.94,10180,69820
100000,92,87188.0,99997,2749.94,12812,87188
200000,92,174669.0,199997,5499.94,25331,174669
400000,92,349231.0,399997,10999.94,50769,349231
600000,92,523749.0,599997,16499.94,76251,523749
800000,92,698320.0,799997,21999.94,101680,698320
1000000,92,872992.0,999997,27499.94,127008,872992
2,93,2.0,1,0.05,0,2
3,93,3.0,2,0.06,0,3
100,93,90.0,5,0.12,10,90
200,93,177.0,5,0.12,23,177
2000,93,1808.0,5,0.12,192,1808
10000,93,9036.0,5,0.12,964,9036
20000,93,17944.0,5,0.12,2056,17944
40000,93,35988.0,5,0.12,4012,35988
60000,93,54040.0,5,0.12,5960,54040
80000,93,72011.0,5,0.12,7989,72011
100000,93,90106.0,5,0.12,9894,90106
200000,93,180057.0,5,0.12,19943,180057
400000,93,359822.0,5,0.12,40178,359822
600000,93,539752.0,5,0.12,60248,539752
800000,93,719776.0,5,0.12,80224,719776
1000000,93,899832.0,5,0.12,100168,899832
2,94,2.0,1,0.05,0,2
3,94,3.0,2,0.06,0,3
100,94,87.0,9,0.18,13,87
200,94,180.0,9,0.18,20,180
2000,94,1787.0,9,0.18,213,1787
10000,94,9005.0,9,0.18,995,9005
20000,94,18060.0,9,0.18,1940,18060
40000,94,36049.0,9,0.18,3951,36049
60000,94,54080.0,9,0.18,5920,54080
80000,94,72170.0,9,0.18,7830,72170
100000,94,90206.0,9,0.18,9794,90206
200000,94,180165.0,9,0.18,19835,180165
400000,94,360270.0,9,0.18,39730,360270
600000,94,540290.0,9,0.18,59710,540290
800000,94,720378.0,9,0.18,79622,720378
1000000,94,900450.0,9,0.18,99550,900450
2,95,2.0,1,0.05,0,2
3,95,3.0,2,0.06,0,3
100,95,96.0,51,0.35,4,96
200,95,181.0,101,0.6,19,181
2000,95,1800.0,1001,5.09,200,1800
10000,95,9003.0,5001,25.09,997,9003
20000,95,18010.0,10001,50.1,1990,18010
40000,95,35976.0,20001,100.09,4024,35976
60000,95,53938.0,30001,150.09,6062,53938
80000,95,71871.0,40001,200.09,8129,71871
100000,95,89794.0,50001,250.09,10206,89794
200000,95,179690.0,100001,500.09,20310,179690
400000,95,359132.0,200001,1000.09,40868,359132
600000,95,538327.0,300001,1500.1,61673,538327
800000,95,717857.0,400001,2000.1,82143,717857
1000000,95,897244.0,500001,2500.1,102756,897244
2,96,2.0,1,0.05,0,2
3,96,3.0,2,0.06,0,3
100,96,94.0,9,0.23,6,94
200,96,184.0,9,0.23,16,184
2000,96,1812.0,9,0.23,188,1812
10000,96,9004.0,9,0.23,996,9004
20000,96,18012.0,9,0.23,1988,18012
40000,96,35933.0,9,0.23,4067,35933
60000,96,53894.0,9,0.23,6106,53894
80000,96,71921.0,9,0.23,8079,71921
100000,96,89947.0,9,0.23,10053,89947
200000,96,179837.0,9,0.23,20163,179837
400000,96,359813.0,9,0.23,40187,359813
600000,96,539685.0,9,0.23,60315,539685
800000,96,719495.0,9,0.23,80505,719495
1000000,96,899462.0,9,0.23,100538,899462
2,97,2.0,1,0.05,0,2
3,97,3.0,2,0.06,0,3
100,97,83.0,98,2.7,17,83
200,97,169.0,198,5.44,31,169
2000,97,1744.0,1998,54.94,256,1744
10000,97,8738.0,9998,274.95,1262,8738
20000,97,17471.0,19998,549.95,2529,17471
40000,97,34884.0,39998,1099.94,5116,34884
60000,97,52373.0,59998,1649.95,7627,52373
80000,97,69787.0,79998,2199.95,10213,69787
100000,97,87262.0,99998,2749.95,12738,87262
200000,97,174568.0,199998,5499.95,25432,174568
400000,97,349477.0,399998,10999.94,50523,349477
600000,97,523981.0,599998,16499.94,76019,523981
800000,97,698246.0,799998,21999.94,101754,698246
1000000,97,872587.0,999998,27499.94,127413,872587
2,98,1.0,1,0.05,1,1
3,98,2.0,2,0.06,1,2
100,98,92.0,96,0.53,8,92
200,98,179.0,196,1.03,21,179
2000,98,1798.0,1996,10.03,202,1798
10000,98,8932.0,9996,50.03,1068,8932
20000,98,17891.0,19996,100.02,2109,17891
40000,98,35837.0,39996,200.02,4163,35837
60000,98,53770.0,59996,300.02,6230,53770
80000,98,71605.0,79996,400.02,8395,71605
100000,98,89467.0,99996,500.02,10533,89467
200000,98,179007.0,199996,1000.02,20993,179007
400000,98,357975.0,399996,2000.03,42025,357975
600000,98,537088.0,599996,3000.03,62912,537088
800000,98,716123.0,799996,4000.03,83877,716123
1000000,98,894899.0,999996,5000.03,105101,894899
2,99,2.0,1,0.05,0,2
3,99,3.0,2,0.06,0,3
100,99,92.0,7,0.17,8,92
200,99,183.0,7,0.17,17,183
2000,99,1787.0,7,0.17,213,1787
10000,99,8984.0,7,0.17,1016,8984
20000,99,17974.0,7,0.17,2026,17974
40000,99,35924.0,7,0.17,4076,35924
60000,99,53893.0,7,0.17,6107,53893
80000,99,71960.0,7,0.17,8040,71960
100000,99,89991.0,7,0.17,10009,89991
200000,99,180201.0,7,0.17,19799,180201
400000,99,360169.0,7,0.17,39831,360169
600000,99,540085.0,7,0.17,59915,540085
800000,99,720176.0,7,0.17,79824,720176
1000000,99,899944.0,7,0.17,100056,899944
2,100,2.0,1,0.05,0,2
3,100,3.0,2,0.06,0,3
100,100,89.0,51,0.35,11,89
200,100,175.0,101,0.6,25,175
2000,100,1816.0,1001,5.09,184,1816
10000,100,9003.0,5001,25.09,997,9003
20000,100,17978.0,10001,50.1,2022,17978
40000,100,35945.0,20001,100.09,4055,35945
60000,100,53915.0,30001,150.09,6085,53915
80000,100,71836.0,40001,200.09,8164,71836
100000,100,89818.0,50001,250.09,10182,89818
200000,100,179529.0,100001,500.09,20471,179529
400000,100,359138.0,200001,1000.09,40862,359138
600000,100,538561.0,300001,1500.1,61439,538561
800000,100,718013.0,400001,2000.1,81987,718013
1000000,100,897620.0,500001,2500.1,102380,897620
