Timestep,Iteration,Total Reward,Suboptimal Arms,Total Regret,Zeros Count,Ones Count
2,1,1.0,0,0.0,1,1
3,1,2.0,0,0.0,1,2
100,1,88.0,0,0.0,12,88
200,1,175.0,0,0.0,25,175
2000,1,1675.0,8,0.4,325,1675
10000,1,8462.0,85,4.25,1538,8462
20000,1,17016.0,151,7.55,2984,17016
40000,1,34020.0,263,13.15,5980,34020
60000,1,50888.0,453,22.65,9112,50888
80000,1,67905.0,605,30.25,12095,67905
100000,1,84888.0,735,36.75,15112,84888
200000,1,169655.0,1434,71.7,30345,169655
400000,1,339657.0,2774,138.7,60343,339657
600000,1,509788.0,4057,202.85,90212,509788
800000,1,679681.0,5339,266.95,120319,679681
1000000,1,849459.0,6639,331.95,150541,849459
2,2,1.0,0,0.0,1,1
3,2,1.0,0,0.0,2,1
100,2,86.0,0,0.0,14,86
200,2,175.0,0,0.0,25,175
2000,2,1711.0,10,0.5,289,1711
10000,2,8528.0,56,2.8,1472,8528
20000,2,16977.0,121,6.05,3023,16977
40000,2,34040.0,251,12.55,5960,34040
60000,2,51030.0,372,18.6,8970,51030
80000,2,67976.0,501,25.05,12024,67976
100000,2,85046.0,630,31.5,14954,85046
200000,2,170074.0,1263,63.15,29926,170074
400000,2,340027.0,2645,132.25,59973,340027
600000,2,509820.0,4041,202.05,90180,509820
800000,2,679823.0,5378,268.9,120177,679823
1000000,2,849420.0,6647,332.35,150580,849420
2,3,2.0,0,0.0,0,2
3,3,3.0,0,0.0,0,3
100,3,82.0,8,0.4,18,82
200,3,161.0,12,0.6,39,161
2000,3,1710.0,20,1.0,290,1710
10000,3,8528.0,79,3.95,1472,8528
20000,3,16980.0,163,8.15,3020,16980
40000,3,33963.0,307,15.35,6037,33963
60000,3,51032.0,483,24.15,8968,51032
80000,3,67974.0,623,31.15,12026,67974
100000,3,85030.0,754,37.7,14970,85030
200000,3,170050.0,1432,71.6,29950,170050
400000,3,340383.0,2748,137.4,59617,340383
600000,3,510342.0,4076,203.8,89658,510342
800000,3,680357.0,5427,271.35,119643,680357
1000000,3,850120.0,6740,337.0,149880,850120
2,4,2.0,0,0.0,0,2
3,4,2.0,0,0.0,1,2
100,4,90.0,0,0.0,10,90
200,4,178.0,0,0.0,22,178
2000,4,1698.0,128,6.4,302,1698
10000,4,8522.0,520,26.0,1478,8522
20000,4,17140.0,569,28.45,2860,17140
40000,4,34170.0,698,34.9,5830,34170
60000,4,51140.0,833,41.65,8860,51140
80000,4,68099.0,946,47.3,11901,68099
100000,4,85081.0,1070,53.5,14919,85081
200000,4,169884.0,1813,90.65,30116,169884
400000,4,339550.0,3158,157.9,60450,339550
600000,4,509557.0,4521,226.05,90443,509557
800000,4,679465.0,5932,296.6,120535,679465
1000000,4,849546.0,7273,363.65,150454,849546
2,5,2.0,0,0.0,0,2
3,5,3.0,0,0.0,0,3
100,5,79.0,0,0.0,21,79
200,5,161.0,0,0.0,39,161
2000,5,1680.0,5,0.25,320,1680
10000,5,8443.0,66,3.3,1557,8443
20000,5,16948.0,142,7.1,3052,16948
40000,5,34024.0,278,13.9,5976,34024
60000,5,51032.0,406,20.3,8968,51032
80000,5,67998.0,538,26.9,12002,67998
100000,5,85023.0,667,33.35,14977,85023
200000,5,169902.0,1345,67.25,30098,169902
400000,5,339862.0,2638,131.9,60138,339862
600000,5,509730.0,3912,195.6,90270,509730
800000,5,679685.0,5241,262.05,120315,679685
1000000,5,849357.0,6568,328.4,150643,849357
2,6,2.0,0,0.0,0,2
3,6,3.0,0,0.0,0,3
100,6,86.0,0,0.0,14,86
200,6,172.0,0,0.0,28,172
2000,6,1696.0,27,1.35,304,1696
10000,6,8461.0,96,4.8,1539,8461
20000,6,16916.0,169,8.45,3084,16916
40000,6,34032.0,287,14.35,5968,34032
60000,6,51139.0,435,21.75,8861,51139
80000,6,68051.0,565,28.25,11949,68051
100000,6,85024.0,712,35.6,14976,85024
200000,6,170104.0,1367,68.35,29896,170104
400000,6,339845.0,2662,133.1,60155,339845
600000,6,509617.0,4011,200.55,90383,509617
800000,6,679483.0,5288,264.4,120517,679483
1000000,6,849487.0,6649,332.45,150513,849487
2,7,2.0,0,0.0,0,2
3,7,2.0,0,0.0,1,2
100,7,84.0,1,0.05,16,84
200,7,169.0,1,0.05,31,169
2000,7,1710.0,20,1.0,290,1710
10000,7,8510.0,70,3.5,1490,8510
20000,7,17033.0,132,6.6,2967,17033
40000,7,33980.0,285,14.25,6020,33980
60000,7,50961.0,433,21.65,9039,50961
80000,7,67906.0,561,28.05,12094,67906
100000,7,84843.0,700,35.0,15157,84843
200000,7,169901.0,1365,68.25,30099,169901
400000,7,340009.0,2645,132.25,59991,340009
600000,7,509848.0,4002,200.1,90152,509848
800000,7,679858.0,5269,263.45,120142,679858
1000000,7,849561.0,6660,333.0,150439,849561
2,8,2.0,0,0.0,0,2
3,8,3.0,0,0.0,0,3
100,8,80.0,0,0.0,20,80
200,8,166.0,10,0.5,34,166
2000,8,1684.0,26,1.3,316,1684
10000,8,8445.0,79,3.95,1555,8445
20000,8,16985.0,159,7.95,3015,16985
40000,8,33949.0,290,14.5,6051,33949
60000,8,50912.0,416,20.8,9088,50912
80000,8,67958.0,548,27.4,12042,67958
100000,8,84908.0,700,35.0,15092,84908
200000,8,169858.0,1314,65.7,30142,169858
400000,8,339937.0,2583,129.15,60063,339937
600000,8,509946.0,3891,194.55,90054,509946
800000,8,679809.0,5319,265.95,120191,679809
1000000,8,849828.0,6663,333.15,150172,849828
2,9,2.0,0,0.0,0,2
3,9,2.0,0,0.0,1,2
100,9,85.0,5,0.25,15,85
200,9,170.0,8,0.4,30,170
2000,9,1686.0,24,1.2,314,1686
10000,9,8497.0,83,4.15,1503,8497
20000,9,16937.0,152,7.6,3063,16937
40000,9,33946.0,286,14.3,6054,33946
60000,9,50868.0,422,21.1,9132,50868
80000,9,67781.0,569,28.45,12219,67781
100000,9,84748.0,712,35.6,15252,84748
200000,9,169715.0,1394,69.7,30285,169715
400000,9,339902.0,2756,137.8,60098,339902
600000,9,509940.0,4113,205.65,90060,509940
800000,9,679778.0,5415,270.75,120222,679778
1000000,9,849693.0,6733,336.65,150307,849693
2,10,1.0,0,0.0,1,1
3,10,2.0,0,0.0,1,2
100,10,86.0,10,0.5,14,86
200,10,176.0,33,1.65,24,176
2000,10,1704.0,37,1.85,296,1704
10000,10,8493.0,94,4.7,1507,8493
20000,10,16962.0,146,7.3,3038,16962
40000,10,33922.0,284,14.2,6078,33922
60000,10,50885.0,408,20.4,9115,50885
80000,10,67817.0,549,27.45,12183,67817
100000,10,84832.0,683,34.15,15168,84832
200000,10,169675.0,1370,68.5,30325,169675
400000,10,339729.0,2665,133.25,60271,339729
600000,10,509668.0,3992,199.6,90332,509668
800000,10,679407.0,5359,267.95,120593,679407
1000000,10,849502.0,6707,335.35,150498,849502
2,11,2.0,0,0.0,0,2
3,11,3.0,0,0.0,0,3
100,11,77.0,0,0.0,23,77
200,11,162.0,1,0.05,38,162
2000,11,1682.0,16,0.8,318,1682
10000,11,8472.0,136,6.8,1528,8472
20000,11,16965.0,210,10.5,3035,16965
40000,11,34032.0,341,17.05,5968,34032
60000,11,50996.0,468,23.4,9004,50996
80000,11,67966.0,591,29.55,12034,67966
100000,11,85035.0,724,36.2,14965,85035
200000,11,169989.0,1393,69.65,30011,169989
400000,11,339871.0,2766,138.3,60129,339871
600000,11,509861.0,4110,205.5,90139,509861
800000,11,679757.0,5437,271.85,120243,679757
1000000,11,849878.0,6757,337.85,150122,849878
2,12,1.0,0,0.0,1,1
3,12,2.0,0,0.0,1,2
100,12,82.0,1,0.05,18,82
200,12,167.0,1,0.05,33,167
2000,12,1688.0,32,1.6,312,1688
10000,12,8432.0,110,5.5,1568,8432
20000,12,16897.0,181,9.05,3103,16897
40000,12,33848.0,309,15.45,6152,33848
60000,12,50842.0,442,22.1,9158,50842
80000,12,67838.0,593,29.65,12162,67838
100000,12,84853.0,723,36.15,15147,84853
200000,12,169964.0,1367,68.35,30036,169964
400000,12,340109.0,2627,131.35,59891,340109
600000,12,509964.0,4002,200.1,90036,509964
800000,12,680126.0,5367,268.35,119874,680126
1000000,12,850073.0,6733,336.65,149927,850073
2,13,2.0,0,0.0,0,2
3,13,3.0,0,0.0,0,3
100,13,80.0,0,0.0,20,80
200,13,159.0,7,0.35,41,159
2000,13,1688.0,24,1.2,312,1688
10000,13,8467.0,108,5.4,1533,8467
20000,13,16937.0,177,8.85,3063,16937
40000,13,33886.0,316,15.8,6114,33886
60000,13,50906.0,452,22.6,9094,50906
80000,13,67875.0,594,29.7,12125,67875
100000,13,84906.0,740,37.0,15094,84906
200000,13,169840.0,1402,70.1,30160,169840
400000,13,339583.0,2736,136.8,60417,339583
600000,13,509486.0,4094,204.7,90514,509486
800000,13,679565.0,5429,271.45,120435,679565
1000000,13,849596.0,6768,338.4,150404,849596
2,14,2.0,0,0.0,0,2
3,14,3.0,0,0.0,0,3
100,14,83.0,1,0.05,17,83
200,14,169.0,1,0.05,31,169
2000,14,1702.0,11,0.55,298,1702
10000,14,8475.0,94,4.7,1525,8475
20000,14,16967.0,146,7.3,3033,16967
40000,14,33966.0,270,13.5,6034,33966
60000,14,50911.0,414,20.7,9089,50911
80000,14,67966.0,561,28.05,12034,67966
100000,14,85024.0,701,35.05,14976,85024
200000,14,170086.0,1366,68.3,29914,170086
400000,14,339727.0,2711,135.55,60273,339727
600000,14,509709.0,4006,200.3,90291,509709
800000,14,680085.0,5302,265.1,119915,680085
1000000,14,850103.0,6625,331.25,149897,850103
2,15,1.0,0,0.0,1,1
3,15,2.0,0,0.0,1,2
100,15,88.0,2,0.1,12,88
200,15,175.0,2,0.1,25,175
2000,15,1695.0,75,3.75,305,1695
10000,15,8447.0,171,8.55,1553,8447
20000,15,16929.0,241,12.05,3071,16929
40000,15,33816.0,405,20.25,6184,33816
60000,15,50912.0,552,27.6,9088,50912
80000,15,67907.0,702,35.1,12093,67907
100000,15,84967.0,841,42.05,15033,84967
200000,15,169966.0,1499,74.95,30034,169966
400000,15,339819.0,2855,142.75,60181,339819
600000,15,510015.0,4170,208.5,89985,510015
800000,15,680089.0,5521,276.05,119911,680089
1000000,15,849939.0,6903,345.15,150061,849939
2,16,1.0,0,0.0,1,1
3,16,2.0,0,0.0,1,2
100,16,88.0,0,0.0,12,88
200,16,178.0,0,0.0,22,178
2000,16,1691.0,21,1.05,309,1691
10000,16,8452.0,115,5.75,1548,8452
20000,16,16961.0,188,9.4,3039,16961
40000,16,34000.0,305,15.25,6000,34000
60000,16,51006.0,478,23.9,8994,51006
80000,16,67974.0,623,31.15,12026,67974
100000,16,84967.0,748,37.4,15033,84967
200000,16,169880.0,1419,70.95,30120,169880
400000,16,340082.0,2731,136.55,59918,340082
600000,16,509817.0,4035,201.75,90183,509817
800000,16,679566.0,5428,271.4,120434,679566
1000000,16,849741.0,6851,342.55,150259,849741
2,17,2.0,0,0.0,0,2
3,17,3.0,0,0.0,0,3
100,17,88.0,0,0.0,12,88
200,17,168.0,2,0.1,32,168
2000,17,1692.0,35,1.75,308,1692
10000,17,8484.0,80,4.0,1516,8484
20000,17,16961.0,145,7.25,3039,16961
40000,17,33998.0,271,13.55,6002,33998
60000,17,50929.0,411,20.55,9071,50929
80000,17,67971.0,542,27.1,12029,67971
100000,17,84947.0,645,32.25,15053,84947
200000,17,169722.0,1262,63.1,30278,169722
400000,17,339779.0,2524,126.2,60221,339779
600000,17,509623.0,3874,193.7,90377,509623
800000,17,679402.0,5257,262.85,120598,679402
1000000,17,849343.0,6562,328.1,150657,849343
2,18,2.0,0,0.0,0,2
3,18,3.0,0,0.0,0,3
100,18,86.0,2,0.1,14,86
200,18,171.0,6,0.3,29,171
2000,18,1704.0,19,0.95,296,1704
10000,18,8460.0,166,8.3,1540,8460
20000,18,17023.0,226,11.3,2977,17023
40000,18,34092.0,349,17.45,5908,34092
60000,18,51117.0,488,24.4,8883,51117
80000,18,68129.0,610,30.5,11871,68129
100000,18,85140.0,744,37.2,14860,85140
200000,18,170174.0,1457,72.85,29826,170174
400000,18,339933.0,2741,137.05,60067,339933
600000,18,510148.0,4085,204.25,89852,510148
800000,18,680236.0,5459,272.95,119764,680236
1000000,18,850245.0,6851,342.55,149755,850245
2,19,1.0,0,0.0,1,1
3,19,2.0,0,0.0,1,2
100,19,84.0,0,0.0,16,84
200,19,168.0,3,0.15,32,168
2000,19,1663.0,18,0.9,337,1663
10000,19,8447.0,74,3.7,1553,8447
20000,19,16947.0,139,6.95,3053,16947
40000,19,33936.0,272,13.6,6064,33936
60000,19,50967.0,394,19.7,9033,50967
80000,19,68032.0,530,26.5,11968,68032
100000,19,84948.0,674,33.7,15052,84948
200000,19,169968.0,1363,68.15,30032,169968
400000,19,339669.0,2710,135.5,60331,339669
600000,19,509575.0,4036,201.8,90425,509575
800000,19,679564.0,5425,271.25,120436,679564
1000000,19,849638.0,6708,335.4,150362,849638
2,20,2.0,0,0.0,0,2
3,20,3.0,0,0.0,0,3
100,20,83.0,2,0.1,17,83
200,20,165.0,5,0.25,35,165
2000,20,1711.0,17,0.85,289,1711
10000,20,8528.0,64,3.2,1472,8528
20000,20,16989.0,144,7.2,3011,16989
40000,20,33961.0,303,15.15,6039,33961
60000,20,50882.0,415,20.75,9118,50882
80000,20,67982.0,542,27.1,12018,67982
100000,20,84892.0,677,33.85,15108,84892
200000,20,169858.0,1329,66.45,30142,169858
400000,20,339850.0,2704,135.2,60150,339850
600000,20,509857.0,4002,200.1,90143,509857
800000,20,679385.0,5370,268.5,120615,679385
1000000,20,849148.0,6656,332.8,150852,849148
2,21,2.0,0,0.0,0,2
3,21,3.0,0,0.0,0,3
100,21,90.0,0,0.0,10,90
200,21,179.0,37,1.85,21,179
2000,21,1692.0,79,3.95,308,1692
10000,21,8516.0,130,6.5,1484,8516
20000,21,17021.0,189,9.45,2979,17021
40000,21,34031.0,321,16.05,5969,34031
60000,21,51032.0,447,22.35,8968,51032
80000,21,68124.0,576,28.8,11876,68124
100000,21,85059.0,700,35.0,14941,85059
200000,21,170072.0,1365,68.25,29928,170072
400000,21,340367.0,2712,135.6,59633,340367
600000,21,510705.0,4059,202.95,89295,510705
800000,21,680480.0,5353,267.65,119520,680480
1000000,21,850502.0,6692,334.6,149498,850502
2,22,1.0,0,0.0,1,1
3,22,2.0,0,0.0,1,2
100,22,88.0,0,0.0,12,88
200,22,167.0,0,0.0,33,167
2000,22,1723.0,12,0.6,277,1723
10000,22,8600.0,68,3.4,1400,8600
20000,22,17160.0,144,7.2,2840,17160
40000,22,34155.0,264,13.2,5845,34155
60000,22,51120.0,425,21.25,8880,51120
80000,22,68132.0,556,27.8,11868,68132
100000,22,84969.0,672,33.6,15031,84969
200000,22,169821.0,1357,67.85,30179,169821
400000,22,339870.0,2709,135.45,60130,339870
600000,22,510075.0,4024,201.2,89925,510075
800000,22,680212.0,5370,268.5,119788,680212
1000000,22,850085.0,6695,334.75,149915,850085
2,23,1.0,0,0.0,1,1
3,23,2.0,0,0.0,1,2
100,23,80.0,2,0.1,20,80
200,23,165.0,5,0.25,35,165
2000,23,1674.0,25,1.25,326,1674
10000,23,8461.0,82,4.1,1539,8461
20000,23,16899.0,146,7.3,3101,16899
40000,23,33893.0,285,14.25,6107,33893
60000,23,50929.0,409,20.45,9071,50929
80000,23,67915.0,557,27.85,12085,67915
100000,23,84899.0,716,35.8,15101,84899
200000,23,169957.0,1391,69.55,30043,169957
400000,23,340115.0,2700,135.0,59885,340115
600000,23,509928.0,4080,204.0,90072,509928
800000,23,679527.0,5447,272.35,120473,679527
1000000,23,849477.0,6752,337.6,150523,849477
2,24,1.0,0,0.0,1,1
3,24,2.0,0,0.0,1,2
100,24,92.0,10,0.5,8,92
200,24,174.0,11,0.55,26,174
2000,24,1699.0,23,1.15,301,1699
10000,24,8477.0,76,3.8,1523,8477
20000,24,16913.0,143,7.15,3087,16913
40000,24,33951.0,281,14.05,6049,33951
60000,24,50903.0,430,21.5,9097,50903
80000,24,67883.0,556,27.8,12117,67883
100000,24,84796.0,689,34.45,15204,84796
200000,24,169800.0,1346,67.3,30200,169800
400000,24,339824.0,2710,135.5,60176,339824
600000,24,509620.0,4043,202.15,90380,509620
800000,24,679389.0,5381,269.05,120611,679389
1000000,24,849173.0,6731,336.55,150827,849173
2,25,2.0,0,0.0,0,2
3,25,3.0,0,0.0,0,3
100,25,89.0,2,0.1,11,89
200,25,175.0,2,0.1,25,175
2000,25,1701.0,20,1.0,299,1701
10000,25,8536.0,99,4.95,1464,8536
20000,25,17036.0,164,8.2,2964,17036
40000,25,34048.0,289,14.45,5952,34048
60000,25,51038.0,430,21.5,8962,51038
80000,25,68025.0,552,27.6,11975,68025
100000,25,85040.0,693,34.65,14960,85040
200000,25,169946.0,1324,66.2,30054,169946
400000,25,339721.0,2665,133.25,60279,339721
600000,25,509331.0,4015,200.75,90669,509331
800000,25,679133.0,5375,268.75,120867,679133
1000000,25,849064.0,6711,335.55,150936,849064
2,26,2.0,0,0.0,0,2
3,26,3.0,0,0.0,0,3
100,26,88.0,4,0.2,12,88
200,26,170.0,4,0.2,30,170
2000,26,1701.0,16,0.8,299,1701
10000,26,8441.0,80,4.0,1559,8441
20000,26,16929.0,149,7.45,3071,16929
40000,26,33850.0,265,13.25,6150,33850
60000,26,50838.0,397,19.85,9162,50838
80000,26,67815.0,534,26.7,12185,67815
100000,26,84818.0,665,33.25,15182,84818
200000,26,169811.0,1331,66.55,30189,169811
400000,26,340028.0,2607,130.35,59972,340028
600000,26,509943.0,3983,199.15,90057,509943
800000,26,680118.0,5311,265.55,119882,680118
1000000,26,849914.0,6684,334.2,150086,849914
2,27,2.0,0,0.0,0,2
3,27,3.0,0,0.0,0,3
100,27,82.0,0,0.0,18,82
200,27,163.0,2,0.1,37,163
2000,27,1675.0,45,2.25,325,1675
10000,27,8513.0,100,5.0,1487,8513
20000,27,16970.0,181,9.05,3030,16970
40000,27,34019.0,317,15.85,5981,34019
60000,27,50971.0,458,22.9,9029,50971
80000,27,68008.0,575,28.75,11992,68008
100000,27,85096.0,710,35.5,14904,85096
200000,27,169913.0,1405,70.25,30087,169913
400000,27,339950.0,2682,134.1,60050,339950
600000,27,509917.0,4024,201.2,90083,509917
800000,27,679795.0,5245,262.25,120205,679795
1000000,27,849875.0,6587,329.35,150125,849875
2,28,2.0,0,0.0,0,2
3,28,3.0,0,0.0,0,3
100,28,85.0,0,0.0,15,85
200,28,167.0,0,0.0,33,167
2000,28,1712.0,15,0.75,288,1712
10000,28,8520.0,78,3.9,1480,8520
20000,28,17030.0,147,7.35,2970,17030
40000,28,34044.0,278,13.9,5956,34044
60000,28,51085.0,413,20.65,8915,51085
80000,28,68075.0,549,27.45,11925,68075
100000,28,85081.0,671,33.55,14919,85081
200000,28,170197.0,1329,66.45,29803,170197
400000,28,340332.0,2688,134.4,59668,340332
600000,28,510569.0,4026,201.3,89431,510569
800000,28,680507.0,5332,266.6,119493,680507
1000000,28,850500.0,6665,333.25,149500,850500
2,29,2.0,0,0.0,0,2
3,29,2.0,0,0.0,1,2
100,29,83.0,0,0.0,17,83
200,29,170.0,5,0.25,30,170
2000,29,1683.0,123,6.15,317,1683
10000,29,8502.0,178,8.9,1498,8502
20000,29,17045.0,240,12.0,2955,17045
40000,29,34050.0,368,18.4,5950,34050
60000,29,51052.0,474,23.7,8948,51052
80000,29,68102.0,589,29.45,11898,68102
100000,29,85106.0,729,36.45,14894,85106
200000,29,170102.0,1402,70.1,29898,170102
400000,29,340007.0,2777,138.85,59993,340007
600000,29,509833.0,4110,205.5,90167,509833
800000,29,679755.0,5442,272.1,120245,679755
1000000,29,849595.0,6721,336.05,150405,849595
2,30,2.0,0,0.0,0,2
3,30,3.0,0,0.0,0,3
100,30,85.0,0,0.0,15,85
200,30,176.0,3,0.15,24,176
2000,30,1710.0,14,0.7,290,1710
10000,30,8529.0,78,3.9,1471,8529
20000,30,17002.0,159,7.95,2998,17002
40000,30,33932.0,306,15.3,6068,33932
60000,30,50892.0,446,22.3,9108,50892
80000,30,67865.0,572,28.6,12135,67865
100000,30,84880.0,709,35.45,15120,84880
200000,30,169886.0,1377,68.85,30114,169886
400000,30,339919.0,2669,133.45,60081,339919
600000,30,509853.0,3982,199.1,90147,509853
800000,30,679940.0,5324,266.2,120060,679940
1000000,30,850044.0,6718,335.9,149956,850044
2,31,2.0,0,0.0,0,2
3,31,2.0,0,0.0,1,2
100,31,85.0,0,0.0,15,85
200,31,171.0,0,0.0,29,171
2000,31,1689.0,20,1.0,311,1689
10000,31,8468.0,61,3.05,1532,8468
20000,31,16925.0,147,7.35,3075,16925
40000,31,33925.0,288,14.4,6075,33925
60000,31,50951.0,404,20.2,9049,50951
80000,31,67907.0,547,27.35,12093,67907
100000,31,84881.0,674,33.7,15119,84881
200000,31,169868.0,1343,67.15,30132,169868
400000,31,339746.0,2615,130.75,60254,339746
600000,31,509809.0,4035,201.75,90191,509809
800000,31,679703.0,5389,269.45,120297,679703
1000000,31,849335.0,6701,335.05,150665,849335
2,32,1.0,0,0.0,1,1
3,32,2.0,0,0.0,1,2
100,32,86.0,4,0.2,14,86
200,32,175.0,5,0.25,25,175
2000,32,1686.0,75,3.75,314,1686
10000,32,8452.0,143,7.15,1548,8452
20000,32,16953.0,215,10.75,3047,16953
40000,32,33898.0,342,17.1,6102,33898
60000,32,50884.0,472,23.6,9116,50884
80000,32,67909.0,597,29.85,12091,67909
100000,32,84850.0,725,36.25,15150,84850
200000,32,169746.0,1415,70.75,30254,169746
400000,32,339580.0,2827,141.35,60420,339580
600000,32,509242.0,4067,203.35,90758,509242
800000,32,678983.0,5391,269.55,121017,678983
1000000,32,849118.0,6645,332.25,150882,849118
2,33,1.0,0,0.0,1,1
3,33,2.0,0,0.0,1,2
100,33,82.0,1,0.05,18,82
200,33,167.0,3,0.15,33,167
2000,33,1695.0,22,1.1,305,1695
10000,33,8531.0,107,5.35,1469,8531
20000,33,17067.0,194,9.7,2933,17067
40000,33,34039.0,336,16.8,5961,34039
60000,33,51007.0,464,23.2,8993,51007
80000,33,67946.0,597,29.85,12054,67946
100000,33,84976.0,719,35.95,15024,84976
200000,33,170010.0,1379,68.95,29990,170010
400000,33,339947.0,2672,133.6,60053,339947
600000,33,510006.0,3994,199.7,89994,510006
800000,33,680137.0,5310,265.5,119863,680137
1000000,33,849966.0,6683,334.15,150034,849966
2,34,2.0,0,0.0,0,2
3,34,3.0,0,0.0,0,3
100,34,82.0,0,0.0,18,82
200,34,162.0,0,0.0,38,162
2000,34,1691.0,17,0.85,309,1691
10000,34,8489.0,89,4.45,1511,8489
20000,34,16958.0,152,7.6,3042,16958
40000,34,33961.0,368,18.4,6039,33961
60000,34,50893.0,505,25.25,9107,50893
80000,34,67915.0,652,32.6,12085,67915
100000,34,84929.0,785,39.25,15071,84929
200000,34,170000.0,1468,73.4,30000,170000
400000,34,340034.0,2879,143.95,59966,340034
600000,34,509806.0,4262,213.1,90194,509806
800000,34,679662.0,5540,277.0,120338,679662
1000000,34,849611.0,6820,341.0,150389,849611
2,35,2.0,0,0.0,0,2
3,35,3.0,0,0.0,0,3
100,35,85.0,0,0.0,15,85
200,35,170.0,0,0.0,30,170
2000,35,1693.0,34,1.7,307,1693
10000,35,8520.0,99,4.95,1480,8520
20000,35,17033.0,159,7.95,2967,17033
40000,35,34042.0,278,13.9,5958,34042
60000,35,50979.0,385,19.25,9021,50979
80000,35,68004.0,490,24.5,11996,68004
100000,35,84949.0,621,31.05,15051,84949
200000,35,169922.0,1288,64.4,30078,169922
400000,35,339738.0,2628,131.4,60262,339738
600000,35,509355.0,3929,196.45,90645,509355
800000,35,678855.0,5348,267.4,121145,678855
1000000,35,848683.0,6741,337.05,151317,848683
2,36,2.0,0,0.0,0,2
3,36,3.0,0,0.0,0,3
100,36,91.0,0,0.0,9,91
200,36,178.0,1,0.05,22,178
2000,36,1704.0,28,1.4,296,1704
10000,36,8477.0,77,3.85,1523,8477
20000,36,17023.0,133,6.65,2977,17023
40000,36,34002.0,276,13.8,5998,34002
60000,36,50967.0,394,19.7,9033,50967
80000,36,68010.0,515,25.75,11990,68010
100000,36,84934.0,632,31.6,15066,84934
200000,36,169808.0,1261,63.05,30192,169808
400000,36,339718.0,2644,132.2,60282,339718
600000,36,509971.0,3986,199.3,90029,509971
800000,36,679866.0,5403,270.15,120134,679866
1000000,36,849920.0,6682,334.1,150080,849920
2,37,2.0,0,0.0,0,2
3,37,3.0,0,0.0,0,3
100,37,88.0,14,0.7,12,88
200,37,170.0,15,0.75,30,170
2000,37,1671.0,33,1.65,329,1671
10000,37,8495.0,92,4.6,1505,8495
20000,37,16952.0,149,7.45,3048,16952
40000,37,33887.0,288,14.4,6113,33887
60000,37,50811.0,432,21.6,9189,50811
80000,37,67839.0,582,29.1,12161,67839
100000,37,84809.0,719,35.95,15191,84809
200000,37,169847.0,1352,67.6,30153,169847
400000,37,339768.0,2698,134.9,60232,339768
600000,37,509691.0,4107,205.35,90309,509691
800000,37,679856.0,5465,273.25,120144,679856
1000000,37,849650.0,6839,341.95,150350,849650
2,38,1.0,0,0.0,1,1
3,38,2.0,0,0.0,1,2
100,38,77.0,14,0.7,23,77
200,38,159.0,15,0.75,41,159
2000,38,1697.0,36,1.8,303,1697
10000,38,8469.0,93,4.65,1531,8469
20000,38,16895.0,175,8.75,3105,16895
40000,38,33871.0,317,15.85,6129,33871
60000,38,50890.0,445,22.25,9110,50890
80000,38,67879.0,582,29.1,12121,67879
100000,38,84742.0,724,36.2,15258,84742
200000,38,169520.0,1346,67.3,30480,169520
400000,38,339670.0,2694,134.7,60330,339670
600000,38,509585.0,4007,200.35,90415,509585
800000,38,679366.0,5361,268.05,120634,679366
1000000,38,849269.0,6723,336.15,150731,849269
2,39,2.0,0,0.0,0,2
3,39,3.0,0,0.0,0,3
100,39,86.0,8,0.4,14,86
200,39,168.0,8,0.4,32,168
2000,39,1678.0,24,1.2,322,1678
10000,39,8475.0,84,4.2,1525,8475
20000,39,17020.0,142,7.1,2980,17020
40000,39,34033.0,271,13.55,5967,34033
60000,39,51075.0,399,19.95,8925,51075
80000,39,68114.0,515,25.75,11886,68114
100000,39,85078.0,646,32.3,14922,85078
200000,39,170083.0,1326,66.3,29917,170083
400000,39,339676.0,2717,135.85,60324,339676
600000,39,509673.0,4153,207.65,90327,509673
800000,39,679523.0,5464,273.2,120477,679523
1000000,39,849442.0,6855,342.75,150558,849442
2,40,1.0,0,0.0,1,1
3,40,2.0,0,0.0,1,2
100,40,80.0,66,3.3,20,80
200,40,159.0,164,8.2,41,159
2000,40,1595.0,1953,97.65,405,1595
10000,40,8047.0,9933,496.65,1953,8047
20000,40,16327.0,13663,683.15,3673,16327
40000,40,33384.0,13794,689.7,6616,33384
60000,40,50360.0,13926,696.3,9640,50360
80000,40,67408.0,14062,703.1,12592,67408
100000,40,84435.0,14193,709.65,15565,84435
200000,40,169391.0,14893,744.65,30609,169391
400000,40,339687.0,16233,811.65,60313,339687
600000,40,509650.0,17563,878.15,90350,509650
800000,40,679753.0,18948,947.4,120247,679753
1000000,40,849794.0,20305,1015.25,150206,849794
2,41,1.0,0,0.0,1,1
3,41,2.0,0,0.0,1,2
100,41,88.0,3,0.15,12,88
200,41,174.0,6,0.3,26,174
2000,41,1704.0,18,0.9,296,1704
10000,41,8472.0,87,4.35,1528,8472
20000,41,16970.0,246,12.3,3030,16970
40000,41,33959.0,371,18.55,6041,33959
60000,41,50996.0,510,25.5,9004,50996
80000,41,67997.0,657,32.85,12003,67997
100000,41,85018.0,791,39.55,14982,85018
200000,41,169796.0,1456,72.8,30204,169796
400000,41,339543.0,2763,138.15,60457,339543
600000,41,509577.0,4112,205.6,90423,509577
800000,41,679441.0,5406,270.3,120559,679441
1000000,41,849341.0,6680,334.0,150659,849341
2,42,1.0,0,0.0,1,1
3,42,2.0,0,0.0,1,2
100,42,84.0,0,0.0,16,84
200,42,168.0,2,0.1,32,168
2000,42,1691.0,17,0.85,309,1691
10000,42,8442.0,75,3.75,1558,8442
20000,42,16928.0,144,7.2,3072,16928
40000,42,33815.0,271,13.55,6185,33815
60000,42,50813.0,410,20.5,9187,50813
80000,42,67692.0,543,27.15,12308,67692
100000,42,84714.0,656,32.8,15286,84714
200000,42,169879.0,1298,64.9,30121,169879
400000,42,339703.0,2613,130.65,60297,339703
600000,42,509698.0,3969,198.45,90302,509698
800000,42,679883.0,5243,262.15,120117,679883
1000000,42,849711.0,6534,326.7,150289,849711
2,43,1.0,0,0.0,1,1
3,43,2.0,0,0.0,1,2
100,43,78.0,0,0.0,22,78
200,43,161.0,0,0.0,39,161
2000,43,1670.0,58,2.9,330,1670
10000,43,8407.0,114,5.7,1593,8407
20000,43,16896.0,180,9.0,3104,16896
40000,43,33756.0,303,15.15,6244,33756
60000,43,50721.0,448,22.4,9279,50721
80000,43,67786.0,584,29.2,12214,67786
100000,43,84799.0,722,36.1,15201,84799
200000,43,169660.0,1376,68.8,30340,169660
400000,43,339680.0,2688,134.4,60320,339680
600000,43,509820.0,4089,204.45,90180,509820
800000,43,679931.0,5409,270.45,120069,679931
1000000,43,849575.0,6767,338.35,150425,849575
2,44,2.0,0,0.0,0,2
3,44,2.0,0,0.0,1,2
100,44,84.0,0,0.0,16,84
200,44,169.0,2,0.1,31,169
2000,44,1691.0,14,0.7,309,1691
10000,44,8465.0,72,3.6,1535,8465
20000,44,16932.0,135,6.75,3068,16932
40000,44,33800.0,265,13.25,6200,33800
60000,44,50753.0,396,19.8,9247,50753
80000,44,67775.0,530,26.5,12225,67775
100000,44,84821.0,670,33.5,15179,84821
200000,44,169592.0,1299,64.95,30408,169592
400000,44,339349.0,2625,131.25,60651,339349
600000,44,509475.0,3949,197.45,90525,509475
800000,44,679553.0,5251,262.55,120447,679553
1000000,44,849457.0,6633,331.65,150543,849457
2,45,2.0,0,0.0,0,2
3,45,3.0,0,0.0,0,3
100,45,82.0,0,0.0,18,82
200,45,165.0,0,0.0,35,165
2000,45,1682.0,24,1.2,318,1682
10000,45,8499.0,74,3.7,1501,8499
20000,45,17003.0,128,6.4,2997,17003
40000,45,34013.0,264,13.2,5987,34013
60000,45,51006.0,369,18.45,8994,51006
80000,45,67928.0,518,25.9,12072,67928
100000,45,84931.0,646,32.3,15069,84931
200000,45,170007.0,1327,66.35,29993,170007
400000,45,340063.0,2703,135.15,59937,340063
600000,45,509971.0,4091,204.55,90029,509971
800000,45,679815.0,5411,270.55,120185,679815
1000000,45,849645.0,6725,336.25,150355,849645
2,46,2.0,0,0.0,0,2
3,46,3.0,0,0.0,0,3
100,46,88.0,0,0.0,12,88
200,46,175.0,0,0.0,25,175
2000,46,1689.0,11,0.55,311,1689
10000,46,8462.0,95,4.75,1538,8462
20000,46,16962.0,175,8.75,3038,16962
40000,46,33926.0,290,14.5,6074,33926
60000,46,50855.0,413,20.65,9145,50855
80000,46,67915.0,552,27.6,12085,67915
100000,46,84858.0,680,34.0,15142,84858
200000,46,169805.0,1378,68.9,30195,169805
400000,46,339655.0,2695,134.75,60345,339655
600000,46,509513.0,4057,202.85,90487,509513
800000,46,679301.0,5380,269.0,120699,679301
1000000,46,849175.0,6743,337.15,150825,849175
2,47,0.0,0,0.0,2,0
3,47,1.0,0,0.0,2,1
100,47,80.0,0,0.0,20,80
200,47,165.0,0,0.0,35,165
2000,47,1707.0,11,0.55,293,1707
10000,47,8566.0,49,2.45,1434,8566
20000,47,17115.0,122,6.1,2885,17115
40000,47,34150.0,253,12.65,5850,34150
60000,47,51064.0,383,19.15,8936,51064
80000,47,68054.0,508,25.4,11946,68054
100000,47,85058.0,641,32.05,14942,85058
200000,47,169989.0,1325,66.25,30011,169989
400000,47,339507.0,2694,134.7,60493,339507
600000,47,509208.0,4010,200.5,90792,509208
800000,47,679013.0,5336,266.8,120987,679013
1000000,47,849043.0,6649,332.45,150957,849043
2,48,2.0,0,0.0,0,2
3,48,2.0,0,0.0,1,2
100,48,86.0,0,0.0,14,86
200,48,166.0,1,0.05,34,166
2000,48,1702.0,16,0.8,298,1702
10000,48,8508.0,66,3.3,1492,8508
20000,48,17051.0,139,6.95,2949,17051
40000,48,34032.0,282,14.1,5968,34032
60000,48,51056.0,415,20.75,8944,51056
80000,48,68034.0,578,28.9,11966,68034
100000,48,84982.0,687,34.35,15018,84982
200000,48,169968.0,1340,67.0,30032,169968
400000,48,340192.0,2638,131.9,59808,340192
600000,48,509908.0,4029,201.45,90092,509908
800000,48,679761.0,5410,270.5,120239,679761
1000000,48,849235.0,6674,333.7,150765,849235
2,49,2.0,0,0.0,0,2
3,49,3.0,0,0.0,0,3
100,49,87.0,5,0.25,13,87
200,49,176.0,5,0.25,24,176
2000,49,1700.0,24,1.2,300,1700
10000,49,8516.0,91,4.55,1484,8516
20000,49,17012.0,159,7.95,2988,17012
40000,49,33986.0,310,15.5,6014,33986
60000,49,51010.0,442,22.1,8990,51010
80000,49,67994.0,593,29.65,12006,67994
100000,49,84972.0,698,34.9,15028,84972
200000,49,170054.0,1374,68.7,29946,170054
400000,49,339548.0,2702,135.1,60452,339548
600000,49,509581.0,4052,202.6,90419,509581
800000,49,679591.0,5323,266.15,120409,679591
1000000,49,849704.0,6676,333.8,150296,849704
2,50,2.0,0,0.0,0,2
3,50,3.0,0,0.0,0,3
100,50,84.0,0,0.0,16,84
200,50,165.0,0,0.0,35,165
2000,50,1714.0,49,2.45,286,1714
10000,50,8535.0,112,5.6,1465,8535
20000,50,17005.0,188,9.4,2995,17005
40000,50,34028.0,332,16.6,5972,34028
60000,50,50974.0,459,22.95,9026,50974
80000,50,67909.0,598,29.9,12091,67909
100000,50,84873.0,733,36.65,15127,84873
200000,50,169765.0,1391,69.55,30235,169765
400000,50,339474.0,2721,136.05,60526,339474
600000,50,509597.0,4104,205.2,90403,509597
800000,50,679803.0,5410,270.5,120197,679803
1000000,50,849883.0,6744,337.2,150117,849883
2,51,2.0,0,0.0,0,2
3,51,3.0,0,0.0,0,3
100,51,91.0,1,0.05,9,91
200,51,176.0,1,0.05,24,176
2000,51,1679.0,14,0.7,321,1679
10000,51,8463.0,64,3.2,1537,8463
20000,51,16955.0,135,6.75,3045,16955
40000,51,33986.0,346,17.3,6014,33986
60000,51,51029.0,473,23.65,8971,51029
80000,51,68072.0,606,30.3,11928,68072
100000,51,85138.0,746,37.3,14862,85138
200000,51,169857.0,1410,70.5,30143,169857
400000,51,339886.0,2719,135.95,60114,339886
600000,51,510028.0,4079,203.95,89972,510028
800000,51,680098.0,5372,268.6,119902,680098
1000000,51,850093.0,6750,337.5,149907,850093
2,52,2.0,0,0.0,0,2
3,52,3.0,0,0.0,0,3
100,52,91.0,0,0.0,9,91
200,52,176.0,18,0.9,24,176
2000,52,1688.0,50,2.5,312,1688
10000,52,8463.0,119,5.95,1537,8463
20000,52,16909.0,189,9.45,3091,16909
40000,52,33955.0,349,17.45,6045,33955
60000,52,50963.0,481,24.05,9037,50963
80000,52,67925.0,602,30.1,12075,67925
100000,52,84911.0,731,36.55,15089,84911
200000,52,169992.0,1440,72.0,30008,169992
400000,52,340028.0,2784,139.2,59972,340028
600000,52,510176.0,4129,206.45,89824,510176
800000,52,680187.0,5512,275.6,119813,680187
1000000,52,850413.0,6810,340.5,149587,850413
2,53,1.0,0,0.0,1,1
3,53,2.0,0,0.0,1,2
100,53,79.0,1,0.05,21,79
200,53,164.0,1,0.05,36,164
2000,53,1690.0,17,0.85,310,1690
10000,53,8485.0,76,3.8,1515,8485
20000,53,16936.0,149,7.45,3064,16936
40000,53,33945.0,280,14.0,6055,33945
60000,53,51006.0,420,21.0,8994,51006
80000,53,67875.0,559,27.95,12125,67875
100000,53,84908.0,716,35.8,15092,84908
200000,53,169904.0,1410,70.5,30096,169904
400000,53,339424.0,2739,136.95,60576,339424
600000,53,509283.0,4089,204.45,90717,509283
800000,53,679191.0,5426,271.3,120809,679191
1000000,53,849240.0,6735,336.75,150760,849240
2,54,2.0,0,0.0,0,2
3,54,3.0,0,0.0,0,3
100,54,83.0,34,1.7,17,83
200,54,168.0,134,6.7,32,168
2000,54,1616.0,1928,96.4,384,1616
10000,54,8025.0,9902,495.1,1975,8025
20000,54,15949.0,19877,993.85,4051,15949
40000,54,31874.0,39815,1990.75,8126,31874
60000,54,47780.0,59739,2986.95,12220,47780
80000,54,64156.0,72798,3639.9,15844,64156
100000,54,81146.0,72949,3647.45,18854,81146
200000,54,165982.0,73636,3681.8,34018,165982
400000,54,335883.0,75020,3751.0,64117,335883
600000,54,505865.0,76260,3813.0,94135,505865
800000,54,675594.0,77590,3879.5,124406,675594
1000000,54,845528.0,79004,3950.2,154472,845528
2,55,2.0,0,0.0,0,2
3,55,3.0,0,0.0,0,3
100,55,81.0,0,0.0,19,81
200,55,161.0,0,0.0,39,161
2000,55,1686.0,293,14.65,314,1686
10000,55,8497.0,357,17.85,1503,8497
20000,55,16916.0,429,21.45,3084,16916
40000,55,33893.0,543,27.15,6107,33893
60000,55,50887.0,682,34.1,9113,50887
80000,55,67892.0,818,40.9,12108,67892
100000,55,84844.0,966,48.3,15156,84844
200000,55,169800.0,1646,82.3,30200,169800
400000,55,340186.0,3031,151.55,59814,340186
600000,55,510110.0,4457,222.85,89890,510110
800000,55,680066.0,5813,290.65,119934,680066
1000000,55,850204.0,7152,357.6,149796,850204
2,56,2.0,0,0.0,0,2
3,56,3.0,0,0.0,0,3
100,56,81.0,0,0.0,19,81
200,56,170.0,4,0.2,30,170
2000,56,1699.0,24,1.2,301,1699
10000,56,8505.0,80,4.0,1495,8505
20000,56,16957.0,152,7.6,3043,16957
40000,56,33958.0,284,14.2,6042,33958
60000,56,50963.0,428,21.4,9037,50963
80000,56,67974.0,566,28.3,12026,67974
100000,56,84985.0,728,36.4,15015,84985
200000,56,169843.0,1360,68.0,30157,169843
400000,56,339956.0,2702,135.1,60044,339956
600000,56,510042.0,4059,202.95,89958,510042
800000,56,679890.0,5417,270.85,120110,679890
1000000,56,849706.0,6836,341.8,150294,849706
2,57,1.0,0,0.0,1,1
3,57,1.0,0,0.0,2,1
100,57,84.0,0,0.0,16,84
200,57,166.0,15,0.75,34,166
2000,57,1699.0,52,2.6,301,1699
10000,57,8529.0,106,5.3,1471,8529
20000,57,16994.0,169,8.45,3006,16994
40000,57,33962.0,306,15.3,6038,33962
60000,57,50890.0,450,22.5,9110,50890
80000,57,67838.0,599,29.95,12162,67838
100000,57,84854.0,723,36.15,15146,84854
200000,57,169643.0,1385,69.25,30357,169643
400000,57,339604.0,2734,136.7,60396,339604
600000,57,509549.0,4057,202.85,90451,509549
800000,57,679586.0,5359,267.95,120414,679586
1000000,57,849554.0,6707,335.35,150446,849554
2,58,2.0,0,0.0,0,2
3,58,3.0,0,0.0,0,3
100,58,90.0,0,0.0,10,90
200,58,172.0,0,0.0,28,172
2000,58,1712.0,21,1.05,288,1712
10000,58,8504.0,88,4.4,1496,8504
20000,58,17012.0,207,10.35,2988,17012
40000,58,34012.0,330,16.5,5988,34012
60000,58,51028.0,473,23.65,8972,51028
80000,58,67978.0,610,30.5,12022,67978
100000,58,85031.0,756,37.8,14969,85031
200000,58,169996.0,1390,69.5,30004,169996
400000,58,339752.0,2708,135.4,60248,339752
600000,58,509794.0,4018,200.9,90206,509794
800000,58,679687.0,5348,267.4,120313,679687
1000000,58,849673.0,6636,331.8,150327,849673
2,59,2.0,0,0.0,0,2
3,59,3.0,0,0.0,0,3
100,59,90.0,2,0.1,10,90
200,59,177.0,2,0.1,23,177
2000,59,1685.0,13,0.65,315,1685
10000,59,8457.0,79,3.95,1543,8457
20000,59,16930.0,149,7.45,3070,16930
40000,59,33772.0,294,14.7,6228,33772
60000,59,50761.0,430,21.5,9239,50761
80000,59,67638.0,561,28.05,12362,67638
100000,59,84573.0,692,34.6,15427,84573
200000,59,169648.0,1341,67.05,30352,169648
400000,59,339508.0,2645,132.25,60492,339508
600000,59,509541.0,4009,200.45,90459,509541
800000,59,679348.0,5342,267.1,120652,679348
1000000,59,849523.0,6648,332.4,150477,849523
2,60,2.0,0,0.0,0,2
3,60,3.0,0,0.0,0,3
100,60,84.0,2,0.1,16,84
200,60,169.0,2,0.1,31,169
2000,60,1686.0,8,0.4,314,1686
10000,60,8474.0,70,3.5,1526,8474
20000,60,17026.0,151,7.55,2974,17026
40000,60,34081.0,327,16.35,5919,34081
60000,60,51073.0,476,23.8,8927,51073
80000,60,68007.0,610,30.5,11993,68007
100000,60,85086.0,732,36.6,14914,85086
200000,60,170041.0,1430,71.5,29959,170041
400000,60,339895.0,2754,137.7,60105,339895
600000,60,509811.0,4078,203.9,90189,509811
800000,60,679919.0,5420,271.0,120081,679919
1000000,60,849595.0,6789,339.45,150405,849595
2,61,1.0,0,0.0,1,1
3,61,2.0,0,0.0,1,2
100,61,81.0,2,0.1,19,81
200,61,164.0,2,0.1,36,164
2000,61,1693.0,20,1.0,307,1693
10000,61,8502.0,79,3.95,1498,8502
20000,61,17007.0,191,9.55,2993,17007
40000,61,34045.0,310,15.5,5955,34045
60000,61,50990.0,726,36.3,9010,50990
80000,61,68061.0,849,42.45,11939,68061
100000,61,85029.0,981,49.05,14971,85029
200000,61,169724.0,1650,82.5,30276,169724
400000,61,339550.0,2982,149.1,60450,339550
600000,61,509362.0,4362,218.1,90638,509362
800000,61,679289.0,5761,288.05,120711,679289
1000000,61,849138.0,7024,351.2,150862,849138
2,62,2.0,0,0.0,0,2
3,62,3.0,0,0.0,0,3
100,62,85.0,1,0.05,15,85
200,62,166.0,2,0.1,34,166
2000,62,1677.0,16,0.8,323,1677
10000,62,8457.0,68,3.4,1543,8457
20000,62,17007.0,127,6.35,2993,17007
40000,62,34038.0,266,13.3,5962,34038
60000,62,51012.0,405,20.25,8988,51012
80000,62,68029.0,528,26.4,11971,68029
100000,62,84987.0,641,32.05,15013,84987
200000,62,169730.0,1298,64.9,30270,169730
400000,62,339768.0,2625,131.25,60232,339768
600000,62,509598.0,3991,199.55,90402,509598
800000,62,679624.0,5328,266.4,120376,679624
1000000,62,849807.0,6653,332.65,150193,849807
2,63,1.0,0,0.0,1,1
3,63,2.0,0,0.0,1,2
100,63,82.0,0,0.0,18,82
200,63,169.0,0,0.0,31,169
2000,63,1706.0,39,1.95,294,1706
10000,63,8503.0,148,7.4,1497,8503
20000,63,16950.0,286,14.3,3050,16950
40000,63,33994.0,431,21.55,6006,33994
60000,63,50987.0,567,28.35,9013,50987
80000,63,67999.0,696,34.8,12001,67999
100000,63,84961.0,827,41.35,15039,84961
200000,63,169952.0,1451,72.55,30048,169952
400000,63,339908.0,2793,139.65,60092,339908
600000,63,509633.0,4176,208.8,90367,509633
800000,63,679521.0,5552,277.6,120479,679521
1000000,63,849553.0,6882,344.1,150447,849553
2,64,2.0,0,0.0,0,2
3,64,3.0,0,0.0,0,3
100,64,84.0,6,0.3,16,84
200,64,167.0,9,0.45,33,167
2000,64,1692.0,75,3.75,308,1692
10000,64,8481.0,355,17.75,1519,8481
20000,64,16996.0,476,23.8,3004,16996
40000,64,33977.0,608,30.4,6023,33977
60000,64,50898.0,737,36.85,9102,50898
80000,64,67953.0,862,43.1,12047,67953
100000,64,84935.0,1002,50.1,15065,84935
200000,64,169820.0,1674,83.7,30180,169820
400000,64,339905.0,2966,148.3,60095,339905
600000,64,510082.0,4305,215.25,89918,510082
800000,64,680067.0,5656,282.8,119933,680067
1000000,64,849899.0,6971,348.55,150101,849899
2,65,0.0,0,0.0,2,0
3,65,0.0,0,0.0,3,0
100,65,87.0,0,0.0,13,87
200,65,173.0,0,0.0,27,173
2000,65,1696.0,42,2.1,304,1696
10000,65,8483.0,142,7.1,1517,8483
20000,65,16978.0,205,10.25,3022,16978
40000,65,33962.0,355,17.75,6038,33962
60000,65,50897.0,490,24.5,9103,50897
80000,65,67834.0,631,31.55,12166,67834
100000,65,84889.0,758,37.9,15111,84889
200000,65,169722.0,1421,71.05,30278,169722
400000,65,339551.0,2824,141.2,60449,339551
600000,65,509366.0,4116,205.8,90634,509366
800000,65,679632.0,5504,275.2,120368,679632
1000000,65,849518.0,6827,341.35,150482,849518
2,66,1.0,0,0.0,1,1
3,66,1.0,0,0.0,2,1
100,66,84.0,0,0.0,16,84
200,66,169.0,0,0.0,31,169
2000,66,1697.0,46,2.3,303,1697
10000,66,8506.0,114,5.7,1494,8506
20000,66,16985.0,183,9.15,3015,16985
40000,66,34017.0,320,16.0,5983,34017
60000,66,51063.0,464,23.2,8937,51063
80000,66,68038.0,599,29.95,11962,68038
100000,66,85027.0,722,36.1,14973,85027
200000,66,169990.0,1354,67.7,30010,169990
400000,66,340030.0,2644,132.2,59970,340030
600000,66,510000.0,4017,200.85,90000,510000
800000,66,679916.0,5310,265.5,120084,679916
1000000,66,850014.0,6667,333.35,149986,850014
2,67,2.0,0,0.0,0,2
3,67,3.0,0,0.0,0,3
100,67,85.0,11,0.55,15,85
200,67,171.0,21,1.05,29,171
2000,67,1685.0,37,1.85,315,1685
10000,67,8492.0,200,10.0,1508,8492
20000,67,16981.0,262,13.1,3019,16981
40000,67,33977.0,417,20.85,6023,33977
60000,67,51066.0,552,27.6,8934,51066
80000,67,68087.0,663,33.15,11913,68087
100000,67,85109.0,811,40.55,14891,85109
200000,67,169912.0,1468,73.4,30088,169912
400000,67,339847.0,2796,139.8,60153,339847
600000,67,509738.0,4181,209.05,90262,509738
800000,67,679523.0,5489,274.45,120477,679523
1000000,67,849522.0,6801,340.05,150478,849522
2,68,2.0,0,0.0,0,2
3,68,3.0,0,0.0,0,3
100,68,82.0,0,0.0,18,82
200,68,169.0,0,0.0,31,169
2000,68,1711.0,14,0.7,289,1711
10000,68,8515.0,60,3.0,1485,8515
20000,68,17034.0,124,6.2,2966,17034
40000,68,34107.0,256,12.8,5893,34107
60000,68,51127.0,394,19.7,8873,51127
80000,68,68266.0,559,27.95,11734,68266
100000,68,85225.0,667,33.35,14775,85225
200000,68,170164.0,1349,67.45,29836,170164
400000,68,340319.0,2699,134.95,59681,340319
600000,68,510535.0,4026,201.3,89465,510535
800000,68,680520.0,5344,267.2,119480,680520
1000000,68,850434.0,6691,334.55,149566,850434
2,69,2.0,0,0.0,0,2
3,69,3.0,0,0.0,0,3
100,69,83.0,70,3.5,17,83
200,69,159.0,169,8.45,41,159
2000,69,1601.0,1964,98.2,399,1601
10000,69,8025.0,9940,497.0,1975,8025
20000,69,15997.0,19907,995.35,4003,15997
40000,69,32559.0,28679,1433.95,7441,32559
60000,69,49511.0,28812,1440.6,10489,49511
80000,69,66405.0,28951,1447.55,13595,66405
100000,69,83408.0,29090,1454.5,16592,83408
200000,69,168453.0,29723,1486.15,31547,168453
400000,69,338401.0,31117,1555.85,61599,338401
600000,69,508489.0,32459,1622.95,91511,508489
800000,69,678966.0,33847,1692.35,121034,678966
1000000,69,849091.0,35169,1758.45,150909,849091
2,70,1.0,0,0.0,1,1
3,70,2.0,0,0.0,1,2
100,70,88.0,8,0.4,12,88
200,70,176.0,9,0.45,24,176
2000,70,1704.0,54,2.7,296,1704
10000,70,8470.0,108,5.4,1530,8470
20000,70,16999.0,161,8.05,3001,16999
40000,70,33985.0,288,14.4,6015,33985
60000,70,51077.0,421,21.05,8923,51077
80000,70,68119.0,554,27.7,11881,68119
100000,70,85141.0,682,34.1,14859,85141
200000,70,169982.0,1346,67.3,30018,169982
400000,70,339681.0,2696,134.8,60319,339681
600000,70,510049.0,4013,200.65,89951,510049
800000,70,679970.0,5335,266.75,120030,679970
1000000,70,850305.0,6674,333.7,149695,850305
2,71,2.0,0,0.0,0,2
3,71,3.0,0,0.0,0,3
100,71,86.0,0,0.0,14,86
200,71,170.0,47,2.35,30,170
2000,71,1684.0,284,14.2,316,1684
10000,71,8422.0,336,16.8,1578,8422
20000,71,16908.0,405,20.25,3092,16908
40000,71,33794.0,533,26.65,6206,33794
60000,71,50731.0,671,33.55,9269,50731
80000,71,67790.0,810,40.5,12210,67790
100000,71,84724.0,930,46.5,15276,84724
200000,71,169896.0,1607,80.35,30104,169896
400000,71,339524.0,2954,147.7,60476,339524
600000,71,509366.0,4241,212.05,90634,509366
800000,71,679362.0,5592,279.6,120638,679362
1000000,71,849438.0,6959,347.95,150562,849438
2,72,1.0,0,0.0,1,1
3,72,2.0,0,0.0,1,2
100,72,88.0,14,0.7,12,88
200,72,179.0,19,0.95,21,179
2000,72,1701.0,39,1.95,299,1701
10000,72,8504.0,79,3.95,1496,8504
20000,72,16993.0,134,6.7,3007,16993
40000,72,33982.0,356,17.8,6018,33982
60000,72,51046.0,498,24.9,8954,51046
80000,72,68025.0,626,31.3,11975,68025
100000,72,84980.0,773,38.65,15020,84980
200000,72,169953.0,1470,73.5,30047,169953
400000,72,339898.0,2779,138.95,60102,339898
600000,72,509997.0,4089,204.45,90003,509997
800000,72,680135.0,5358,267.9,119865,680135
1000000,72,849962.0,6644,332.2,150038,849962
2,73,2.0,0,0.0,0,2
3,73,3.0,0,0.0,0,3
100,73,85.0,0,0.0,15,85
200,73,165.0,0,0.0,35,165
2000,73,1689.0,41,2.05,311,1689
10000,73,8444.0,118,5.9,1556,8444
20000,73,16870.0,180,9.0,3130,16870
40000,73,33838.0,326,16.3,6162,33838
60000,73,50959.0,452,22.6,9041,50959
80000,73,67937.0,591,29.55,12063,67937
100000,73,84966.0,745,37.25,15034,84966
200000,73,169905.0,1390,69.5,30095,169905
400000,73,339886.0,2738,136.9,60114,339886
600000,73,510083.0,4041,202.05,89917,510083
800000,73,679931.0,5379,268.95,120069,679931
1000000,73,850144.0,6793,339.65,149856,850144
2,74,0.0,0,0.0,2,0
3,74,1.0,0,0.0,2,1
100,74,79.0,0,0.0,21,79
200,74,163.0,0,0.0,37,163
2000,74,1672.0,130,6.5,328,1672
10000,74,8423.0,185,9.25,1577,8423
20000,74,16859.0,407,20.35,3141,16859
40000,74,33909.0,533,26.65,6091,33909
60000,74,50946.0,669,33.45,9054,50946
80000,74,67890.0,804,40.2,12110,67890
100000,74,84936.0,932,46.6,15064,84936
200000,74,170148.0,1611,80.55,29852,170148
400000,74,339860.0,2868,143.4,60140,339860
600000,74,509803.0,4201,210.05,90197,509803
800000,74,679763.0,5530,276.5,120237,679763
1000000,74,849838.0,6866,343.3,150162,849838
2,75,1.0,0,0.0,1,1
3,75,2.0,0,0.0,1,2
100,75,83.0,0,0.0,17,83
200,75,171.0,0,0.0,29,171
2000,75,1715.0,21,1.05,285,1715
10000,75,8496.0,68,3.4,1504,8496
20000,75,16988.0,139,6.95,3012,16988
40000,75,33890.0,265,13.25,6110,33890
60000,75,50804.0,400,20.0,9196,50804
80000,75,67786.0,544,27.2,12214,67786
100000,75,84906.0,662,33.1,15094,84906
200000,75,169597.0,1317,65.85,30403,169597
400000,75,339791.0,2647,132.35,60209,339791
600000,75,509811.0,4019,200.95,90189,509811
800000,75,679750.0,5317,265.85,120250,679750
1000000,75,849473.0,6631,331.55,150527,849473
2,76,2.0,0,0.0,0,2
3,76,3.0,0,0.0,0,3
100,76,88.0,0,0.0,12,88
200,76,173.0,0,0.0,27,173
2000,76,1705.0,42,2.1,295,1705
10000,76,8539.0,93,4.65,1461,8539
20000,76,17110.0,171,8.55,2890,17110
40000,76,34085.0,314,15.7,5915,34085
60000,76,51218.0,460,23.0,8782,51218
80000,76,68219.0,573,28.65,11781,68219
100000,76,85222.0,721,36.05,14778,85222
200000,76,170200.0,1384,69.2,29800,170200
400000,76,340226.0,2713,135.65,59774,340226
600000,76,510092.0,4034,201.7,89908,510092
800000,76,680167.0,5373,268.65,119833,680167
1000000,76,850340.0,6733,336.65,149660,850340
2,77,1.0,0,0.0,1,1
3,77,2.0,0,0.0,1,2
100,77,86.0,1,0.05,14,86
200,77,168.0,4,0.2,32,168
2000,77,1717.0,13,0.65,283,1717
10000,77,8480.0,74,3.7,1520,8480
20000,77,16975.0,136,6.8,3025,16975
40000,77,34003.0,273,13.65,5997,34003
60000,77,51132.0,375,18.75,8868,51132
80000,77,68120.0,510,25.5,11880,68120
100000,77,85179.0,629,31.45,14821,85179
200000,77,170275.0,1309,65.45,29725,170275
400000,77,340397.0,2696,134.8,59603,340397
600000,77,510609.0,4091,204.55,89391,510609
800000,77,680428.0,5402,270.1,119572,680428
1000000,77,850628.0,6701,335.05,149372,850628
2,78,2.0,0,0.0,0,2
3,78,3.0,0,0.0,0,3
100,78,85.0,4,0.2,15,85
200,78,170.0,5,0.25,30,170
2000,78,1681.0,24,1.2,319,1681
10000,78,8479.0,106,5.3,1521,8479
20000,78,16965.0,170,8.5,3035,16965
40000,78,34051.0,318,15.9,5949,34051
60000,78,51047.0,440,22.0,8953,51047
80000,78,68012.0,566,28.3,11988,68012
100000,78,85048.0,701,35.05,14952,85048
200000,78,169923.0,1397,69.85,30077,169923
400000,78,339904.0,2744,137.2,60096,339904
600000,78,509758.0,4122,206.1,90242,509758
800000,78,679655.0,5461,273.05,120345,679655
1000000,78,849552.0,6814,340.7,150448,849552
2,79,1.0,0,0.0,1,1
3,79,2.0,0,0.0,1,2
100,79,85.0,96,4.8,15,85
200,79,154.0,195,9.75,46,154
2000,79,1594.0,1987,99.35,406,1594
10000,79,8333.0,2578,128.9,1667,8333
20000,79,16824.0,2636,131.8,3176,16824
40000,79,33844.0,2773,138.65,6156,33844
60000,79,50838.0,2921,146.05,9162,50838
80000,79,67814.0,3062,153.1,12186,67814
100000,79,84741.0,3211,160.55,15259,84741
200000,79,169792.0,3871,193.55,30208,169792
400000,79,339573.0,5303,265.15,60427,339573
600000,79,509270.0,6639,331.95,90730,509270
800000,79,679352.0,7997,399.85,120648,679352
1000000,79,849417.0,9387,469.35,150583,849417
2,80,1.0,0,0.0,1,1
3,80,1.0,0,0.0,2,1
100,80,90.0,0,0.0,10,90
200,80,175.0,0,0.0,25,175
2000,80,1693.0,64,3.2,307,1693
10000,80,8508.0,164,8.2,1492,8508
20000,80,17043.0,382,19.1,2957,17043
40000,80,33977.0,524,26.2,6023,33977
60000,80,50918.0,654,32.7,9082,50918
80000,80,67992.0,789,39.45,12008,67992
100000,80,84906.0,928,46.4,15094,84906
200000,80,169993.0,1576,78.8,30007,169993
400000,80,339872.0,2872,143.6,60128,339872
600000,80,509973.0,4251,212.55,90027,509973
800000,80,679915.0,5562,278.1,120085,679915
1000000,80,849902.0,6887,344.35,150098,849902
2,81,2.0,0,0.0,0,2
3,81,3.0,0,0.0,0,3
100,81,86.0,3,0.15,14,86
200,81,176.0,3,0.15,24,176
2000,81,1696.0,40,2.0,304,1696
10000,81,8521.0,95,4.75,1479,8521
20000,81,17052.0,163,8.15,2948,17052
40000,81,34065.0,343,17.15,5935,34065
60000,81,51084.0,470,23.5,8916,51084
80000,81,68048.0,609,30.45,11952,68048
100000,81,84958.0,750,37.5,15042,84958
200000,81,169909.0,1386,69.3,30091,169909
400000,81,339628.0,2689,134.45,60372,339628
600000,81,509794.0,4067,203.35,90206,509794
800000,81,679771.0,5383,269.15,120229,679771
1000000,81,849786.0,6705,335.25,150214,849786
2,82,2.0,0,0.0,0,2
3,82,3.0,0,0.0,0,3
100,82,90.0,0,0.0,10,90
200,82,179.0,33,1.65,21,179
2000,82,1709.0,109,5.45,291,1709
10000,82,8544.0,150,7.5,1456,8544
20000,82,16972.0,216,10.8,3028,16972
40000,82,33946.0,349,17.45,6054,33946
60000,82,51026.0,497,24.85,8974,51026
80000,82,68039.0,620,31.0,11961,68039
100000,82,85109.0,743,37.15,14891,85109
200000,82,169962.0,1427,71.35,30038,169962
400000,82,339828.0,2775,138.75,60172,339828
600000,82,509799.0,4123,206.15,90201,509799
800000,82,679767.0,5447,272.35,120233,679767
1000000,82,849780.0,6742,337.1,150220,849780
2,83,2.0,0,0.0,0,2
3,83,3.0,0,0.0,0,3
100,83,85.0,0,0.0,15,85
200,83,167.0,10,0.5,33,167
2000,83,1668.0,246,12.3,332,1668
10000,83,8464.0,404,20.2,1536,8464
20000,83,17012.0,516,25.8,2988,17012
40000,83,34002.0,648,32.4,5998,34002
60000,83,51008.0,777,38.85,8992,51008
80000,83,68006.0,904,45.2,11994,68006
100000,83,84985.0,1044,52.2,15015,84985
200000,83,170172.0,1669,83.45,29828,170172
400000,83,339996.0,2942,147.1,60004,339996
600000,83,510057.0,4273,213.65,89943,510057
800000,83,680004.0,5558,277.9,119996,680004
1000000,83,850164.0,6838,341.9,149836,850164
2,84,2.0,0,0.0,0,2
3,84,3.0,0,0.0,0,3
100,84,85.0,1,0.05,15,85
200,84,168.0,1,0.05,32,168
2000,84,1675.0,10,0.5,325,1675
10000,84,8466.0,152,7.6,1534,8466
20000,84,17006.0,207,10.35,2994,17006
40000,84,34109.0,340,17.0,5891,34109
60000,84,51097.0,480,24.0,8903,51097
80000,84,68174.0,644,32.2,11826,68174
100000,84,85150.0,788,39.4,14850,85150
200000,84,170245.0,1463,73.15,29755,170245
400000,84,340243.0,2815,140.75,59757,340243
600000,84,510201.0,4123,206.15,89799,510201
800000,84,680461.0,5414,270.7,119539,680461
1000000,84,850612.0,6668,333.4,149388,850612
2,85,2.0,0,0.0,0,2
3,85,3.0,0,0.0,0,3
100,85,80.0,0,0.0,20,80
200,85,158.0,0,0.0,42,158
2000,85,1682.0,53,2.65,318,1682
10000,85,8435.0,101,5.05,1565,8435
20000,85,16951.0,169,8.45,3049,16951
40000,85,33992.0,309,15.45,6008,33992
60000,85,50924.0,428,21.4,9076,50924
80000,85,67872.0,565,28.25,12128,67872
100000,85,84901.0,679,33.95,15099,84901
200000,85,169696.0,1354,67.7,30304,169696
400000,85,339398.0,2698,134.9,60602,339398
600000,85,509356.0,4068,203.4,90644,509356
800000,85,679113.0,5387,269.35,120887,679113
1000000,85,849208.0,6746,337.3,150792,849208
2,86,1.0,0,0.0,1,1
3,86,2.0,0,0.0,1,2
100,86,85.0,3,0.15,15,85
200,86,169.0,5,0.25,31,169
2000,86,1706.0,22,1.1,294,1706
10000,86,8456.0,104,5.2,1544,8456
20000,86,16942.0,176,8.8,3058,16942
40000,86,33941.0,318,15.9,6059,33941
60000,86,50904.0,471,23.55,9096,50904
80000,86,67905.0,598,29.9,12095,67905
100000,86,84968.0,713,35.65,15032,84968
200000,86,169863.0,1388,69.4,30137,169863
400000,86,339645.0,2738,136.9,60355,339645
600000,86,509309.0,4036,201.8,90691,509309
800000,86,679057.0,5411,270.55,120943,679057
1000000,86,849085.0,6719,335.95,150915,849085
2,87,2.0,0,0.0,0,2
3,87,3.0,0,0.0,0,3
100,87,85.0,0,0.0,15,85
200,87,174.0,4,0.2,26,174
2000,87,1720.0,35,1.75,280,1720
10000,87,8549.0,85,4.25,1451,8549
20000,87,17076.0,143,7.15,2924,17076
40000,87,34058.0,266,13.3,5942,34058
60000,87,51149.0,409,20.45,8851,51149
80000,87,68201.0,632,31.6,11799,68201
100000,87,85230.0,820,41.0,14770,85230
200000,87,170090.0,1471,73.55,29910,170090
400000,87,340310.0,2864,143.2,59690,340310
600000,87,510331.0,4205,210.25,89669,510331
800000,87,680030.0,5534,276.7,119970,680030
1000000,87,850100.0,6833,341.65,149900,850100
2,88,2.0,0,0.0,0,2
3,88,3.0,0,0.0,0,3
100,88,85.0,0,0.0,15,85
200,88,166.0,0,0.0,34,166
2000,88,1702.0,27,1.35,298,1702
10000,88,8592.0,85,4.25,1408,8592
20000,88,17054.0,163,8.15,2946,17054
40000,88,34061.0,296,14.8,5939,34061
60000,88,51085.0,419,20.95,8915,51085
80000,88,68067.0,546,27.3,11933,68067
100000,88,85074.0,672,33.6,14926,85074
200000,88,170149.0,1370,68.5,29851,170149
400000,88,340083.0,2751,137.55,59917,340083
600000,88,509760.0,4063,203.15,90240,509760
800000,88,679355.0,5363,268.15,120645,679355
1000000,88,849016.0,6663,333.15,150984,849016
2,89,2.0,0,0.0,0,2
3,89,3.0,0,0.0,0,3
100,89,84.0,4,0.2,16,84
200,89,170.0,5,0.25,30,170
2000,89,1699.0,29,1.45,301,1699
10000,89,8497.0,90,4.5,1503,8497
20000,89,16979.0,149,7.45,3021,16979
40000,89,34042.0,314,15.7,5958,34042
60000,89,50980.0,450,22.5,9020,50980
80000,89,67993.0,575,28.75,12007,67993
100000,89,85004.0,700,35.0,14996,85004
200000,89,169882.0,1341,67.05,30118,169882
400000,89,339696.0,2683,134.15,60304,339696
600000,89,509826.0,4025,201.25,90174,509826
800000,89,679566.0,5348,267.4,120434,679566
1000000,89,849026.0,6673,333.65,150974,849026
2,90,0.0,0,0.0,2,0
3,90,1.0,0,0.0,2,1
100,90,82.0,69,3.45,18,82
200,90,159.0,169,8.45,41,159
2000,90,1678.0,274,13.7,322,1678
10000,90,8496.0,355,17.75,1504,8496
20000,90,16954.0,428,21.4,3046,16954
40000,90,33926.0,549,27.45,6074,33926
60000,90,50876.0,683,34.15,9124,50876
80000,90,67861.0,831,41.55,12139,67861
100000,90,84860.0,984,49.2,15140,84860
200000,90,169964.0,1639,81.95,30036,169964
400000,90,339923.0,2964,148.2,60077,339923
600000,90,509911.0,4278,213.9,90089,509911
800000,90,679760.0,5579,278.95,120240,679760
1000000,90,849719.0,6948,347.4,150281,849719
2,91,1.0,0,0.0,1,1
3,91,1.0,0,0.0,2,1
100,91,90.0,0,0.0,10,90
200,91,173.0,0,0.0,27,173
2000,91,1689.0,15,0.75,311,1689
10000,91,8477.0,75,3.75,1523,8477
20000,91,16900.0,127,6.35,3100,16900
40000,91,33919.0,263,13.15,6081,33919
60000,91,50979.0,382,19.1,9021,50979
80000,91,67992.0,529,26.45,12008,67992
100000,91,85044.0,661,33.05,14956,85044
200000,91,169980.0,1317,65.85,30020,169980
400000,91,340204.0,2663,133.15,59796,340204
600000,91,510124.0,4022,201.1,89876,510124
800000,91,680088.0,5305,265.25,119912,680088
1000000,91,850008.0,6608,330.4,149992,850008
2,92,1.0,0,0.0,1,1
3,92,2.0,0,0.0,1,2
100,92,82.0,9,0.45,18,82
200,92,168.0,10,0.5,32,168
2000,92,1715.0,16,0.8,285,1715
10000,92,8547.0,60,3.0,1453,8547
20000,92,17079.0,128,6.4,2921,17079
40000,92,34068.0,262,13.1,5932,34068
60000,92,51029.0,400,20.0,8971,51029
80000,92,67945.0,534,26.7,12055,67945
100000,92,84945.0,664,33.2,15055,84945
200000,92,170059.0,1326,66.3,29941,170059
400000,92,340342.0,2668,133.4,59658,340342
600000,92,510012.0,3965,198.25,89988,510012
800000,92,679923.0,5286,264.3,120077,679923
1000000,92,849852.0,6530,326.5,150148,849852
2,93,1.0,0,0.0,1,1
3,93,2.0,0,0.0,1,2
100,93,83.0,0,0.0,17,83
200,93,165.0,0,0.0,35,165
2000,93,1680.0,22,1.1,320,1680
10000,93,8486.0,97,4.85,1514,8486
20000,93,16927.0,154,7.7,3073,16927
40000,93,33868.0,290,14.5,6132,33868
60000,93,50924.0,407,20.35,9076,50924
80000,93,68045.0,533,26.65,11955,68045
100000,93,85105.0,646,32.3,14895,85105
200000,93,170037.0,1327,66.35,29963,170037
400000,93,339899.0,2664,133.2,60101,339899
600000,93,509630.0,4003,200.15,90370,509630
800000,93,679730.0,5310,265.5,120270,679730
1000000,93,849395.0,6670,333.5,150605,849395
2,94,2.0,0,0.0,0,2
3,94,3.0,0,0.0,0,3
100,94,83.0,0,0.0,17,83
200,94,162.0,1,0.05,38,162
2000,94,1672.0,15,0.75,328,1672
10000,94,8477.0,102,5.1,1523,8477
20000,94,16959.0,179,8.95,3041,16959
40000,94,33901.0,315,15.75,6099,33901
60000,94,50842.0,422,21.1,9158,50842
80000,94,67841.0,542,27.1,12159,67841
100000,94,84911.0,655,32.75,15089,84911
200000,94,169856.0,1304,65.2,30144,169856
400000,94,339826.0,2639,131.95,60174,339826
600000,94,509532.0,4026,201.3,90468,509532
800000,94,679127.0,5365,268.25,120873,679127
1000000,94,848843.0,6658,332.9,151157,848843
2,95,1.0,0,0.0,1,1
3,95,1.0,0,0.0,2,1
100,95,87.0,6,0.3,13,87
200,95,166.0,21,1.05,34,166
2000,95,1695.0,35,1.75,305,1695
10000,95,8492.0,75,3.75,1508,8492
20000,95,17007.0,162,8.1,2993,17007
40000,95,34051.0,307,15.35,5949,34051
60000,95,51056.0,434,21.7,8944,51056
80000,95,68047.0,553,27.65,11953,68047
100000,95,85025.0,671,33.55,14975,85025
200000,95,169796.0,1357,67.85,30204,169796
400000,95,339458.0,2715,135.75,60542,339458
600000,95,509151.0,4007,200.35,90849,509151
800000,95,679038.0,5358,267.9,120962,679038
1000000,95,849049.0,6644,332.2,150951,849049
2,96,1.0,0,0.0,1,1
3,96,2.0,0,0.0,1,2
100,96,80.0,3,0.15,20,80
200,96,165.0,3,0.15,35,165
2000,96,1693.0,23,1.15,307,1693
10000,96,8516.0,85,4.25,1484,8516
20000,96,17033.0,154,7.7,2967,17033
40000,96,33936.0,302,15.1,6064,33936
60000,96,50955.0,440,22.0,9045,50955
80000,96,67937.0,576,28.8,12063,67937
100000,96,84913.0,704,35.2,15087,84913
200000,96,169883.0,1389,69.45,30117,169883
400000,96,339956.0,2727,136.35,60044,339956
600000,96,509850.0,4036,201.8,90150,509850
800000,96,679772.0,5335,266.75,120228,679772
1000000,96,849872.0,6716,335.8,150128,849872
2,97,2.0,0,0.0,0,2
3,97,3.0,0,0.0,0,3
100,97,83.0,0,0.0,17,83
200,97,169.0,7,0.35,31,169
2000,97,1705.0,21,1.05,295,1705
10000,97,8457.0,83,4.15,1543,8457
20000,97,16921.0,156,7.8,3079,16921
40000,97,33885.0,294,14.7,6115,33885
60000,97,50835.0,426,21.3,9165,50835
80000,97,67763.0,547,27.35,12237,67763
100000,97,84744.0,664,33.2,15256,84744
200000,97,169641.0,1321,66.05,30359,169641
400000,97,339838.0,2622,131.1,60162,339838
600000,97,509657.0,3953,197.65,90343,509657
800000,97,679349.0,5314,265.7,120651,679349
1000000,97,849028.0,6633,331.65,150972,849028
2,98,2.0,0,0.0,0,2
3,98,3.0,0,0.0,0,3
100,98,84.0,0,0.0,16,84
200,98,170.0,0,0.0,30,170
2000,98,1698.0,27,1.35,302,1698
10000,98,8505.0,90,4.5,1495,8505
20000,98,17065.0,168,8.4,2935,17065
40000,98,34057.0,310,15.5,5943,34057
60000,98,51009.0,456,22.8,8991,51009
80000,98,68004.0,608,30.4,11996,68004
100000,98,85049.0,736,36.8,14951,85049
200000,98,170019.0,1389,69.45,29981,170019
400000,98,339967.0,2742,137.1,60033,339967
600000,98,509952.0,4047,202.35,90048,509952
800000,98,680046.0,5332,266.6,119954,680046
1000000,98,850039.0,6659,332.95,149961,850039
2,99,2.0,0,0.0,0,2
3,99,2.0,0,0.0,1,2
100,99,87.0,67,3.35,13,87
200,99,174.0,167,8.35,26,174
2000,99,1597.0,1958,97.9,403,1597
10000,99,8226.0,4045,202.25,1774,8226
20000,99,16684.0,4122,206.1,3316,16684
40000,99,33651.0,4230,211.5,6349,33651
60000,99,50711.0,4374,218.7,9289,50711
80000,99,67617.0,4503,225.15,12383,67617
100000,99,84640.0,4622,231.1,15360,84640
200000,99,169579.0,5313,265.65,30421,169579
400000,99,339642.0,6615,330.75,60358,339642
600000,99,509365.0,7889,394.45,90635,509365
800000,99,679207.0,9277,463.85,120793,679207
1000000,99,849244.0,10586,529.3,150756,849244
2,100,2.0,0,0.0,0,2
3,100,3.0,0,0.0,0,3
100,100,81.0,3,0.15,19,81
200,100,170.0,4,0.2,30,170
2000,100,1690.0,36,1.8,310,1690
10000,100,8540.0,92,4.6,1460,8540
20000,100,17093.0,167,8.35,2907,17093
40000,100,33968.0,299,14.95,6032,33968
60000,100,51085.0,449,22.45,8915,51085
80000,100,68040.0,585,29.25,11960,68040
100000,100,85020.0,720,36.0,14980,85020
200000,100,169868.0,1392,69.6,30132,169868
400000,100,339813.0,2713,135.65,60187,339813
600000,100,509857.0,4031,201.55,90143,509857
800000,100,680043.0,5414,270.7,119957,680043
1000000,100,849982.0,6691,334.55,150018,849982
