Timestep,Iteration,Total Reward,Suboptimal Arms,Total Regret,Zeros Count,Ones Count
2,1,1.0,1,0.05,1,1
3,1,2.0,2,0.09,1,2
100,1,87.0,90,4.05,13,87
200,1,171.0,190,8.55,29,171
2000,1,1677.0,1990,89.55,323,1677
10000,1,8447.0,9990,449.55,1553,8447
20000,1,16969.0,19990,899.55,3031,16969
40000,1,34054.0,39990,1799.55,5946,34054
60000,1,51049.0,59990,2699.55,8951,51049
80000,1,68069.0,79990,3599.55,11931,68069
100000,1,85043.0,99990,4499.55,14957,85043
200000,1,169980.0,199990,8999.55,30020,169980
400000,1,340573.0,399990,17999.55,59427,340573
600000,1,510368.0,599990,26999.55,89632,510368
800000,1,680191.0,799990,35999.55,119809,680191
1000000,1,850166.0,999990,44999.55,149834,850166
2,2,1.0,1,0.05,1,1
3,2,2.0,2,0.09,1,2
100,2,89.0,10,0.45,11,89
200,2,171.0,10,0.45,29,171
2000,2,1764.0,10,0.45,236,1764
10000,2,8937.0,10,0.45,1063,8937
20000,2,17847.0,10,0.45,2153,17847
40000,2,35730.0,10,0.45,4270,35730
60000,2,53623.0,10,0.45,6377,53623
80000,2,71548.0,10,0.45,8452,71548
100000,2,89451.0,10,0.45,10549,89451
200000,2,179084.0,10,0.45,20916,179084
400000,2,358242.0,10,0.45,41758,358242
600000,2,537483.0,10,0.45,62517,537483
800000,2,716227.0,10,0.45,83773,716227
1000000,2,895165.0,10,0.45,104835,895165
2,3,2.0,1,0.05,0,2
3,3,3.0,2,0.09,0,3
100,3,89.0,14,0.63,11,89
200,3,183.0,14,0.63,17,183
2000,3,1796.0,14,0.63,204,1796
10000,3,8965.0,14,0.63,1035,8965
20000,3,17965.0,14,0.63,2035,17965
40000,3,35852.0,14,0.63,4148,35852
60000,3,53760.0,14,0.63,6240,53760
80000,3,71639.0,14,0.63,8361,71639
100000,3,89629.0,14,0.63,10371,89629
200000,3,178921.0,14,0.63,21079,178921
400000,3,358001.0,14,0.63,41999,358001
600000,3,536968.0,14,0.63,63032,536968
800000,3,715807.0,14,0.63,84193,715807
1000000,3,894661.0,14,0.63,105339,894661
2,4,2.0,1,0.05,0,2
3,4,3.0,2,0.09,0,3
100,4,89.0,12,0.54,11,89
200,4,182.0,12,0.54,18,182
2000,4,1791.0,12,0.54,209,1791
10000,4,8939.0,12,0.54,1061,8939
20000,4,17913.0,12,0.54,2087,17913
40000,4,35746.0,12,0.54,4254,35746
60000,4,53684.0,12,0.54,6316,53684
80000,4,71605.0,12,0.54,8395,71605
100000,4,89447.0,12,0.54,10553,89447
200000,4,178901.0,12,0.54,21099,178901
400000,4,357844.0,12,0.54,42156,357844
600000,4,536672.0,12,0.54,63328,536672
800000,4,715571.0,12,0.54,84429,715571
1000000,4,894680.0,12,0.54,105320,894680
2,5,2.0,1,0.05,0,2
3,5,3.0,2,0.09,0,3
100,5,86.0,10,0.45,14,86
200,5,166.0,10,0.45,34,166
2000,5,1800.0,10,0.45,200,1800
10000,5,8973.0,10,0.45,1027,8973
20000,5,17936.0,10,0.45,2064,17936
40000,5,35839.0,10,0.45,4161,35839
60000,5,53638.0,10,0.45,6362,53638
80000,5,71513.0,10,0.45,8487,71513
100000,5,89404.0,10,0.45,10596,89404
200000,5,179006.0,10,0.45,20994,179006
400000,5,357945.0,10,0.45,42055,357945
600000,5,537081.0,10,0.45,62919,537081
800000,5,716004.0,10,0.45,83996,716004
1000000,5,894845.0,10,0.45,105155,894845
2,6,2.0,1,0.05,0,2
3,6,3.0,2,0.09,0,3
100,6,90.0,12,0.54,10,90
200,6,174.0,12,0.54,26,174
2000,6,1806.0,12,0.54,194,1806
10000,6,8980.0,12,0.54,1020,8980
20000,6,17948.0,12,0.54,2052,17948
40000,6,35848.0,12,0.54,4152,35848
60000,6,53773.0,12,0.54,6227,53773
80000,6,71716.0,12,0.54,8284,71716
100000,6,89584.0,12,0.54,10416,89584
200000,6,179206.0,12,0.54,20794,179206
400000,6,358226.0,12,0.54,41774,358226
600000,6,537085.0,12,0.54,62915,537085
800000,6,716045.0,12,0.54,83955,716045
1000000,6,894978.0,12,0.54,105022,894978
2,7,2.0,1,0.05,0,2
3,7,3.0,2,0.09,0,3
100,7,83.0,58,2.61,17,83
200,7,172.0,58,2.61,28,172
2000,7,1783.0,58,2.61,217,1783
10000,7,8969.0,58,2.61,1031,8969
20000,7,17923.0,58,2.61,2077,17923
40000,7,35934.0,58,2.61,4066,35934
60000,7,53869.0,58,2.61,6131,53869
80000,7,71751.0,58,2.61,8249,71751
100000,7,89659.0,58,2.61,10341,89659
200000,7,179368.0,58,2.61,20632,179368
400000,7,358284.0,58,2.61,41716,358284
600000,7,537035.0,58,2.61,62965,537035
800000,7,715974.0,58,2.61,84026,715974
1000000,7,894999.0,58,2.61,105001,894999
2,8,2.0,1,0.05,0,2
3,8,3.0,2,0.09,0,3
100,8,91.0,51,2.29,9,91
200,8,182.0,51,2.29,18,182
2000,8,1799.0,51,2.29,201,1799
10000,8,8965.0,51,2.29,1035,8965
20000,8,17915.0,51,2.29,2085,17915
40000,8,35877.0,51,2.29,4123,35877
60000,8,53835.0,51,2.29,6165,53835
80000,8,71649.0,51,2.29,8351,71649
100000,8,89580.0,51,2.29,10420,89580
200000,8,179134.0,51,2.29,20866,179134
400000,8,357998.0,51,2.29,42002,357998
600000,8,536910.0,51,2.29,63090,536910
800000,8,715872.0,51,2.29,84128,715872
1000000,8,894840.0,51,2.29,105160,894840
2,9,1.0,1,0.05,1,1
3,9,2.0,2,0.09,1,2
100,9,86.0,10,0.45,14,86
200,9,174.0,10,0.45,26,174
2000,9,1809.0,10,0.45,191,1809
10000,9,9012.0,10,0.45,988,9012
20000,9,17966.0,10,0.45,2034,17966
40000,9,35840.0,10,0.45,4160,35840
60000,9,53798.0,10,0.45,6202,53798
80000,9,71731.0,10,0.45,8269,71731
100000,9,89675.0,10,0.45,10325,89675
200000,9,179286.0,10,0.45,20714,179286
400000,9,358391.0,10,0.45,41609,358391
600000,9,537503.0,10,0.45,62497,537503
800000,9,716306.0,10,0.45,83694,716306
1000000,9,895611.0,10,0.45,104389,895611
2,10,2.0,1,0.05,0,2
3,10,2.0,2,0.09,1,2
100,10,85.0,10,0.45,15,85
200,10,172.0,10,0.45,28,172
2000,10,1808.0,10,0.45,192,1808
10000,10,8993.0,10,0.45,1007,8993
20000,10,17991.0,10,0.45,2009,17991
40000,10,35912.0,10,0.45,4088,35912
60000,10,53865.0,10,0.45,6135,53865
80000,10,71788.0,10,0.45,8212,71788
100000,10,89718.0,10,0.45,10282,89718
200000,10,179260.0,10,0.45,20740,179260
400000,10,358711.0,10,0.45,41289,358711
600000,10,537755.0,10,0.45,62245,537755
800000,10,716547.0,10,0.45,83453,716547
1000000,10,895730.0,10,0.45,104270,895730
2,11,1.0,1,0.05,1,1
3,11,2.0,2,0.09,1,2
100,11,85.0,19,0.86,15,85
200,11,179.0,19,0.86,21,179
2000,11,1791.0,19,0.86,209,1791
10000,11,8923.0,19,0.86,1077,8923
20000,11,17874.0,19,0.86,2126,17874
40000,11,35765.0,19,0.86,4235,35765
60000,11,53831.0,19,0.86,6169,53831
80000,11,71754.0,19,0.86,8246,71754
100000,11,89672.0,19,0.86,10328,89672
200000,11,179278.0,19,0.86,20722,179278
400000,11,358364.0,19,0.86,41636,358364
600000,11,537121.0,19,0.86,62879,537121
800000,11,715879.0,19,0.86,84121,715879
1000000,11,894697.0,19,0.86,105303,894697
2,12,2.0,1,0.05,0,2
3,12,3.0,2,0.09,0,3
100,12,86.0,12,0.54,14,86
200,12,176.0,12,0.54,24,176
2000,12,1789.0,12,0.54,211,1789
10000,12,8962.0,12,0.54,1038,8962
20000,12,17949.0,12,0.54,2051,17949
40000,12,35899.0,12,0.54,4101,35899
60000,12,53804.0,12,0.54,6196,53804
80000,12,71654.0,12,0.54,8346,71654
100000,12,89525.0,12,0.54,10475,89525
200000,12,178883.0,12,0.54,21117,178883
400000,12,357645.0,12,0.54,42355,357645
600000,12,536528.0,12,0.54,63472,536528
800000,12,715330.0,12,0.54,84670,715330
1000000,12,894278.0,12,0.54,105722,894278
2,13,2.0,1,0.05,0,2
3,13,3.0,2,0.09,0,3
100,13,83.0,90,4.05,17,83
200,13,173.0,190,8.55,27,173
2000,13,1675.0,1990,89.55,325,1675
10000,13,8490.0,9990,449.55,1510,8490
20000,13,17056.0,19990,899.55,2944,17056
40000,13,34057.0,39990,1799.55,5943,34057
60000,13,51026.0,59990,2699.55,8974,51026
80000,13,68049.0,79990,3599.55,11951,68049
100000,13,85094.0,99990,4499.55,14906,85094
200000,13,169869.0,199990,8999.55,30131,169869
400000,13,339970.0,399990,17999.55,60030,339970
600000,13,509879.0,599990,26999.55,90121,509879
800000,13,679925.0,799990,35999.55,120075,679925
1000000,13,849857.0,999990,44999.55,150143,849857
2,14,1.0,1,0.05,1,1
3,14,2.0,2,0.09,1,2
100,14,87.0,10,0.45,13,87
200,14,176.0,10,0.45,24,176
2000,14,1812.0,10,0.45,188,1812
10000,14,8979.0,10,0.45,1021,8979
20000,14,17934.0,10,0.45,2066,17934
40000,14,35792.0,10,0.45,4208,35792
60000,14,53729.0,10,0.45,6271,53729
80000,14,71618.0,10,0.45,8382,71618
100000,14,89488.0,10,0.45,10512,89488
200000,14,179033.0,10,0.45,20967,179033
400000,14,358059.0,10,0.45,41941,358059
600000,14,537009.0,10,0.45,62991,537009
800000,14,716096.0,10,0.45,83904,716096
1000000,14,895215.0,10,0.45,104785,895215
2,15,1.0,1,0.05,1,1
3,15,2.0,2,0.09,1,2
100,15,89.0,90,4.05,11,89
200,15,176.0,190,8.55,24,176
2000,15,1718.0,1990,89.55,282,1718
10000,15,8510.0,9990,449.55,1490,8510
20000,15,17065.0,19990,899.55,2935,17065
40000,15,34112.0,39990,1799.55,5888,34112
60000,15,51168.0,59990,2699.55,8832,51168
80000,15,68093.0,79990,3599.55,11907,68093
100000,15,85085.0,99990,4499.55,14915,85085
200000,15,170140.0,199990,8999.55,29860,170140
400000,15,340293.0,399990,17999.55,59707,340293
600000,15,510210.0,599990,26999.55,89790,510210
800000,15,680136.0,799990,35999.55,119864,680136
1000000,15,850116.0,999990,44999.55,149884,850116
2,16,2.0,1,0.05,0,2
3,16,3.0,2,0.09,0,3
100,16,86.0,90,4.05,14,86
200,16,171.0,190,8.55,29,171
2000,16,1696.0,1990,89.55,304,1696
10000,16,8532.0,9990,449.55,1468,8532
20000,16,16991.0,19990,899.55,3009,16991
40000,16,34006.0,39990,1799.55,5994,34006
60000,16,51094.0,59990,2699.55,8906,51094
80000,16,68115.0,79990,3599.55,11885,68115
100000,16,84985.0,99990,4499.55,15015,84985
200000,16,170017.0,199990,8999.55,29983,170017
400000,16,340030.0,399990,17999.55,59970,340030
600000,16,509825.0,599990,26999.55,90175,509825
800000,16,679993.0,799990,35999.55,120007,679993
1000000,16,849944.0,999990,44999.55,150056,849944
2,17,2.0,1,0.05,0,2
3,17,3.0,2,0.09,0,3
100,17,87.0,10,0.45,13,87
200,17,172.0,10,0.45,28,172
2000,17,1794.0,10,0.45,206,1794
10000,17,9005.0,10,0.45,995,9005
20000,17,17970.0,10,0.45,2030,17970
40000,17,35872.0,10,0.45,4128,35872
60000,17,53720.0,10,0.45,6280,53720
80000,17,71605.0,10,0.45,8395,71605
100000,17,89530.0,10,0.45,10470,89530
200000,17,179126.0,10,0.45,20874,179126
400000,17,358034.0,10,0.45,41966,358034
600000,17,536976.0,10,0.45,63024,536976
800000,17,715831.0,10,0.45,84169,715831
1000000,17,895020.0,10,0.45,104980,895020
2,18,2.0,1,0.05,0,2
3,18,3.0,2,0.09,0,3
100,18,92.0,10,0.45,8,92
200,18,179.0,10,0.45,21,179
2000,18,1777.0,10,0.45,223,1777
10000,18,8958.0,10,0.45,1042,8958
20000,18,17942.0,10,0.45,2058,17942
40000,18,35825.0,10,0.45,4175,35825
60000,18,53782.0,10,0.45,6218,53782
80000,18,71658.0,10,0.45,8342,71658
100000,18,89546.0,10,0.45,10454,89546
200000,18,179027.0,10,0.45,20973,179027
400000,18,357826.0,10,0.45,42174,357826
600000,18,536968.0,10,0.45,63032,536968
800000,18,715994.0,10,0.45,84006,715994
1000000,18,895053.0,10,0.45,104947,895053
2,19,2.0,1,0.05,0,2
3,19,2.0,2,0.09,1,2
100,19,91.0,10,0.45,9,91
200,19,181.0,10,0.45,19,181
2000,19,1809.0,10,0.45,191,1809
10000,19,8978.0,10,0.45,1022,8978
20000,19,17970.0,10,0.45,2030,17970
40000,19,35810.0,10,0.45,4190,35810
60000,19,53704.0,10,0.45,6296,53704
80000,19,71637.0,10,0.45,8363,71637
100000,19,89533.0,10,0.45,10467,89533
200000,19,179012.0,10,0.45,20988,179012
400000,19,358183.0,10,0.45,41817,358183
600000,19,537099.0,10,0.45,62901,537099
800000,19,716247.0,10,0.45,83753,716247
1000000,19,895246.0,10,0.45,104754,895246
2,20,2.0,1,0.05,0,2
3,20,3.0,2,0.09,0,3
100,20,85.0,90,4.05,15,85
200,20,170.0,190,8.55,30,170
2000,20,1719.0,1990,89.55,281,1719
10000,20,8529.0,9990,449.55,1471,8529
20000,20,17027.0,19990,899.55,2973,17027
40000,20,34037.0,39990,1799.55,5963,34037
60000,20,50922.0,59990,2699.55,9078,50922
80000,20,67850.0,79990,3599.55,12150,67850
100000,20,84829.0,99990,4499.55,15171,84829
200000,20,169874.0,199990,8999.55,30126,169874
400000,20,340019.0,399990,17999.55,59981,340019
600000,20,509941.0,599990,26999.55,90059,509941
800000,20,680114.0,799990,35999.55,119886,680114
1000000,20,850269.0,999990,44999.55,149731,850269
2,21,2.0,1,0.05,0,2
3,21,3.0,2,0.09,0,3
100,21,94.0,14,0.63,6,94
200,21,186.0,14,0.63,14,186
2000,21,1803.0,14,0.63,197,1803
10000,21,8915.0,14,0.63,1085,8915
20000,21,17880.0,14,0.63,2120,17880
40000,21,35732.0,14,0.63,4268,35732
60000,21,53660.0,14,0.63,6340,53660
80000,21,71606.0,14,0.63,8394,71606
100000,21,89492.0,14,0.63,10508,89492
200000,21,178976.0,14,0.63,21024,178976
400000,21,357927.0,14,0.63,42073,357927
600000,21,537192.0,14,0.63,62808,537192
800000,21,715958.0,14,0.63,84042,715958
1000000,21,894977.0,14,0.63,105023,894977
2,22,1.0,1,0.05,1,1
3,22,2.0,2,0.09,1,2
100,22,84.0,90,4.05,16,84
200,22,162.0,190,8.55,38,162
2000,22,1673.0,1990,89.55,327,1673
10000,22,8503.0,9990,449.55,1497,8503
20000,22,17018.0,19990,899.55,2982,17018
40000,22,33893.0,39990,1799.55,6107,33893
60000,22,50905.0,59990,2699.55,9095,50905
80000,22,67828.0,79990,3599.55,12172,67828
100000,22,84822.0,99990,4499.55,15178,84822
200000,22,169781.0,199990,8999.55,30219,169781
400000,22,339940.0,399990,17999.55,60060,339940
600000,22,509870.0,599990,26999.55,90130,509870
800000,22,680069.0,799990,35999.55,119931,680069
1000000,22,850081.0,999990,44999.55,149919,850081
2,23,2.0,1,0.05,0,2
3,23,3.0,2,0.09,0,3
100,23,92.0,20,0.9,8,92
200,23,182.0,20,0.9,18,182
2000,23,1771.0,20,0.9,229,1771
10000,23,8934.0,20,0.9,1066,8934
20000,23,17892.0,20,0.9,2108,17892
40000,23,35847.0,20,0.9,4153,35847
60000,23,53669.0,20,0.9,6331,53669
80000,23,71578.0,20,0.9,8422,71578
100000,23,89403.0,20,0.9,10597,89403
200000,23,178927.0,20,0.9,21073,178927
400000,23,358154.0,20,0.9,41846,358154
600000,23,537309.0,20,0.9,62691,537309
800000,23,716216.0,20,0.9,83784,716216
1000000,23,895321.0,20,0.9,104679,895321
2,24,1.0,1,0.05,1,1
3,24,2.0,2,0.09,1,2
100,24,84.0,78,3.51,16,84
200,24,166.0,178,8.01,34,166
2000,24,1682.0,1977,88.97,318,1682
10000,24,8490.0,9977,448.97,1510,8490
20000,24,16999.0,19977,898.96,3001,16999
40000,24,34040.0,39977,1798.97,5960,34040
60000,24,50977.0,59977,2698.97,9023,50977
80000,24,67957.0,79977,3598.97,12043,67957
100000,24,84909.0,99977,4498.97,15091,84909
200000,24,170153.0,199977,8998.97,29847,170153
400000,24,340243.0,399977,17998.96,59757,340243
600000,24,510114.0,599977,26998.96,89886,510114
800000,24,679932.0,799977,35998.96,120068,679932
1000000,24,850111.0,999977,44998.96,149889,850111
2,25,2.0,1,0.05,0,2
3,25,3.0,2,0.09,0,3
100,25,85.0,71,3.19,15,85
200,25,173.0,71,3.19,27,173
2000,25,1796.0,71,3.19,204,1796
10000,25,8965.0,71,3.19,1035,8965
20000,25,17870.0,71,3.19,2130,17870
40000,25,35758.0,71,3.19,4242,35758
60000,25,53664.0,71,3.19,6336,53664
80000,25,71622.0,71,3.19,8378,71622
100000,25,89502.0,71,3.19,10498,89502
200000,25,178924.0,71,3.19,21076,178924
400000,25,357879.0,71,3.19,42121,357879
600000,25,537000.0,71,3.19,63000,537000
800000,25,716286.0,71,3.19,83714,716286
1000000,25,895484.0,71,3.19,104516,895484
2,26,2.0,1,0.05,0,2
3,26,2.0,2,0.09,1,2
100,26,89.0,10,0.45,11,89
200,26,176.0,10,0.45,24,176
2000,26,1790.0,10,0.45,210,1790
10000,26,8956.0,10,0.45,1044,8956
20000,26,17905.0,10,0.45,2095,17905
40000,26,35828.0,10,0.45,4172,35828
60000,26,53691.0,10,0.45,6309,53691
80000,26,71609.0,10,0.45,8391,71609
100000,26,89536.0,10,0.45,10464,89536
200000,26,179074.0,10,0.45,20926,179074
400000,26,358025.0,10,0.45,41975,358025
600000,26,536901.0,10,0.45,63099,536901
800000,26,715850.0,10,0.45,84150,715850
1000000,26,894922.0,10,0.45,105078,894922
2,27,2.0,1,0.05,0,2
3,27,3.0,2,0.09,0,3
100,27,87.0,10,0.45,13,87
200,27,172.0,10,0.45,28,172
2000,27,1789.0,10,0.45,211,1789
10000,27,8936.0,10,0.45,1064,8936
20000,27,17850.0,10,0.45,2150,17850
40000,27,35716.0,10,0.45,4284,35716
60000,27,53633.0,10,0.45,6367,53633
80000,27,71503.0,10,0.45,8497,71503
100000,27,89395.0,10,0.45,10605,89395
200000,27,178968.0,10,0.45,21032,178968
400000,27,357904.0,10,0.45,42096,357904
600000,27,536919.0,10,0.45,63081,536919
800000,27,715849.0,10,0.45,84151,715849
1000000,27,894963.0,10,0.45,105037,894963
2,28,1.0,1,0.05,1,1
3,28,2.0,2,0.09,1,2
100,28,84.0,10,0.45,16,84
200,28,173.0,10,0.45,27,173
2000,28,1773.0,10,0.45,227,1773
10000,28,8914.0,10,0.45,1086,8914
20000,28,17846.0,10,0.45,2154,17846
40000,28,35743.0,10,0.45,4257,35743
60000,28,53666.0,10,0.45,6334,53666
80000,28,71538.0,10,0.45,8462,71538
100000,28,89467.0,10,0.45,10533,89467
200000,28,179037.0,10,0.45,20963,179037
400000,28,357916.0,10,0.45,42084,357916
600000,28,537274.0,10,0.45,62726,537274
800000,28,716052.0,10,0.45,83948,716052
1000000,28,895067.0,10,0.45,104933,895067
2,29,2.0,1,0.05,0,2
3,29,2.0,2,0.09,1,2
100,29,83.0,10,0.45,17,83
200,29,174.0,10,0.45,26,174
2000,29,1803.0,10,0.45,197,1803
10000,29,8990.0,10,0.45,1010,8990
20000,29,17953.0,10,0.45,2047,17953
40000,29,35839.0,10,0.45,4161,35839
60000,29,53647.0,10,0.45,6353,53647
80000,29,71539.0,10,0.45,8461,71539
100000,29,89421.0,10,0.45,10579,89421
200000,29,178907.0,10,0.45,21093,178907
400000,29,357891.0,10,0.45,42109,357891
600000,29,536830.0,10,0.45,63170,536830
800000,29,716065.0,10,0.45,83935,716065
1000000,29,894900.0,10,0.45,105100,894900
2,30,2.0,1,0.05,0,2
3,30,3.0,2,0.09,0,3
100,30,92.0,10,0.45,8,92
200,30,184.0,10,0.45,16,184
2000,30,1818.0,10,0.45,182,1818
10000,30,8960.0,25,1.13,1040,8960
20000,30,17947.0,25,1.13,2053,17947
40000,30,35792.0,25,1.13,4208,35792
60000,30,53718.0,25,1.13,6282,53718
80000,30,71600.0,25,1.13,8400,71600
100000,30,89571.0,25,1.13,10429,89571
200000,30,179072.0,25,1.13,20928,179072
400000,30,357871.0,25,1.13,42129,357871
600000,30,537244.0,25,1.13,62756,537244
800000,30,716318.0,25,1.13,83682,716318
1000000,30,895529.0,25,1.13,104471,895529
2,31,2.0,1,0.05,0,2
3,31,3.0,2,0.09,0,3
100,31,91.0,10,0.45,9,91
200,31,182.0,10,0.45,18,182
2000,31,1779.0,10,0.45,221,1779
10000,31,8937.0,10,0.45,1063,8937
20000,31,17835.0,10,0.45,2165,17835
40000,31,35735.0,10,0.45,4265,35735
60000,31,53584.0,10,0.45,6416,53584
80000,31,71463.0,10,0.45,8537,71463
100000,31,89442.0,10,0.45,10558,89442
200000,31,178905.0,10,0.45,21095,178905
400000,31,357890.0,10,0.45,42110,357890
600000,31,536757.0,10,0.45,63243,536757
800000,31,715805.0,10,0.45,84195,715805
1000000,31,894780.0,10,0.45,105220,894780
2,32,2.0,1,0.05,0,2
3,32,2.0,2,0.09,1,2
100,32,87.0,10,0.45,13,87
200,32,180.0,10,0.45,20,180
2000,32,1775.0,10,0.45,225,1775
10000,32,8932.0,10,0.45,1068,8932
20000,32,17896.0,10,0.45,2104,17896
40000,32,35816.0,10,0.45,4184,35816
60000,32,53701.0,10,0.45,6299,53701
80000,32,71596.0,10,0.45,8404,71596
100000,32,89429.0,10,0.45,10571,89429
200000,32,178894.0,10,0.45,21106,178894
400000,32,357697.0,10,0.45,42303,357697
600000,32,536759.0,10,0.45,63241,536759
800000,32,715895.0,10,0.45,84105,715895
1000000,32,894725.0,10,0.45,105275,894725
2,33,2.0,1,0.05,0,2
3,33,3.0,2,0.09,0,3
100,33,71.0,90,4.05,29,71
200,33,156.0,190,8.55,44,156
2000,33,1699.0,1990,89.55,301,1699
10000,33,8480.0,9990,449.55,1520,8480
20000,33,16979.0,19990,899.55,3021,16979
40000,33,34042.0,39990,1799.55,5958,34042
60000,33,51017.0,59990,2699.55,8983,51017
80000,33,68034.0,79990,3599.55,11966,68034
100000,33,85078.0,99990,4499.55,14922,85078
200000,33,170145.0,199990,8999.55,29855,170145
400000,33,340001.0,399990,17999.55,59999,340001
600000,33,510015.0,599990,26999.55,89985,510015
800000,33,680068.0,799990,35999.55,119932,680068
1000000,33,850002.0,999990,44999.55,149998,850002
2,34,2.0,1,0.05,0,2
3,34,3.0,2,0.09,0,3
100,34,86.0,37,1.66,14,86
200,34,171.0,137,6.16,29,171
2000,34,1702.0,1937,87.17,298,1702
10000,34,8520.0,9937,447.17,1480,8520
20000,34,16981.0,19937,897.16,3019,16981
40000,34,33926.0,39937,1797.17,6074,33926
60000,34,50933.0,59937,2697.17,9067,50933
80000,34,67975.0,79937,3597.17,12025,67975
100000,34,84984.0,99937,4497.17,15016,84984
200000,34,170066.0,199937,8997.17,29934,170066
400000,34,340112.0,399937,17997.16,59888,340112
600000,34,510038.0,599937,26997.16,89962,510038
800000,34,679856.0,799937,35997.16,120144,679856
1000000,34,849949.0,999937,44997.16,150051,849949
2,35,2.0,1,0.05,0,2
3,35,3.0,2,0.09,0,3
100,35,81.0,83,3.73,19,81
200,35,169.0,83,3.73,31,169
2000,35,1786.0,83,3.73,214,1786
10000,35,8954.0,83,3.73,1046,8954
20000,35,17933.0,83,3.73,2067,17933
40000,35,35832.0,83,3.73,4168,35832
60000,35,53814.0,83,3.73,6186,53814
80000,35,71693.0,83,3.73,8307,71693
100000,35,89618.0,83,3.73,10382,89618
200000,35,179114.0,83,3.73,20886,179114
400000,35,358003.0,83,3.73,41997,358003
600000,35,536997.0,83,3.73,63003,536997
800000,35,715963.0,83,3.73,84037,715963
1000000,35,895118.0,83,3.73,104882,895118
2,36,2.0,1,0.05,0,2
3,36,2.0,2,0.09,1,2
100,36,87.0,10,0.45,13,87
200,36,173.0,10,0.45,27,173
2000,36,1782.0,10,0.45,218,1782
10000,36,8912.0,10,0.45,1088,8912
20000,36,17886.0,10,0.45,2114,17886
40000,36,35811.0,10,0.45,4189,35811
60000,36,53686.0,10,0.45,6314,53686
80000,36,71529.0,10,0.45,8471,71529
100000,36,89402.0,10,0.45,10598,89402
200000,36,178916.0,10,0.45,21084,178916
400000,36,357892.0,10,0.45,42108,357892
600000,36,537016.0,10,0.45,62984,537016
800000,36,716033.0,10,0.45,83967,716033
1000000,36,895116.0,10,0.45,104884,895116
2,37,2.0,1,0.05,0,2
3,37,3.0,2,0.09,0,3
100,37,87.0,90,4.05,13,87
200,37,176.0,190,8.55,24,176
2000,37,1712.0,1990,89.55,288,1712
10000,37,8499.0,9990,449.55,1501,8499
20000,37,16987.0,19990,899.55,3013,16987
40000,37,33914.0,39990,1799.55,6086,33914
60000,37,50844.0,59990,2699.55,9156,50844
80000,37,67877.0,79990,3599.55,12123,67877
100000,37,84793.0,99990,4499.55,15207,84793
200000,37,169817.0,199990,8999.55,30183,169817
400000,37,339937.0,399990,17999.55,60063,339937
600000,37,509969.0,599990,26999.55,90031,509969
800000,37,679928.0,799990,35999.55,120072,679928
1000000,37,850087.0,999990,44999.55,149913,850087
2,38,2.0,1,0.05,0,2
3,38,3.0,2,0.09,0,3
100,38,90.0,90,4.05,10,90
200,38,173.0,190,8.55,27,173
2000,38,1715.0,1990,89.55,285,1715
10000,38,8539.0,9990,449.55,1461,8539
20000,38,17068.0,19990,899.55,2932,17068
40000,38,34097.0,39990,1799.55,5903,34097
60000,38,51063.0,59990,2699.55,8937,51063
80000,38,68028.0,79990,3599.55,11972,68028
100000,38,84935.0,99990,4499.55,15065,84935
200000,38,169858.0,199990,8999.55,30142,169858
400000,38,340062.0,399990,17999.55,59938,340062
600000,38,510047.0,599990,26999.55,89953,510047
800000,38,680195.0,799990,35999.55,119805,680195
1000000,38,850103.0,999990,44999.55,149897,850103
2,39,1.0,1,0.05,1,1
3,39,2.0,2,0.09,1,2
100,39,84.0,16,0.72,16,84
200,39,175.0,16,0.72,25,175
2000,39,1797.0,16,0.72,203,1797
10000,39,8933.0,16,0.72,1067,8933
20000,39,17891.0,16,0.72,2109,17891
40000,39,35773.0,16,0.72,4227,35773
60000,39,53664.0,16,0.72,6336,53664
80000,39,71533.0,16,0.72,8467,71533
100000,39,89422.0,16,0.72,10578,89422
200000,39,178979.0,16,0.72,21021,178979
400000,39,357942.0,16,0.72,42058,357942
600000,39,537056.0,16,0.72,62944,537056
800000,39,715997.0,16,0.72,84003,715997
1000000,39,895139.0,16,0.72,104861,895139
2,40,2.0,1,0.05,0,2
3,40,3.0,2,0.09,0,3
100,40,86.0,45,2.02,14,86
200,40,181.0,63,2.83,19,181
2000,40,1813.0,63,2.83,187,1813
10000,40,8939.0,63,2.83,1061,8939
20000,40,17876.0,63,2.83,2124,17876
40000,40,35787.0,63,2.83,4213,35787
60000,40,53688.0,63,2.83,6312,53688
80000,40,71541.0,63,2.83,8459,71541
100000,40,89362.0,63,2.83,10638,89362
200000,40,178882.0,63,2.83,21118,178882
400000,40,358030.0,63,2.83,41970,358030
600000,40,537095.0,63,2.83,62905,537095
800000,40,716132.0,63,2.83,83868,716132
1000000,40,895275.0,63,2.83,104725,895275
2,41,2.0,1,0.05,0,2
3,41,3.0,2,0.09,0,3
100,41,88.0,14,0.63,12,88
200,41,180.0,14,0.63,20,180
2000,41,1774.0,14,0.63,226,1774
10000,41,8905.0,14,0.63,1095,8905
20000,41,17864.0,14,0.63,2136,17864
40000,41,35682.0,14,0.63,4318,35682
60000,41,53557.0,14,0.63,6443,53557
80000,41,71424.0,14,0.63,8576,71424
100000,41,89314.0,14,0.63,10686,89314
200000,41,178738.0,14,0.63,21262,178738
400000,41,357707.0,14,0.63,42293,357707
600000,41,536804.0,14,0.63,63196,536804
800000,41,715677.0,14,0.63,84323,715677
1000000,41,894839.0,14,0.63,105161,894839
2,42,1.0,1,0.05,1,1
3,42,2.0,2,0.09,1,2
100,42,90.0,10,0.45,10,90
200,42,182.0,10,0.45,18,182
2000,42,1797.0,10,0.45,203,1797
10000,42,8967.0,10,0.45,1033,8967
20000,42,17937.0,10,0.45,2063,17937
40000,42,35829.0,10,0.45,4171,35829
60000,42,53678.0,10,0.45,6322,53678
80000,42,71531.0,10,0.45,8469,71531
100000,42,89385.0,10,0.45,10615,89385
200000,42,178991.0,10,0.45,21009,178991
400000,42,358023.0,10,0.45,41977,358023
600000,42,537113.0,10,0.45,62887,537113
800000,42,716219.0,10,0.45,83781,716219
1000000,42,895038.0,10,0.45,104962,895038
2,43,2.0,1,0.05,0,2
3,43,2.0,2,0.09,1,2
100,43,93.0,10,0.45,7,93
200,43,183.0,10,0.45,17,183
2000,43,1787.0,10,0.45,213,1787
10000,43,8980.0,10,0.45,1020,8980
20000,43,17933.0,10,0.45,2067,17933
40000,43,35782.0,10,0.45,4218,35782
60000,43,53697.0,10,0.45,6303,53697
80000,43,71616.0,10,0.45,8384,71616
100000,43,89510.0,10,0.45,10490,89510
200000,43,179018.0,10,0.45,20982,179018
400000,43,358300.0,10,0.45,41700,358300
600000,43,537186.0,10,0.45,62814,537186
800000,43,716403.0,10,0.45,83597,716403
1000000,43,895614.0,10,0.45,104386,895614
2,44,2.0,1,0.05,0,2
3,44,3.0,2,0.09,0,3
100,44,92.0,10,0.45,8,92
200,44,177.0,10,0.45,23,177
2000,44,1803.0,10,0.45,197,1803
10000,44,8946.0,10,0.45,1054,8946
20000,44,17881.0,10,0.45,2119,17881
40000,44,35770.0,10,0.45,4230,35770
60000,44,53657.0,10,0.45,6343,53657
80000,44,71534.0,10,0.45,8466,71534
100000,44,89490.0,10,0.45,10510,89490
200000,44,178930.0,10,0.45,21070,178930
400000,44,357946.0,10,0.45,42054,357946
600000,44,536735.0,10,0.45,63265,536735
800000,44,715734.0,10,0.45,84266,715734
1000000,44,894789.0,10,0.45,105211,894789
2,45,2.0,1,0.05,0,2
3,45,3.0,2,0.09,0,3
100,45,87.0,90,4.05,13,87
200,45,169.0,190,8.55,31,169
2000,45,1692.0,1990,89.55,308,1692
10000,45,8521.0,9990,449.55,1479,8521
20000,45,17028.0,19990,899.55,2972,17028
40000,45,34006.0,39990,1799.55,5994,34006
60000,45,51086.0,59990,2699.55,8914,51086
80000,45,68081.0,79990,3599.55,11919,68081
100000,45,85051.0,99990,4499.55,14949,85051
200000,45,170151.0,199990,8999.55,29849,170151
400000,45,340020.0,399990,17999.55,59980,340020
600000,45,510098.0,599990,26999.55,89902,510098
800000,45,680128.0,799990,35999.55,119872,680128
1000000,45,850168.0,999990,44999.55,149832,850168
2,46,2.0,1,0.05,0,2
3,46,3.0,2,0.09,0,3
100,46,86.0,19,0.86,14,86
200,46,178.0,19,0.86,22,178
2000,46,1801.0,19,0.86,199,1801
10000,46,8911.0,19,0.86,1089,8911
20000,46,17837.0,19,0.86,2163,17837
40000,46,35738.0,19,0.86,4262,35738
60000,46,53599.0,19,0.86,6401,53599
80000,46,71520.0,19,0.86,8480,71520
100000,46,89465.0,19,0.86,10535,89465
200000,46,178839.0,19,0.86,21161,178839
400000,46,357864.0,19,0.86,42136,357864
600000,46,536699.0,19,0.86,63301,536699
800000,46,715596.0,19,0.86,84404,715596
1000000,46,894516.0,19,0.86,105484,894516
2,47,2.0,1,0.05,0,2
3,47,2.0,2,0.09,1,2
100,47,86.0,10,0.45,14,86
200,47,173.0,10,0.45,27,173
2000,47,1780.0,10,0.45,220,1780
10000,47,8902.0,10,0.45,1098,8902
20000,47,17870.0,10,0.45,2130,17870
40000,47,35765.0,10,0.45,4235,35765
60000,47,53636.0,10,0.45,6364,53636
80000,47,71578.0,10,0.45,8422,71578
100000,47,89405.0,10,0.45,10595,89405
200000,47,178948.0,10,0.45,21052,178948
400000,47,357818.0,10,0.45,42182,357818
600000,47,536879.0,10,0.45,63121,536879
800000,47,715839.0,10,0.45,84161,715839
1000000,47,894923.0,10,0.45,105077,894923
2,48,2.0,1,0.05,0,2
3,48,3.0,2,0.09,0,3
100,48,90.0,69,3.1,10,90
200,48,173.0,164,7.38,27,173
2000,48,1683.0,1936,87.12,317,1683
10000,48,8477.0,9936,447.12,1523,8477
20000,48,16930.0,19936,897.12,3070,16930
40000,48,33928.0,39936,1797.12,6072,33928
60000,48,50974.0,59936,2697.12,9026,50974
80000,48,67901.0,79936,3597.12,12099,67901
100000,48,84940.0,99936,4497.12,15060,84940
200000,48,169907.0,199936,8997.12,30093,169907
400000,48,339838.0,399936,17997.12,60162,339838
600000,48,510009.0,599936,26997.12,89991,510009
800000,48,680152.0,799936,35997.12,119848,680152
1000000,48,850316.0,999936,44997.12,149684,850316
2,49,1.0,1,0.05,1,1
3,49,2.0,2,0.09,1,2
100,49,87.0,10,0.45,13,87
200,49,174.0,10,0.45,26,174
2000,49,1811.0,10,0.45,189,1811
10000,49,8961.0,10,0.45,1039,8961
20000,49,17872.0,10,0.45,2128,17872
40000,49,35766.0,10,0.45,4234,35766
60000,49,53696.0,10,0.45,6304,53696
80000,49,71626.0,10,0.45,8374,71626
100000,49,89567.0,10,0.45,10433,89567
200000,49,179059.0,10,0.45,20941,179059
400000,49,358128.0,10,0.45,41872,358128
600000,49,537133.0,10,0.45,62867,537133
800000,49,716239.0,10,0.45,83761,716239
1000000,49,894998.0,10,0.45,105002,894998
2,50,2.0,1,0.05,0,2
3,50,3.0,2,0.09,0,3
100,50,89.0,10,0.45,11,89
200,50,178.0,10,0.45,22,178
2000,50,1801.0,10,0.45,199,1801
10000,50,8993.0,10,0.45,1007,8993
20000,50,17939.0,10,0.45,2061,17939
40000,50,35844.0,10,0.45,4156,35844
60000,50,53655.0,10,0.45,6345,53655
80000,50,71484.0,10,0.45,8516,71484
100000,50,89399.0,10,0.45,10601,89399
200000,50,178767.0,10,0.45,21233,178767
400000,50,357826.0,10,0.45,42174,357826
600000,50,536541.0,10,0.45,63459,536541
800000,50,715262.0,10,0.45,84738,715262
1000000,50,894191.0,10,0.45,105809,894191
2,51,2.0,1,0.05,0,2
3,51,3.0,2,0.09,0,3
100,51,85.0,59,2.65,15,85
200,51,174.0,59,2.65,26,174
2000,51,1782.0,59,2.65,218,1782
10000,51,8930.0,59,2.65,1070,8930
20000,51,17895.0,59,2.65,2105,17895
40000,51,35760.0,59,2.65,4240,35760
60000,51,53648.0,59,2.65,6352,53648
80000,51,71519.0,59,2.65,8481,71519
100000,51,89357.0,59,2.65,10643,89357
200000,51,178842.0,59,2.65,21158,178842
400000,51,357906.0,59,2.65,42094,357906
600000,51,536986.0,59,2.65,63014,536986
800000,51,716049.0,59,2.65,83951,716049
1000000,51,895078.0,59,2.65,104922,895078
2,52,2.0,1,0.05,0,2
3,52,3.0,2,0.09,0,3
100,52,85.0,13,0.59,15,85
200,52,178.0,13,0.59,22,178
2000,52,1779.0,13,0.59,221,1779
10000,52,8931.0,13,0.59,1069,8931
20000,52,17876.0,13,0.59,2124,17876
40000,52,35798.0,13,0.59,4202,35798
60000,52,53665.0,13,0.59,6335,53665
80000,52,71523.0,13,0.59,8477,71523
100000,52,89374.0,13,0.59,10626,89374
200000,52,178842.0,13,0.59,21158,178842
400000,52,357869.0,13,0.59,42131,357869
600000,52,536705.0,13,0.59,63295,536705
800000,52,715718.0,13,0.59,84282,715718
1000000,52,894665.0,13,0.59,105335,894665
2,53,2.0,1,0.05,0,2
3,53,3.0,2,0.09,0,3
100,53,86.0,10,0.45,14,86
200,53,179.0,10,0.45,21,179
2000,53,1768.0,10,0.45,232,1768
10000,53,8889.0,10,0.45,1111,8889
20000,53,17926.0,10,0.45,2074,17926
40000,53,35933.0,10,0.45,4067,35933
60000,53,53832.0,10,0.45,6168,53832
80000,53,71737.0,10,0.45,8263,71737
100000,53,89651.0,10,0.45,10349,89651
200000,53,179018.0,10,0.45,20982,179018
400000,53,358279.0,10,0.45,41721,358279
600000,53,537210.0,10,0.45,62790,537210
800000,53,716176.0,10,0.45,83824,716176
1000000,53,895237.0,10,0.45,104763,895237
2,54,1.0,1,0.05,1,1
3,54,2.0,2,0.09,1,2
100,54,93.0,10,0.45,7,93
200,54,180.0,10,0.45,20,180
2000,54,1785.0,10,0.45,215,1785
10000,54,8978.0,10,0.45,1022,8978
20000,54,17949.0,10,0.45,2051,17949
40000,54,35903.0,10,0.45,4097,35903
60000,54,53763.0,10,0.45,6237,53763
80000,54,71661.0,10,0.45,8339,71661
100000,54,89530.0,10,0.45,10470,89530
200000,54,179133.0,10,0.45,20867,179133
400000,54,358072.0,10,0.45,41928,358072
600000,54,537155.0,10,0.45,62845,537155
800000,54,716307.0,10,0.45,83693,716307
1000000,54,895379.0,10,0.45,104621,895379
2,55,1.0,1,0.05,1,1
3,55,2.0,2,0.09,1,2
100,55,82.0,90,4.05,18,82
200,55,163.0,190,8.55,37,163
2000,55,1701.0,1990,89.55,299,1701
10000,55,8541.0,9990,449.55,1459,8541
20000,55,17072.0,19990,899.55,2928,17072
40000,55,34058.0,39990,1799.55,5942,34058
60000,55,51129.0,59990,2699.55,8871,51129
80000,55,68173.0,79990,3599.55,11827,68173
100000,55,85131.0,99990,4499.55,14869,85131
200000,55,170161.0,199990,8999.55,29839,170161
400000,55,340286.0,399990,17999.55,59714,340286
600000,55,510561.0,599990,26999.55,89439,510561
800000,55,680444.0,799990,35999.55,119556,680444
1000000,55,850157.0,999990,44999.55,149843,850157
2,56,2.0,1,0.05,0,2
3,56,3.0,2,0.09,0,3
100,56,90.0,10,0.45,10,90
200,56,176.0,10,0.45,24,176
2000,56,1786.0,10,0.45,214,1786
10000,56,8973.0,10,0.45,1027,8973
20000,56,17922.0,10,0.45,2078,17922
40000,56,35878.0,10,0.45,4122,35878
60000,56,53909.0,10,0.45,6091,53909
80000,56,71853.0,10,0.45,8147,71853
100000,56,89793.0,10,0.45,10207,89793
200000,56,179165.0,10,0.45,20835,179165
400000,56,358183.0,10,0.45,41817,358183
600000,56,537188.0,10,0.45,62812,537188
800000,56,716046.0,10,0.45,83954,716046
1000000,56,894992.0,10,0.45,105008,894992
2,57,1.0,1,0.05,1,1
3,57,2.0,2,0.09,1,2
100,57,83.0,90,4.05,17,83
200,57,172.0,190,8.55,28,172
2000,57,1722.0,1990,89.55,278,1722
10000,57,8525.0,9990,449.55,1475,8525
20000,57,17114.0,19990,899.55,2886,17114
40000,57,34178.0,39990,1799.55,5822,34178
60000,57,51097.0,59990,2699.55,8903,51097
80000,57,68116.0,79990,3599.55,11884,68116
100000,57,85173.0,99990,4499.55,14827,85173
200000,57,170205.0,199990,8999.55,29795,170205
400000,57,340091.0,399990,17999.55,59909,340091
600000,57,510025.0,599990,26999.55,89975,510025
800000,57,680173.0,799990,35999.55,119827,680173
1000000,57,850147.0,999990,44999.55,149853,850147
2,58,1.0,1,0.05,1,1
3,58,2.0,2,0.09,1,2
100,58,88.0,12,0.54,12,88
200,58,174.0,12,0.54,26,174
2000,58,1784.0,12,0.54,216,1784
10000,58,8958.0,12,0.54,1042,8958
20000,58,17926.0,12,0.54,2074,17926
40000,58,35796.0,12,0.54,4204,35796
60000,58,53683.0,12,0.54,6317,53683
80000,58,71551.0,12,0.54,8449,71551
100000,58,89468.0,12,0.54,10532,89468
200000,58,179100.0,12,0.54,20900,179100
400000,58,358319.0,12,0.54,41681,358319
600000,58,537414.0,12,0.54,62586,537414
800000,58,716183.0,12,0.54,83817,716183
1000000,58,895077.0,12,0.54,104923,895077
2,59,2.0,1,0.05,0,2
3,59,2.0,2,0.09,1,2
100,59,83.0,15,0.68,17,83
200,59,171.0,15,0.68,29,171
2000,59,1787.0,15,0.68,213,1787
10000,59,8942.0,15,0.68,1058,8942
20000,59,17902.0,15,0.68,2098,17902
40000,59,35801.0,15,0.68,4199,35801
60000,59,53732.0,15,0.68,6268,53732
80000,59,71606.0,15,0.68,8394,71606
100000,59,89455.0,15,0.68,10545,89455
200000,59,179141.0,15,0.68,20859,179141
400000,59,358171.0,15,0.68,41829,358171
600000,59,537123.0,15,0.68,62877,537123
800000,59,715984.0,15,0.68,84016,715984
1000000,59,894848.0,15,0.68,105152,894848
2,60,2.0,1,0.05,0,2
3,60,3.0,2,0.09,0,3
100,60,89.0,12,0.54,11,89
200,60,177.0,12,0.54,23,177
2000,60,1796.0,12,0.54,204,1796
10000,60,8910.0,12,0.54,1090,8910
20000,60,17837.0,12,0.54,2163,17837
40000,60,35834.0,12,0.54,4166,35834
60000,60,53768.0,12,0.54,6232,53768
80000,60,71685.0,12,0.54,8315,71685
100000,60,89560.0,12,0.54,10440,89560
200000,60,179041.0,12,0.54,20959,179041
400000,60,358068.0,12,0.54,41932,358068
600000,60,536939.0,12,0.54,63061,536939
800000,60,715665.0,12,0.54,84335,715665
1000000,60,894457.0,12,0.54,105543,894457
2,61,2.0,1,0.05,0,2
3,61,2.0,2,0.09,1,2
100,61,91.0,10,0.45,9,91
200,61,180.0,10,0.45,20,180
2000,61,1799.0,10,0.45,201,1799
10000,61,8919.0,10,0.45,1081,8919
20000,61,17847.0,10,0.45,2153,17847
40000,61,35764.0,10,0.45,4236,35764
60000,61,53766.0,10,0.45,6234,53766
80000,61,71645.0,10,0.45,8355,71645
100000,61,89564.0,10,0.45,10436,89564
200000,61,179067.0,10,0.45,20933,179067
400000,61,357921.0,10,0.45,42079,357921
600000,61,537038.0,10,0.45,62962,537038
800000,61,715923.0,10,0.45,84077,715923
1000000,61,894921.0,10,0.45,105079,894921
2,62,2.0,1,0.05,0,2
3,62,3.0,2,0.09,0,3
100,62,87.0,18,0.81,13,87
200,62,177.0,18,0.81,23,177
2000,62,1790.0,18,0.81,210,1790
10000,62,8919.0,18,0.81,1081,8919
20000,62,17862.0,18,0.81,2138,17862
40000,62,35775.0,18,0.81,4225,35775
60000,62,53604.0,18,0.81,6396,53604
80000,62,71562.0,18,0.81,8438,71562
100000,62,89512.0,18,0.81,10488,89512
200000,62,179003.0,18,0.81,20997,179003
400000,62,357686.0,18,0.81,42314,357686
600000,62,536717.0,18,0.81,63283,536717
800000,62,715635.0,18,0.81,84365,715635
1000000,62,894569.0,18,0.81,105431,894569
2,63,2.0,1,0.05,0,2
3,63,2.0,2,0.09,1,2
100,63,90.0,10,0.45,10,90
200,63,184.0,10,0.45,16,184
2000,63,1799.0,10,0.45,201,1799
10000,63,8995.0,10,0.45,1005,8995
20000,63,17886.0,10,0.45,2114,17886
40000,63,35713.0,10,0.45,4287,35713
60000,63,53665.0,10,0.45,6335,53665
80000,63,71565.0,10,0.45,8435,71565
100000,63,89410.0,10,0.45,10590,89410
200000,63,178934.0,10,0.45,21066,178934
400000,63,358083.0,10,0.45,41917,358083
600000,63,536895.0,10,0.45,63105,536895
800000,63,716210.0,10,0.45,83790,716210
1000000,63,895395.0,10,0.45,104605,895395
2,64,2.0,1,0.05,0,2
3,64,3.0,2,0.09,0,3
100,64,85.0,90,4.05,15,85
200,64,174.0,190,8.55,26,174
2000,64,1710.0,1990,89.55,290,1710
10000,64,8535.0,9990,449.55,1465,8535
20000,64,17012.0,19990,899.55,2988,17012
40000,64,33995.0,39990,1799.55,6005,33995
60000,64,51033.0,59990,2699.55,8967,51033
80000,64,68088.0,79990,3599.55,11912,68088
100000,64,85039.0,99990,4499.55,14961,85039
200000,64,169967.0,199990,8999.55,30033,169967
400000,64,339956.0,399990,17999.55,60044,339956
600000,64,509894.0,599990,26999.55,90106,509894
800000,64,680091.0,799990,35999.55,119909,680091
1000000,64,850215.0,999990,44999.55,149785,850215
2,65,2.0,1,0.05,0,2
3,65,3.0,2,0.09,0,3
100,65,88.0,28,1.26,12,88
200,65,172.0,28,1.26,28,172
2000,65,1794.0,28,1.26,206,1794
10000,65,8973.0,28,1.26,1027,8973
20000,65,17971.0,28,1.26,2029,17971
40000,65,35856.0,28,1.26,4144,35856
60000,65,53826.0,28,1.26,6174,53826
80000,65,71776.0,28,1.26,8224,71776
100000,65,89692.0,28,1.26,10308,89692
200000,65,179073.0,28,1.26,20927,179073
400000,65,358129.0,28,1.26,41871,358129
600000,65,536974.0,28,1.26,63026,536974
800000,65,716116.0,28,1.26,83884,716116
1000000,65,895189.0,28,1.26,104811,895189
2,66,2.0,1,0.05,0,2
3,66,3.0,2,0.09,0,3
100,66,92.0,90,4.05,8,92
200,66,179.0,187,8.41,21,179
2000,66,1729.0,1987,89.42,271,1729
10000,66,8559.0,9987,449.42,1441,8559
20000,66,17044.0,19987,899.41,2956,17044
40000,66,34037.0,39987,1799.42,5963,34037
60000,66,51093.0,59987,2699.42,8907,51093
80000,66,68109.0,79987,3599.42,11891,68109
100000,66,85051.0,99987,4499.42,14949,85051
200000,66,170071.0,199987,8999.42,29929,170071
400000,66,340081.0,399987,17999.41,59919,340081
600000,66,510288.0,599987,26999.41,89712,510288
800000,66,680263.0,799987,35999.41,119737,680263
1000000,66,850425.0,999987,44999.41,149575,850425
2,67,2.0,1,0.05,0,2
3,67,3.0,2,0.09,0,3
100,67,85.0,10,0.45,15,85
200,67,173.0,10,0.45,27,173
2000,67,1779.0,10,0.45,221,1779
10000,67,8957.0,10,0.45,1043,8957
20000,67,17936.0,10,0.45,2064,17936
40000,67,35742.0,10,0.45,4258,35742
60000,67,53625.0,10,0.45,6375,53625
80000,67,71510.0,10,0.45,8490,71510
100000,67,89327.0,10,0.45,10673,89327
200000,67,178870.0,10,0.45,21130,178870
400000,67,357777.0,10,0.45,42223,357777
600000,67,536753.0,10,0.45,63247,536753
800000,67,715906.0,10,0.45,84094,715906
1000000,67,894961.0,10,0.45,105039,894961
2,68,1.0,1,0.05,1,1
3,68,2.0,2,0.09,1,2
100,68,88.0,10,0.45,12,88
200,68,177.0,10,0.45,23,177
2000,68,1793.0,10,0.45,207,1793
10000,68,8917.0,10,0.45,1083,8917
20000,68,17786.0,10,0.45,2214,17786
40000,68,35674.0,10,0.45,4326,35674
60000,68,53526.0,10,0.45,6474,53526
80000,68,71453.0,10,0.45,8547,71453
100000,68,89279.0,10,0.45,10721,89279
200000,68,178751.0,10,0.45,21249,178751
400000,68,357704.0,10,0.45,42296,357704
600000,68,536762.0,10,0.45,63238,536762
800000,68,715923.0,10,0.45,84077,715923
1000000,68,895124.0,10,0.45,104876,895124
2,69,2.0,1,0.05,0,2
3,69,2.0,2,0.09,1,2
100,69,91.0,10,0.45,9,91
200,69,182.0,10,0.45,18,182
2000,69,1783.0,10,0.45,217,1783
10000,69,8985.0,10,0.45,1015,8985
20000,69,17908.0,10,0.45,2092,17908
40000,69,35850.0,10,0.45,4150,35850
60000,69,53774.0,10,0.45,6226,53774
80000,69,71708.0,10,0.45,8292,71708
100000,69,89663.0,10,0.45,10337,89663
200000,69,178961.0,10,0.45,21039,178961
400000,69,357853.0,10,0.45,42147,357853
600000,69,536859.0,10,0.45,63141,536859
800000,69,715941.0,10,0.45,84059,715941
1000000,69,894889.0,10,0.45,105111,894889
2,70,2.0,1,0.05,0,2
3,70,3.0,2,0.09,0,3
100,70,94.0,63,2.83,6,94
200,70,179.0,150,6.75,21,179
2000,70,1763.0,188,8.46,237,1763
10000,70,8925.0,188,8.46,1075,8925
20000,70,17812.0,188,8.46,2188,17812
40000,70,35654.0,188,8.46,4346,35654
60000,70,53649.0,188,8.46,6351,53649
80000,70,71591.0,188,8.46,8409,71591
100000,70,89442.0,188,8.46,10558,89442
200000,70,178990.0,188,8.46,21010,178990
400000,70,357910.0,188,8.46,42090,357910
600000,70,536919.0,188,8.46,63081,536919
800000,70,715979.0,188,8.46,84021,715979
1000000,70,894869.0,188,8.46,105131,894869
2,71,2.0,1,0.05,0,2
3,71,3.0,2,0.09,0,3
100,71,90.0,90,4.05,10,90
200,71,177.0,190,8.55,23,177
2000,71,1711.0,1990,89.55,289,1711
10000,71,8532.0,9990,449.55,1468,8532
20000,71,17022.0,19990,899.55,2978,17022
40000,71,33927.0,39990,1799.55,6073,33927
60000,71,50887.0,59990,2699.55,9113,50887
80000,71,67868.0,79990,3599.55,12132,67868
100000,71,84826.0,99990,4499.55,15174,84826
200000,71,170061.0,199990,8999.55,29939,170061
400000,71,340027.0,399990,17999.55,59973,340027
600000,71,510259.0,599990,26999.55,89741,510259
800000,71,680473.0,799990,35999.55,119527,680473
1000000,71,850405.0,999990,44999.55,149595,850405
2,72,2.0,1,0.05,0,2
3,72,3.0,2,0.09,0,3
100,72,80.0,90,4.05,20,80
200,72,167.0,190,8.55,33,167
2000,72,1697.0,1990,89.55,303,1697
10000,72,8546.0,9990,449.55,1454,8546
20000,72,17021.0,19990,899.55,2979,17021
40000,72,33958.0,39990,1799.55,6042,33958
60000,72,51008.0,59990,2699.55,8992,51008
80000,72,67943.0,79990,3599.55,12057,67943
100000,72,85035.0,99990,4499.55,14965,85035
200000,72,169822.0,199990,8999.55,30178,169822
400000,72,339624.0,399990,17999.55,60376,339624
600000,72,509495.0,599990,26999.55,90505,509495
800000,72,679668.0,799990,35999.55,120332,679668
1000000,72,849284.0,999990,44999.55,150716,849284
2,73,1.0,1,0.05,1,1
3,73,2.0,2,0.09,1,2
100,73,81.0,10,0.45,19,81
200,73,173.0,10,0.45,27,173
2000,73,1773.0,10,0.45,227,1773
10000,73,8922.0,10,0.45,1078,8922
20000,73,17863.0,10,0.45,2137,17863
40000,73,35706.0,10,0.45,4294,35706
60000,73,53574.0,10,0.45,6426,53574
80000,73,71509.0,10,0.45,8491,71509
100000,73,89378.0,10,0.45,10622,89378
200000,73,178889.0,10,0.45,21111,178889
400000,73,358016.0,10,0.45,41984,358016
600000,73,536900.0,10,0.45,63100,536900
800000,73,715945.0,10,0.45,84055,715945
1000000,73,894865.0,10,0.45,105135,894865
2,74,2.0,1,0.05,0,2
3,74,3.0,2,0.09,0,3
100,74,91.0,90,4.05,9,91
200,74,177.0,190,8.55,23,177
2000,74,1670.0,1990,89.55,330,1670
10000,74,8451.0,9990,449.55,1549,8451
20000,74,16949.0,19990,899.55,3051,16949
40000,74,33905.0,39990,1799.55,6095,33905
60000,74,50989.0,59990,2699.55,9011,50989
80000,74,67959.0,79990,3599.55,12041,67959
100000,74,84967.0,99990,4499.55,15033,84967
200000,74,169963.0,199990,8999.55,30037,169963
400000,74,340000.0,399990,17999.55,60000,340000
600000,74,510070.0,599990,26999.55,89930,510070
800000,74,680424.0,799990,35999.55,119576,680424
1000000,74,850354.0,999990,44999.55,149646,850354
2,75,1.0,1,0.05,1,1
3,75,2.0,2,0.09,1,2
100,75,91.0,10,0.45,9,91
200,75,180.0,10,0.45,20,180
2000,75,1788.0,10,0.45,212,1788
10000,75,8977.0,10,0.45,1023,8977
20000,75,17902.0,10,0.45,2098,17902
40000,75,35780.0,10,0.45,4220,35780
60000,75,53683.0,10,0.45,6317,53683
80000,75,71674.0,10,0.45,8326,71674
100000,75,89577.0,10,0.45,10423,89577
200000,75,179037.0,10,0.45,20963,179037
400000,75,358264.0,10,0.45,41736,358264
600000,75,537311.0,10,0.45,62689,537311
800000,75,716300.0,10,0.45,83700,716300
1000000,75,895459.0,10,0.45,104541,895459
2,76,2.0,1,0.05,0,2
3,76,3.0,2,0.09,0,3
100,76,84.0,90,4.05,16,84
200,76,171.0,190,8.55,29,171
2000,76,1670.0,1990,89.55,330,1670
10000,76,8504.0,9990,449.55,1496,8504
20000,76,17052.0,19990,899.55,2948,17052
40000,76,33967.0,39990,1799.55,6033,33967
60000,76,50986.0,59990,2699.55,9014,50986
80000,76,67951.0,79990,3599.55,12049,67951
100000,76,84969.0,99990,4499.55,15031,84969
200000,76,169841.0,199990,8999.55,30159,169841
400000,76,339642.0,399990,17999.55,60358,339642
600000,76,509399.0,599990,26999.55,90601,509399
800000,76,679503.0,799990,35999.55,120497,679503
1000000,76,849780.0,999990,44999.55,150220,849780
2,77,2.0,1,0.05,0,2
3,77,3.0,2,0.09,0,3
100,77,91.0,10,0.45,9,91
200,77,187.0,10,0.45,13,187
2000,77,1794.0,10,0.45,206,1794
10000,77,8951.0,10,0.45,1049,8951
20000,77,17898.0,10,0.45,2102,17898
40000,77,35748.0,10,0.45,4252,35748
60000,77,53620.0,10,0.45,6380,53620
80000,77,71533.0,10,0.45,8467,71533
100000,77,89399.0,10,0.45,10601,89399
200000,77,178874.0,10,0.45,21126,178874
400000,77,358000.0,10,0.45,42000,358000
600000,77,536803.0,10,0.45,63197,536803
800000,77,715921.0,10,0.45,84079,715921
1000000,77,894730.0,10,0.45,105270,894730
2,78,2.0,1,0.05,0,2
3,78,3.0,2,0.09,0,3
100,78,89.0,86,3.87,11,89
200,78,171.0,185,8.32,29,171
2000,78,1732.0,1982,89.19,268,1732
10000,78,8590.0,9982,449.19,1410,8590
20000,78,17123.0,19982,899.19,2877,17123
40000,78,34103.0,39982,1799.19,5897,34103
60000,78,51069.0,59982,2699.19,8931,51069
80000,78,68057.0,79982,3599.19,11943,68057
100000,78,85120.0,99982,4499.19,14880,85120
200000,78,170156.0,199982,8999.19,29844,170156
400000,78,340093.0,399982,17999.19,59907,340093
600000,78,510275.0,599982,26999.19,89725,510275
800000,78,680245.0,799982,35999.19,119755,680245
1000000,78,850156.0,999982,44999.19,149844,850156
2,79,2.0,1,0.05,0,2
3,79,3.0,2,0.09,0,3
100,79,88.0,70,3.15,12,88
200,79,177.0,170,7.65,23,177
2000,79,1770.0,266,11.97,230,1770
10000,79,8964.0,266,11.97,1036,8964
20000,79,17903.0,266,11.97,2097,17903
40000,79,35848.0,266,11.97,4152,35848
60000,79,53684.0,266,11.97,6316,53684
80000,79,71659.0,266,11.97,8341,71659
100000,79,89541.0,266,11.97,10459,89541
200000,79,178971.0,266,11.97,21029,178971
400000,79,358111.0,266,11.97,41889,358111
600000,79,537242.0,266,11.97,62758,537242
800000,79,715973.0,266,11.97,84027,715973
1000000,79,895142.0,266,11.97,104858,895142
2,80,2.0,1,0.05,0,2
3,80,3.0,2,0.09,0,3
100,80,89.0,11,0.5,11,89
200,80,179.0,11,0.5,21,179
2000,80,1795.0,11,0.5,205,1795
10000,80,8969.0,11,0.5,1031,8969
20000,80,17901.0,11,0.5,2099,17901
40000,80,35783.0,11,0.5,4217,35783
60000,80,53706.0,11,0.5,6294,53706
80000,80,71640.0,11,0.5,8360,71640
100000,80,89437.0,11,0.5,10563,89437
200000,80,178882.0,11,0.5,21118,178882
400000,80,358007.0,11,0.5,41993,358007
600000,80,537245.0,11,0.5,62755,537245
800000,80,716140.0,11,0.5,83860,716140
1000000,80,895170.0,11,0.5,104830,895170
2,81,2.0,1,0.05,0,2
3,81,2.0,2,0.09,1,2
100,81,86.0,44,1.98,14,86
200,81,170.0,46,2.07,30,170
2000,81,1686.0,1801,81.05,314,1686
10000,81,8464.0,9801,441.05,1536,8464
20000,81,16983.0,19801,891.04,3017,16983
40000,81,34016.0,39801,1791.05,5984,34016
60000,81,51073.0,59801,2691.05,8927,51073
80000,81,68121.0,79801,3591.05,11879,68121
100000,81,85097.0,99801,4491.05,14903,85097
200000,81,170114.0,199801,8991.05,29886,170114
400000,81,340287.0,399801,17991.04,59713,340287
600000,81,510417.0,599801,26991.04,89583,510417
800000,81,680400.0,799801,35991.04,119600,680400
1000000,81,850400.0,999801,44991.04,149600,850400
2,82,2.0,1,0.05,0,2
3,82,3.0,2,0.09,0,3
100,82,88.0,11,0.5,12,88
200,82,180.0,11,0.5,20,180
2000,82,1807.0,11,0.5,193,1807
10000,82,8993.0,11,0.5,1007,8993
20000,82,17978.0,11,0.5,2022,17978
40000,82,35931.0,11,0.5,4069,35931
60000,82,53852.0,11,0.5,6148,53852
80000,82,71762.0,11,0.5,8238,71762
100000,82,89667.0,11,0.5,10333,89667
200000,82,179216.0,11,0.5,20784,179216
400000,82,358197.0,11,0.5,41803,358197
600000,82,537127.0,11,0.5,62873,537127
800000,82,716396.0,11,0.5,83604,716396
1000000,82,895226.0,11,0.5,104774,895226
2,83,1.0,1,0.05,1,1
3,83,2.0,2,0.09,1,2
100,83,85.0,90,4.05,15,85
200,83,161.0,190,8.55,39,161
2000,83,1686.0,1990,89.55,314,1686
10000,83,8493.0,9990,449.55,1507,8493
20000,83,16972.0,19990,899.55,3028,16972
40000,83,34067.0,39990,1799.55,5933,34067
60000,83,51025.0,59990,2699.55,8975,51025
80000,83,68081.0,79990,3599.55,11919,68081
100000,83,85038.0,99990,4499.55,14962,85038
200000,83,170118.0,199990,8999.55,29882,170118
400000,83,340421.0,399990,17999.55,59579,340421
600000,83,510463.0,599990,26999.55,89537,510463
800000,83,680232.0,799990,35999.55,119768,680232
1000000,83,850111.0,999990,44999.55,149889,850111
2,84,1.0,1,0.05,1,1
3,84,2.0,2,0.09,1,2
100,84,87.0,90,4.05,13,87
200,84,168.0,190,8.55,32,168
2000,84,1692.0,1990,89.55,308,1692
10000,84,8449.0,9990,449.55,1551,8449
20000,84,16974.0,19990,899.55,3026,16974
40000,84,34036.0,39990,1799.55,5964,34036
60000,84,51101.0,59990,2699.55,8899,51101
80000,84,68095.0,79990,3599.55,11905,68095
100000,84,85017.0,99990,4499.55,14983,85017
200000,84,170072.0,199990,8999.55,29928,170072
400000,84,340179.0,399990,17999.55,59821,340179
600000,84,510144.0,599990,26999.55,89856,510144
800000,84,679977.0,799990,35999.55,120023,679977
1000000,84,850141.0,999990,44999.55,149859,850141
2,85,2.0,1,0.05,0,2
3,85,3.0,2,0.09,0,3
100,85,90.0,87,3.91,10,90
200,85,171.0,187,8.41,29,171
2000,85,1716.0,1408,63.36,284,1716
10000,85,8869.0,1408,63.36,1131,8869
20000,85,17847.0,1408,63.36,2153,17847
40000,85,35680.0,1408,63.36,4320,35680
60000,85,53577.0,1408,63.36,6423,53577
80000,85,71389.0,1408,63.36,8611,71389
100000,85,89317.0,1408,63.36,10683,89317
200000,85,178867.0,1408,63.36,21133,178867
400000,85,357850.0,1408,63.36,42150,357850
600000,85,536660.0,1408,63.36,63340,536660
800000,85,715510.0,1408,63.36,84490,715510
1000000,85,894529.0,1408,63.36,105471,894529
2,86,2.0,1,0.05,0,2
3,86,3.0,2,0.09,0,3
100,86,88.0,14,0.63,12,88
200,86,177.0,14,0.63,23,177
2000,86,1794.0,14,0.63,206,1794
10000,86,8980.0,14,0.63,1020,8980
20000,86,17948.0,14,0.63,2052,17948
40000,86,35845.0,14,0.63,4155,35845
60000,86,53755.0,14,0.63,6245,53755
80000,86,71620.0,14,0.63,8380,71620
100000,86,89522.0,14,0.63,10478,89522
200000,86,179095.0,14,0.63,20905,179095
400000,86,358060.0,14,0.63,41940,358060
600000,86,537042.0,14,0.63,62958,537042
800000,86,716001.0,14,0.63,83999,716001
1000000,86,895056.0,14,0.63,104944,895056
2,87,2.0,1,0.05,0,2
3,87,3.0,2,0.09,0,3
100,87,90.0,10,0.45,10,90
200,87,181.0,10,0.45,19,181
2000,87,1799.0,10,0.45,201,1799
10000,87,8879.0,10,0.45,1121,8879
20000,87,17816.0,10,0.45,2184,17816
40000,87,35760.0,10,0.45,4240,35760
60000,87,53685.0,10,0.45,6315,53685
80000,87,71535.0,10,0.45,8465,71535
100000,87,89480.0,10,0.45,10520,89480
200000,87,179002.0,10,0.45,20998,179002
400000,87,358185.0,10,0.45,41815,358185
600000,87,537365.0,10,0.45,62635,537365
800000,87,716533.0,10,0.45,83467,716533
1000000,87,895346.0,10,0.45,104654,895346
2,88,2.0,1,0.05,0,2
3,88,3.0,2,0.09,0,3
100,88,91.0,10,0.45,9,91
200,88,182.0,10,0.45,18,182
2000,88,1821.0,10,0.45,179,1821
10000,88,8972.0,10,0.45,1028,8972
20000,88,17953.0,10,0.45,2047,17953
40000,88,35907.0,10,0.45,4093,35907
60000,88,53791.0,10,0.45,6209,53791
80000,88,71709.0,10,0.45,8291,71709
100000,88,89605.0,10,0.45,10395,89605
200000,88,179138.0,10,0.45,20862,179138
400000,88,358190.0,10,0.45,41810,358190
600000,88,536996.0,10,0.45,63004,536996
800000,88,716164.0,10,0.45,83836,716164
1000000,88,895294.0,10,0.45,104706,895294
2,89,2.0,1,0.05,0,2
3,89,3.0,2,0.09,0,3
100,89,87.0,15,0.68,13,87
200,89,174.0,15,0.68,26,174
2000,89,1777.0,15,0.68,223,1777
10000,89,8980.0,15,0.68,1020,8980
20000,89,17940.0,15,0.68,2060,17940
40000,89,35941.0,15,0.68,4059,35941
60000,89,53848.0,15,0.68,6152,53848
80000,89,71775.0,15,0.68,8225,71775
100000,89,89637.0,15,0.68,10363,89637
200000,89,179141.0,15,0.68,20859,179141
400000,89,358202.0,15,0.68,41798,358202
600000,89,537153.0,15,0.68,62847,537153
800000,89,716143.0,15,0.68,83857,716143
1000000,89,895395.0,15,0.68,104605,895395
2,90,1.0,1,0.05,1,1
3,90,1.0,2,0.09,2,1
100,90,87.0,90,4.05,13,87
200,90,168.0,190,8.55,32,168
2000,90,1666.0,1990,89.55,334,1666
10000,90,8502.0,9990,449.55,1498,8502
20000,90,16955.0,19990,899.55,3045,16955
40000,90,33949.0,39990,1799.55,6051,33949
60000,90,50847.0,59990,2699.55,9153,50847
80000,90,67812.0,79990,3599.55,12188,67812
100000,90,84820.0,99990,4499.55,15180,84820
200000,90,169959.0,199990,8999.55,30041,169959
400000,90,339925.0,399990,17999.55,60075,339925
600000,90,510011.0,599990,26999.55,89989,510011
800000,90,680212.0,799990,35999.55,119788,680212
1000000,90,850166.0,999990,44999.55,149834,850166
2,91,0.0,1,0.05,2,0
3,91,1.0,2,0.09,2,1
100,91,90.0,19,0.86,10,90
200,91,175.0,19,0.86,25,175
2000,91,1785.0,19,0.86,215,1785
10000,91,8974.0,19,0.86,1026,8974
20000,91,17934.0,19,0.86,2066,17934
40000,91,35869.0,19,0.86,4131,35869
60000,91,53808.0,19,0.86,6192,53808
80000,91,71637.0,19,0.86,8363,71637
100000,91,89528.0,19,0.86,10472,89528
200000,91,178948.0,19,0.86,21052,178948
400000,91,357860.0,19,0.86,42140,357860
600000,91,537018.0,19,0.86,62982,537018
800000,91,715623.0,19,0.86,84377,715623
1000000,91,894708.0,19,0.86,105292,894708
2,92,2.0,1,0.05,0,2
3,92,3.0,2,0.09,0,3
100,92,86.0,10,0.45,14,86
200,92,179.0,10,0.45,21,179
2000,92,1783.0,10,0.45,217,1783
10000,92,8944.0,10,0.45,1056,8944
20000,92,17910.0,10,0.45,2090,17910
40000,92,35713.0,10,0.45,4287,35713
60000,92,53638.0,10,0.45,6362,53638
80000,92,71463.0,10,0.45,8537,71463
100000,92,89355.0,10,0.45,10645,89355
200000,92,178719.0,10,0.45,21281,178719
400000,92,357907.0,10,0.45,42093,357907
600000,92,536879.0,10,0.45,63121,536879
800000,92,715795.0,10,0.45,84205,715795
1000000,92,894648.0,10,0.45,105352,894648
2,93,2.0,1,0.05,0,2
3,93,3.0,2,0.09,0,3
100,93,90.0,12,0.54,10,90
200,93,179.0,12,0.54,21,179
2000,93,1803.0,12,0.54,197,1803
10000,93,8974.0,12,0.54,1026,8974
20000,93,17902.0,12,0.54,2098,17902
40000,93,35846.0,12,0.54,4154,35846
60000,93,53701.0,12,0.54,6299,53701
80000,93,71504.0,12,0.54,8496,71504
100000,93,89449.0,12,0.54,10551,89449
200000,93,179077.0,12,0.54,20923,179077
400000,93,358033.0,12,0.54,41967,358033
600000,93,536800.0,12,0.54,63200,536800
800000,93,715737.0,12,0.54,84263,715737
1000000,93,894915.0,12,0.54,105085,894915
2,94,2.0,1,0.05,0,2
3,94,3.0,2,0.09,0,3
100,94,85.0,85,3.82,15,85
200,94,169.0,185,8.32,31,169
2000,94,1705.0,1985,89.33,295,1705
10000,94,8593.0,9985,449.33,1407,8593
20000,94,17084.0,19985,899.32,2916,17084
40000,94,34131.0,39985,1799.33,5869,34131
60000,94,51168.0,59985,2699.33,8832,51168
80000,94,68150.0,79985,3599.33,11850,68150
100000,94,85139.0,99985,4499.33,14861,85139
200000,94,170005.0,199985,8999.33,29995,170005
400000,94,340034.0,399985,17999.32,59966,340034
600000,94,510193.0,599985,26999.32,89807,510193
800000,94,680350.0,799985,35999.32,119650,680350
1000000,94,850344.0,999985,44999.32,149656,850344
2,95,2.0,1,0.05,0,2
3,95,3.0,2,0.09,0,3
100,95,93.0,17,0.77,7,93
200,95,175.0,20,0.9,25,175
2000,95,1818.0,20,0.9,182,1818
10000,95,9001.0,20,0.9,999,9001
20000,95,17943.0,20,0.9,2057,17943
40000,95,35807.0,20,0.9,4193,35807
60000,95,53724.0,20,0.9,6276,53724
80000,95,71576.0,20,0.9,8424,71576
100000,95,89452.0,20,0.9,10548,89452
200000,95,179016.0,20,0.9,20984,179016
400000,95,358287.0,20,0.9,41713,358287
600000,95,537362.0,20,0.9,62638,537362
800000,95,716422.0,20,0.9,83578,716422
1000000,95,895364.0,20,0.9,104636,895364
2,96,1.0,1,0.05,1,1
3,96,2.0,2,0.09,1,2
100,96,89.0,10,0.45,11,89
200,96,178.0,10,0.45,22,178
2000,96,1814.0,10,0.45,186,1814
10000,96,8923.0,10,0.45,1077,8923
20000,96,17871.0,10,0.45,2129,17871
40000,96,35774.0,10,0.45,4226,35774
60000,96,53675.0,10,0.45,6325,53675
80000,96,71652.0,10,0.45,8348,71652
100000,96,89569.0,10,0.45,10431,89569
200000,96,179020.0,10,0.45,20980,179020
400000,96,358013.0,10,0.45,41987,358013
600000,96,536910.0,10,0.45,63090,536910
800000,96,716064.0,10,0.45,83936,716064
1000000,96,895062.0,10,0.45,104938,895062
2,97,2.0,1,0.05,0,2
3,97,3.0,2,0.09,0,3
100,97,87.0,10,0.45,13,87
200,97,177.0,10,0.45,23,177
2000,97,1783.0,10,0.45,217,1783
10000,97,8949.0,10,0.45,1051,8949
20000,97,17915.0,10,0.45,2085,17915
40000,97,35771.0,10,0.45,4229,35771
60000,97,53738.0,10,0.45,6262,53738
80000,97,71615.0,10,0.45,8385,71615
100000,97,89532.0,10,0.45,10468,89532
200000,97,179007.0,10,0.45,20993,179007
400000,97,357941.0,10,0.45,42059,357941
600000,97,536882.0,10,0.45,63118,536882
800000,97,716061.0,10,0.45,83939,716061
1000000,97,894867.0,10,0.45,105133,894867
2,98,2.0,1,0.05,0,2
3,98,3.0,2,0.09,0,3
100,98,83.0,11,0.5,17,83
200,98,169.0,11,0.5,31,169
2000,98,1787.0,11,0.5,213,1787
10000,98,8932.0,11,0.5,1068,8932
20000,98,17893.0,11,0.5,2107,17893
40000,98,35901.0,11,0.5,4099,35901
60000,98,53860.0,11,0.5,6140,53860
80000,98,71698.0,11,0.5,8302,71698
100000,98,89630.0,11,0.5,10370,89630
200000,98,179242.0,11,0.5,20758,179242
400000,98,358284.0,11,0.5,41716,358284
600000,98,537225.0,11,0.5,62775,537225
800000,98,716613.0,11,0.5,83387,716613
1000000,98,895872.0,11,0.5,104128,895872
2,99,2.0,1,0.05,0,2
3,99,3.0,2,0.09,0,3
100,99,86.0,13,0.59,14,86
200,99,176.0,13,0.59,24,176
2000,99,1777.0,13,0.59,223,1777
10000,99,8937.0,13,0.59,1063,8937
20000,99,17880.0,13,0.59,2120,17880
40000,99,35819.0,13,0.59,4181,35819
60000,99,53711.0,13,0.59,6289,53711
80000,99,71597.0,13,0.59,8403,71597
100000,99,89593.0,13,0.59,10407,89593
200000,99,179017.0,13,0.59,20983,179017
400000,99,358015.0,13,0.59,41985,358015
600000,99,537092.0,13,0.59,62908,537092
800000,99,716162.0,13,0.59,83838,716162
1000000,99,895225.0,13,0.59,104775,895225
2,100,2.0,1,0.05,0,2
3,100,3.0,2,0.09,0,3
100,100,92.0,10,0.45,8,92
200,100,179.0,10,0.45,21,179
2000,100,1798.0,10,0.45,202,1798
10000,100,8982.0,10,0.45,1018,8982
20000,100,17939.0,10,0.45,2061,17939
40000,100,35840.0,10,0.45,4160,35840
60000,100,53715.0,10,0.45,6285,53715
80000,100,71549.0,10,0.45,8451,71549
100000,100,89378.0,10,0.45,10622,89378
200000,100,179016.0,10,0.45,20984,179016
400000,100,357792.0,10,0.45,42208,357792
600000,100,536777.0,10,0.45,63223,536777
800000,100,715768.0,10,0.45,84232,715768
1000000,100,894776.0,10,0.45,105224,894776
