Timestep,Iteration,Total Reward,Suboptimal Arms,Total Regret,Zeros Count,Ones Count
2,1,2.0,2,0.1,0,2
3,1,2.0,3,0.15,1,2
100,1,85.0,100,5.0,15,85
200,1,166.0,200,10.0,34,166
2000,1,1709.0,1998,99.9,291,1709
10000,1,8500.0,9987,499.35,1500,8500
20000,1,17295.0,13882,694.1,2705,17295
40000,1,35333.0,13962,698.1,4667,35333
60000,1,53303.0,14029,701.45,6697,53303
80000,1,71232.0,14090,704.5,8768,71232
100000,1,89270.0,14154,707.7,10730,89270
200000,1,179250.0,14531,726.55,20750,179250
400000,1,359244.0,15253,762.65,40756,359244
600000,1,539127.0,15880,794.0,60873,539127
800000,1,719089.0,16585,829.25,80911,719089
1000000,1,899399.0,17259,862.95,100601,899399
2,2,1.0,2,0.1,1,1
3,2,2.0,3,0.15,1,2
100,2,91.0,6,0.3,9,91
200,2,184.0,13,0.65,16,184
2000,2,1808.0,22,1.1,192,1808
10000,2,9000.0,52,2.6,1000,9000
20000,2,18010.0,84,4.2,1990,18010
40000,2,35950.0,160,8.0,4050,35950
60000,2,53900.0,218,10.9,6100,53900
80000,2,71819.0,282,14.1,8181,71819
100000,2,89829.0,341,17.05,10171,89829
200000,2,179869.0,677,33.85,20131,179869
400000,2,359862.0,1373,68.65,40138,359862
600000,2,539771.0,2008,100.4,60229,539771
800000,2,719606.0,2642,132.1,80394,719606
1000000,2,899540.0,3319,165.95,100460,899540
2,3,2.0,2,0.1,0,2
3,3,3.0,3,0.15,0,3
100,3,84.0,100,5.0,16,84
200,3,167.0,200,10.0,33,167
2000,3,1756.0,417,20.85,244,1756
10000,3,8961.0,451,22.55,1039,8961
20000,3,18046.0,483,24.15,1954,18046
40000,3,36134.0,554,27.7,3866,36134
60000,3,54081.0,616,30.8,5919,54081
80000,3,72113.0,682,34.1,7887,72113
100000,3,90151.0,749,37.45,9849,90151
200000,3,180060.0,1085,54.25,19940,180060
400000,3,360044.0,1716,85.8,39956,360044
600000,3,539987.0,2348,117.4,60013,539987
800000,3,719791.0,3000,150.0,80209,719791
1000000,3,899786.0,3687,184.35,100214,899786
2,4,2.0,2,0.1,0,2
3,4,3.0,3,0.15,0,3
100,4,88.0,96,4.8,12,88
200,4,172.0,196,9.8,28,172
2000,4,1719.0,1995,99.75,281,1719
10000,4,8512.0,9975,498.75,1488,8512
20000,4,17010.0,19840,992.0,2990,17010
40000,4,34517.0,29046,1452.3,5483,34517
60000,4,52413.0,29117,1455.85,7587,52413
80000,4,70367.0,29184,1459.2,9633,70367
100000,4,88419.0,29250,1462.5,11581,88419
200000,4,178447.0,29574,1478.7,21553,178447
400000,4,358418.0,30203,1510.15,41582,358418
600000,4,538382.0,30824,1541.2,61618,538382
800000,4,718462.0,31522,1576.1,81538,718462
1000000,4,898493.0,32184,1609.2,101507,898493
2,5,2.0,2,0.1,0,2
3,5,3.0,3,0.15,0,3
100,5,86.0,100,5.0,14,86
200,5,175.0,200,10.0,25,175
2000,5,1757.0,793,39.65,243,1757
10000,5,8983.0,818,40.9,1017,8983
20000,5,17987.0,853,42.65,2013,17987
40000,5,36003.0,916,45.8,3997,36003
60000,5,54052.0,990,49.5,5948,54052
80000,5,72097.0,1048,52.4,7903,72097
100000,5,90031.0,1103,55.15,9969,90031
200000,5,179990.0,1414,70.7,20010,179990
400000,5,360113.0,2087,104.35,39887,360113
600000,5,539935.0,2764,138.2,60065,539935
800000,5,719591.0,3411,170.55,80409,719591
1000000,5,899673.0,4086,204.3,100327,899673
2,6,2.0,2,0.1,0,2
3,6,3.0,3,0.15,0,3
100,6,93.0,28,1.4,7,93
200,6,178.0,29,1.45,22,178
2000,6,1794.0,35,1.75,206,1794
10000,6,8950.0,59,2.95,1050,8950
20000,6,17903.0,96,4.8,2097,17903
40000,6,35923.0,157,7.85,4077,35923
60000,6,53974.0,225,11.25,6026,53974
80000,6,72000.0,288,14.4,8000,72000
100000,6,90005.0,344,17.2,9995,90005
200000,6,180060.0,703,35.15,19940,180060
400000,6,359869.0,1404,70.2,40131,359869
600000,6,539656.0,2096,104.8,60344,539656
800000,6,719668.0,2762,138.1,80332,719668
1000000,6,899484.0,3434,171.7,100516,899484
2,7,2.0,2,0.1,0,2
3,7,3.0,3,0.15,0,3
100,7,84.0,100,5.0,16,84
200,7,160.0,200,10.0,40,160
2000,7,1743.0,936,46.8,257,1743
10000,7,8924.0,965,48.25,1076,8924
20000,7,17972.0,996,49.8,2028,17972
40000,7,36018.0,1064,53.2,3982,36018
60000,7,54098.0,1126,56.3,5902,54098
80000,7,72078.0,1189,59.45,7922,72078
100000,7,89989.0,1252,62.6,10011,89989
200000,7,180076.0,1587,79.35,19924,180076
400000,7,360142.0,2284,114.2,39858,360142
600000,7,540260.0,2985,149.25,59740,540260
800000,7,720098.0,3647,182.35,79902,720098
1000000,7,900083.0,4350,217.5,99917,900083
2,8,2.0,2,0.1,0,2
3,8,3.0,3,0.15,0,3
100,8,85.0,100,5.0,15,85
200,8,169.0,200,10.0,31,169
2000,8,1752.0,767,38.35,248,1752
10000,8,8955.0,797,39.85,1045,8955
20000,8,18011.0,834,41.7,1989,18011
40000,8,36021.0,908,45.4,3979,36021
60000,8,53966.0,969,48.45,6034,53966
80000,8,71970.0,1026,51.3,8030,71970
100000,8,89997.0,1087,54.35,10003,89997
200000,8,179943.0,1403,70.15,20057,179943
400000,8,359980.0,2066,103.3,40020,359980
600000,8,539712.0,2693,134.65,60288,539712
800000,8,719614.0,3425,171.25,80386,719614
1000000,8,899573.0,4077,203.85,100427,899573
2,9,2.0,2,0.1,0,2
3,9,2.0,3,0.15,1,2
100,9,79.0,100,5.0,21,79
200,9,166.0,200,10.0,34,166
2000,9,1755.0,784,39.2,245,1755
10000,9,8939.0,805,40.25,1061,8939
20000,9,17909.0,839,41.95,2091,17909
40000,9,35924.0,912,45.6,4076,35924
60000,9,53905.0,981,49.05,6095,53905
80000,9,71895.0,1057,52.85,8105,71895
100000,9,89836.0,1124,56.2,10164,89836
200000,9,179773.0,1462,73.1,20227,179773
400000,9,359636.0,2158,107.9,40364,359636
600000,9,539707.0,2795,139.75,60293,539707
800000,9,719873.0,3426,171.3,80127,719873
1000000,9,900020.0,4091,204.55,99980,900020
2,10,2.0,2,0.1,0,2
3,10,3.0,3,0.15,0,3
100,10,85.0,100,5.0,15,85
200,10,171.0,200,10.0,29,171
2000,10,1712.0,1995,99.75,288,1712
10000,10,8907.0,2346,117.3,1093,8907
20000,10,17911.0,2380,119.0,2089,17911
40000,10,35924.0,2442,122.1,4076,35924
60000,10,53942.0,2511,125.55,6058,53942
80000,10,71931.0,2574,128.7,8069,71931
100000,10,89880.0,2645,132.25,10120,89880
200000,10,179907.0,2953,147.65,20093,179907
400000,10,360032.0,3671,183.55,39968,360032
600000,10,540045.0,4364,218.2,59955,540045
800000,10,719888.0,5044,252.2,80112,719888
1000000,10,899896.0,5709,285.45,100104,899896
2,11,1.0,2,0.1,1,1
3,11,2.0,3,0.15,1,2
100,11,82.0,100,5.0,18,82
200,11,166.0,200,10.0,34,166
2000,11,1686.0,1988,99.4,314,1686
10000,11,8863.0,2470,123.5,1137,8863
20000,11,17874.0,2506,125.3,2126,17874
40000,11,35751.0,2573,128.65,4249,35751
60000,11,53745.0,2649,132.45,6255,53745
80000,11,71734.0,2724,136.2,8266,71734
100000,11,89721.0,2797,139.85,10279,89721
200000,11,179653.0,3146,157.3,20347,179653
400000,11,359614.0,3826,191.3,40386,359614
600000,11,539591.0,4501,225.05,60409,539591
800000,11,719450.0,5178,258.9,80550,719450
1000000,11,899382.0,5847,292.35,100618,899382
2,12,2.0,2,0.1,0,2
3,12,3.0,3,0.15,0,3
100,12,89.0,100,5.0,11,89
200,12,173.0,200,10.0,27,173
2000,12,1780.0,586,29.3,220,1780
10000,12,9023.0,624,31.2,977,9023
20000,12,18004.0,664,33.2,1996,18004
40000,12,35973.0,726,36.3,4027,35973
60000,12,53902.0,806,40.3,6098,53902
80000,12,71850.0,882,44.1,8150,71850
100000,12,89797.0,960,48.0,10203,89797
200000,12,179994.0,1302,65.1,20006,179994
400000,12,360152.0,1969,98.45,39848,360152
600000,12,540008.0,2632,131.6,59992,540008
800000,12,720044.0,3302,165.1,79956,720044
1000000,12,899967.0,3959,197.95,100033,899967
2,13,1.0,2,0.1,1,1
3,13,2.0,3,0.15,1,2
100,13,85.0,100,5.0,15,85
200,13,175.0,200,10.0,25,175
2000,13,1714.0,1952,97.6,286,1714
10000,13,8559.0,9042,452.1,1441,8559
20000,13,17505.0,9080,454.0,2495,17505
40000,13,35492.0,9153,457.65,4508,35492
60000,13,53486.0,9212,460.6,6514,53486
80000,13,71425.0,9274,463.7,8575,71425
100000,13,89370.0,9328,466.4,10630,89370
200000,13,179355.0,9647,482.35,20645,179355
400000,13,359411.0,10351,517.55,40589,359411
600000,13,539501.0,11019,550.95,60499,539501
800000,13,719730.0,11663,583.15,80270,719730
1000000,13,899568.0,12349,617.45,100432,899568
2,14,2.0,2,0.1,0,2
3,14,3.0,3,0.15,0,3
100,14,83.0,100,5.0,17,83
200,14,165.0,200,10.0,35,165
2000,14,1719.0,1995,99.75,281,1719
10000,14,8888.0,3301,165.05,1112,8888
20000,14,17878.0,3321,166.05,2122,17878
40000,14,35848.0,3401,170.05,4152,35848
60000,14,53818.0,3461,173.05,6182,53818
80000,14,71860.0,3527,176.35,8140,71860
100000,14,89863.0,3593,179.65,10137,89863
200000,14,179849.0,3895,194.75,20151,179849
400000,14,359942.0,4556,227.8,40058,359942
600000,14,539936.0,5195,259.75,60064,539936
800000,14,719972.0,5840,292.0,80028,719972
1000000,14,899928.0,6513,325.65,100072,899928
2,15,2.0,2,0.1,0,2
3,15,3.0,3,0.15,0,3
100,15,88.0,58,2.9,12,88
200,15,179.0,59,2.95,21,179
2000,15,1800.0,64,3.2,200,1800
10000,15,9007.0,96,4.8,993,9007
20000,15,17974.0,142,7.1,2026,17974
40000,15,36001.0,191,9.55,3999,36001
60000,15,53956.0,262,13.1,6044,53956
80000,15,71936.0,323,16.15,8064,71936
100000,15,89905.0,390,19.5,10095,89905
200000,15,179834.0,754,37.7,20166,179834
400000,15,359831.0,1408,70.4,40169,359831
600000,15,539738.0,2065,103.25,60262,539738
800000,15,719742.0,2742,137.1,80258,719742
1000000,15,899910.0,3418,170.9,100090,899910
2,16,2.0,2,0.1,0,2
3,16,3.0,3,0.15,0,3
100,16,93.0,10,0.5,7,93
200,16,185.0,10,0.5,15,185
2000,16,1813.0,54,2.7,187,1813
10000,16,8947.0,117,5.85,1053,8947
20000,16,18015.0,148,7.4,1985,18015
40000,16,35987.0,219,10.95,4013,35987
60000,16,53983.0,279,13.95,6017,53983
80000,16,72057.0,352,17.6,7943,72057
100000,16,90061.0,407,20.35,9939,90061
200000,16,180047.0,713,35.65,19953,180047
400000,16,360003.0,1389,69.45,39997,360003
600000,16,540095.0,2011,100.55,59905,540095
800000,16,719993.0,2677,133.85,80007,719993
1000000,16,900204.0,3349,167.45,99796,900204
2,17,1.0,2,0.1,1,1
3,17,2.0,3,0.15,1,2
100,17,81.0,100,5.0,19,81
200,17,173.0,161,8.05,27,173
2000,17,1804.0,171,8.55,196,1804
10000,17,9040.0,203,10.15,960,9040
20000,17,18021.0,243,12.15,1979,18021
40000,17,36040.0,316,15.8,3960,36040
60000,17,54012.0,370,18.5,5988,54012
80000,17,72086.0,434,21.7,7914,72086
100000,17,90090.0,492,24.6,9910,90090
200000,17,180025.0,816,40.8,19975,180025
400000,17,360133.0,1493,74.65,39867,360133
600000,17,540114.0,2161,108.05,59886,540114
800000,17,720123.0,2863,143.15,79877,720123
1000000,17,900124.0,3509,175.45,99876,900124
2,18,2.0,2,0.1,0,2
3,18,3.0,3,0.15,0,3
100,18,79.0,100,5.0,21,79
200,18,162.0,198,9.9,38,162
2000,18,1680.0,1993,99.65,320,1680
10000,18,8520.0,9981,499.05,1480,8520
20000,18,17106.0,19360,968.0,2894,17106
40000,18,35032.0,19441,972.05,4968,35032
60000,18,53020.0,19505,975.25,6980,53020
80000,18,71028.0,19568,978.4,8972,71028
100000,18,89001.0,19638,981.9,10999,89001
200000,18,178805.0,19959,997.95,21195,178805
400000,18,358866.0,20622,1031.1,41134,358866
600000,18,538703.0,21286,1064.3,61297,538703
800000,18,718720.0,21942,1097.1,81280,718720
1000000,18,898585.0,22601,1130.05,101415,898585
2,19,1.0,2,0.1,1,1
3,19,2.0,3,0.15,1,2
100,19,87.0,100,5.0,13,87
200,19,169.0,200,10.0,31,169
2000,19,1692.0,1997,99.85,308,1692
10000,19,8518.0,9951,497.55,1482,8518
20000,19,16977.0,19939,996.95,3023,16977
40000,19,33987.0,39908,1995.4,6013,33987
60000,19,51902.0,40355,2017.75,8098,51902
80000,19,69904.0,40428,2021.4,10096,69904
100000,19,87841.0,40485,2024.25,12159,87841
200000,19,177713.0,40836,2041.8,22287,177713
400000,19,357568.0,41510,2075.5,42432,357568
600000,19,537675.0,42155,2107.75,62325,537675
800000,19,717429.0,42850,2142.5,82571,717429
1000000,19,897342.0,43495,2174.75,102658,897342
2,20,2.0,2,0.1,0,2
3,20,3.0,3,0.15,0,3
100,20,91.0,100,5.0,9,91
200,20,173.0,200,10.0,27,173
2000,20,1714.0,1983,99.15,286,1714
10000,20,8778.0,4631,231.55,1222,8778
20000,20,17783.0,4667,233.35,2217,17783
40000,20,35829.0,4725,236.25,4171,35829
60000,20,53864.0,4790,239.5,6136,53864
80000,20,71832.0,4863,243.15,8168,71832
100000,20,89849.0,4914,245.7,10151,89849
200000,20,179943.0,5265,263.25,20057,179943
400000,20,359847.0,5915,295.75,40153,359847
600000,20,539866.0,6550,327.5,60134,539866
800000,20,719739.0,7221,361.05,80261,719739
1000000,20,899717.0,7865,393.25,100283,899717
2,21,2.0,2,0.1,0,2
3,21,3.0,3,0.15,0,3
100,21,90.0,100,5.0,10,90
200,21,179.0,199,9.95,21,179
2000,21,1704.0,1995,99.75,296,1704
10000,21,8678.0,6744,337.2,1322,8678
20000,21,17664.0,6784,339.2,2336,17664
40000,21,35656.0,6852,342.6,4344,35656
60000,21,53665.0,6914,345.7,6335,53665
80000,21,71676.0,6973,348.65,8324,71676
100000,21,89679.0,7031,351.55,10321,89679
200000,21,179641.0,7370,368.5,20359,179641
400000,21,359710.0,7985,399.25,40290,359710
600000,21,539653.0,8655,432.75,60347,539653
800000,21,719546.0,9325,466.25,80454,719546
1000000,21,899326.0,9984,499.2,100674,899326
2,22,2.0,2,0.1,0,2
3,22,3.0,3,0.15,0,3
100,22,85.0,100,5.0,15,85
200,22,173.0,200,10.0,27,173
2000,22,1679.0,1989,99.45,321,1679
10000,22,8418.0,9979,498.95,1582,8418
20000,22,17180.0,12792,639.6,2820,17180
40000,22,35225.0,12863,643.15,4775,35225
60000,22,53282.0,12924,646.2,6718,53282
80000,22,71302.0,12987,649.35,8698,71302
100000,22,89396.0,13065,653.25,10604,89396
200000,22,179319.0,13396,669.8,20681,179319
400000,22,359465.0,14011,700.55,40535,359465
600000,22,539521.0,14674,733.7,60479,539521
800000,22,719678.0,15317,765.85,80322,719678
1000000,22,899506.0,16022,801.1,100494,899506
2,23,2.0,2,0.1,0,2
3,23,3.0,3,0.15,0,3
100,23,93.0,100,5.0,7,93
200,23,176.0,194,9.7,24,176
2000,23,1724.0,1994,99.7,276,1724
10000,23,8898.0,2654,132.7,1102,8898
20000,23,17903.0,2685,134.25,2097,17903
40000,23,35833.0,2780,139.0,4167,35833
60000,23,53853.0,2860,143.0,6147,53853
80000,23,71847.0,2937,146.85,8153,71847
100000,23,89818.0,2998,149.9,10182,89818
200000,23,179866.0,3348,167.4,20134,179866
400000,23,359707.0,3998,199.9,40293,359707
600000,23,539895.0,4649,232.45,60105,539895
800000,23,719933.0,5271,263.55,80067,719933
1000000,23,900094.0,5962,298.1,99906,900094
2,24,2.0,2,0.1,0,2
3,24,3.0,3,0.15,0,3
100,24,80.0,100,5.0,20,80
200,24,166.0,189,9.45,34,166
2000,24,1797.0,297,14.85,203,1797
10000,24,8962.0,314,15.7,1038,8962
20000,24,17938.0,357,17.85,2062,17938
40000,24,36006.0,417,20.85,3994,36006
60000,24,53957.0,471,23.55,6043,53957
80000,24,71977.0,539,26.95,8023,71977
100000,24,89900.0,632,31.6,10100,89900
200000,24,179921.0,968,48.4,20079,179921
400000,24,359940.0,1599,79.95,40060,359940
600000,24,539947.0,2249,112.45,60053,539947
800000,24,719988.0,2881,144.05,80012,719988
1000000,24,900103.0,3575,178.75,99897,900103
2,25,2.0,2,0.1,0,2
3,25,3.0,3,0.15,0,3
100,25,88.0,100,5.0,12,88
200,25,168.0,200,10.0,32,168
2000,25,1745.0,1990,99.5,255,1745
10000,25,8847.0,3503,175.15,1153,8847
20000,25,17869.0,3538,176.9,2131,17869
40000,25,35852.0,3594,179.7,4148,35852
60000,25,53855.0,3651,182.55,6145,53855
80000,25,71809.0,3707,185.35,8191,71809
100000,25,89790.0,3773,188.65,10210,89790
200000,25,179737.0,4112,205.6,20263,179737
400000,25,359642.0,4795,239.75,40358,359642
600000,25,539398.0,5478,273.9,60602,539398
800000,25,719264.0,6111,305.55,80736,719264
1000000,25,899131.0,6747,337.35,100869,899131
2,26,1.0,2,0.1,1,1
3,26,1.0,3,0.15,2,1
100,26,84.0,100,5.0,16,84
200,26,163.0,200,10.0,37,163
2000,26,1758.0,912,45.6,242,1758
10000,26,8971.0,933,46.65,1029,8971
20000,26,18006.0,970,48.5,1994,18006
40000,26,36053.0,1061,53.05,3947,36053
60000,26,54081.0,1125,56.25,5919,54081
80000,26,72023.0,1199,59.95,7977,72023
100000,26,90009.0,1283,64.15,9991,90009
200000,26,180065.0,1645,82.25,19935,180065
400000,26,360064.0,2321,116.05,39936,360064
600000,26,540083.0,2991,149.55,59917,540083
800000,26,720135.0,3708,185.4,79865,720135
1000000,26,899899.0,4396,219.8,100101,899899
2,27,1.0,2,0.1,1,1
3,27,2.0,3,0.15,1,2
100,27,88.0,100,5.0,12,88
200,27,175.0,200,10.0,25,175
2000,27,1773.0,585,29.25,227,1773
10000,27,8975.0,616,30.8,1025,8975
20000,27,17942.0,650,32.5,2058,17942
40000,27,35972.0,722,36.1,4028,35972
60000,27,53929.0,787,39.35,6071,53929
80000,27,71964.0,933,46.65,8036,71964
100000,27,89989.0,996,49.8,10011,89989
200000,27,179936.0,1337,66.85,20064,179936
400000,27,359968.0,2017,100.85,40032,359968
600000,27,539869.0,2723,136.15,60131,539869
800000,27,719876.0,3356,167.8,80124,719876
1000000,27,899904.0,4054,202.7,100096,899904
2,28,2.0,2,0.1,0,2
3,28,3.0,3,0.15,0,3
100,28,86.0,100,5.0,14,86
200,28,169.0,200,10.0,31,169
2000,28,1765.0,634,31.7,235,1765
10000,28,8963.0,665,33.25,1037,8963
20000,28,18008.0,690,34.5,1992,18008
40000,28,36032.0,749,37.45,3968,36032
60000,28,54024.0,823,41.15,5976,54024
80000,28,72051.0,884,44.2,7949,72051
100000,28,90056.0,952,47.6,9944,90056
200000,28,180111.0,1269,63.45,19889,180111
400000,28,360209.0,1934,96.7,39791,360209
600000,28,540483.0,2611,130.55,59517,540483
800000,28,720563.0,3307,165.35,79437,720563
1000000,28,900531.0,4011,200.55,99469,900531
2,29,1.0,2,0.1,1,1
3,29,2.0,3,0.15,1,2
100,29,79.0,100,5.0,21,79
200,29,159.0,200,10.0,41,159
2000,29,1760.0,282,14.1,240,1760
10000,29,8996.0,328,16.4,1004,8996
20000,29,18042.0,371,18.55,1958,18042
40000,29,36162.0,421,21.05,3838,36162
60000,29,54182.0,486,24.3,5818,54182
80000,29,72192.0,558,27.9,7808,72192
100000,29,90144.0,619,30.95,9856,90144
200000,29,180302.0,981,49.05,19698,180302
400000,29,360156.0,1619,80.95,39844,360156
600000,29,540271.0,2244,112.2,59729,540271
800000,29,720183.0,2936,146.8,79817,720183
1000000,29,899988.0,3614,180.7,100012,899988
2,30,2.0,2,0.1,0,2
3,30,2.0,3,0.15,1,2
100,30,85.0,96,4.8,15,85
200,30,174.0,196,9.8,26,174
2000,30,1709.0,1994,99.7,291,1709
10000,30,8521.0,9976,498.8,1479,8521
20000,30,16986.0,19849,992.45,3014,16986
40000,30,33975.0,39807,1990.35,6025,33975
60000,30,51608.0,47011,2350.55,8392,51608
80000,30,69661.0,47066,2353.3,10339,69661
100000,30,87647.0,47129,2356.45,12353,87647
200000,30,177741.0,47459,2372.95,22259,177741
400000,30,357762.0,48107,2405.35,42238,357762
600000,30,537594.0,48801,2440.05,62406,537594
800000,30,717621.0,49463,2473.15,82379,717621
1000000,30,897778.0,50145,2507.25,102222,897778
2,31,2.0,2,0.1,0,2
3,31,3.0,3,0.15,0,3
100,31,83.0,100,5.0,17,83
200,31,164.0,200,10.0,36,164
2000,31,1690.0,1996,99.8,310,1690
10000,31,8521.0,9975,498.75,1479,8521
20000,31,17038.0,19954,997.7,2962,17038
40000,31,34068.0,39913,1995.65,5932,34068
60000,31,51148.0,59878,2993.9,8852,51148
80000,31,68821.0,65791,3289.55,11179,68821
100000,31,86822.0,65859,3292.95,13178,86822
200000,31,176730.0,66175,3308.75,23270,176730
400000,31,356679.0,66839,3341.95,43321,356679
600000,31,536613.0,67510,3375.5,63387,536613
800000,31,716308.0,68159,3407.95,83692,716308
1000000,31,896221.0,68833,3441.65,103779,896221
2,32,2.0,2,0.1,0,2
3,32,3.0,3,0.15,0,3
100,32,88.0,100,5.0,12,88
200,32,170.0,200,10.0,30,170
2000,32,1703.0,1946,97.3,297,1703
10000,32,8898.0,1991,99.55,1102,8898
20000,32,17879.0,2030,101.5,2121,17879
40000,32,35843.0,2083,104.15,4157,35843
60000,32,53804.0,2152,107.6,6196,53804
80000,32,71865.0,2230,111.5,8135,71865
100000,32,89868.0,2301,115.05,10132,89868
200000,32,179760.0,2642,132.1,20240,179760
400000,32,359832.0,3281,164.05,40168,359832
600000,32,539744.0,3945,197.25,60256,539744
800000,32,719777.0,4591,229.55,80223,719777
1000000,32,899816.0,5281,264.05,100184,899816
2,33,2.0,2,0.1,0,2
3,33,3.0,3,0.15,0,3
100,33,82.0,100,5.0,18,82
200,33,173.0,138,6.9,27,173
2000,33,1797.0,141,7.05,203,1797
10000,33,8973.0,162,8.1,1027,8973
20000,33,17932.0,192,9.6,2068,17932
40000,33,35937.0,243,12.15,4063,35937
60000,33,53908.0,312,15.6,6092,53908
80000,33,71971.0,365,18.25,8029,71971
100000,33,89874.0,427,21.35,10126,89874
200000,33,179930.0,736,36.8,20070,179930
400000,33,359927.0,1384,69.2,40073,359927
600000,33,539711.0,2052,102.6,60289,539711
800000,33,719767.0,2724,136.2,80233,719767
1000000,33,899693.0,3423,171.15,100307,899693
2,34,2.0,2,0.1,0,2
3,34,2.0,3,0.15,1,2
100,34,81.0,100,5.0,19,81
200,34,162.0,200,10.0,38,162
2000,34,1695.0,1997,99.85,305,1695
10000,34,8486.0,9985,499.25,1514,8486
20000,34,16942.0,19970,998.5,3058,16942
40000,34,34780.0,22814,1140.7,5220,34780
60000,34,52852.0,22881,1144.05,7148,52852
80000,34,70849.0,22943,1147.15,9151,70849
100000,34,88824.0,22999,1149.95,11176,88824
200000,34,178798.0,23339,1166.95,21202,178798
400000,34,358966.0,23968,1198.4,41034,358966
600000,34,539055.0,24590,1229.5,60945,539055
800000,34,719098.0,25246,1262.3,80902,719098
1000000,34,898972.0,25933,1296.65,101028,898972
2,35,2.0,2,0.1,0,2
3,35,3.0,3,0.15,0,3
100,35,91.0,100,5.0,9,91
200,35,178.0,200,10.0,22,178
2000,35,1700.0,1995,99.75,300,1700
10000,35,8589.0,8201,410.05,1411,8589
20000,35,17603.0,8241,412.05,2397,17603
40000,35,35617.0,8321,416.05,4383,35617
60000,35,53662.0,8383,419.15,6338,53662
80000,35,71672.0,8452,422.6,8328,71672
100000,35,89740.0,8506,425.3,10260,89740
200000,35,179686.0,8825,441.25,20314,179686
400000,35,359647.0,9530,476.5,40353,359647
600000,35,539780.0,10205,510.25,60220,539780
800000,35,719990.0,10895,544.75,80010,719990
1000000,35,899967.0,11539,576.95,100033,899967
2,36,2.0,2,0.1,0,2
3,36,3.0,3,0.15,0,3
100,36,83.0,100,5.0,17,83
200,36,163.0,200,10.0,37,163
2000,36,1776.0,285,14.25,224,1776
10000,36,9022.0,315,15.75,978,9022
20000,36,18012.0,352,17.6,1988,18012
40000,36,35985.0,431,21.55,4015,35985
60000,36,53994.0,504,25.2,6006,53994
80000,36,72026.0,566,28.3,7974,72026
100000,36,90012.0,638,31.9,9988,90012
200000,36,180067.0,982,49.1,19933,180067
400000,36,359893.0,1639,81.95,40107,359893
600000,36,539907.0,2340,117.0,60093,539907
800000,36,719923.0,3052,152.6,80077,719923
1000000,36,899916.0,3692,184.6,100084,899916
2,37,2.0,2,0.1,0,2
3,37,3.0,3,0.15,0,3
100,37,88.0,100,5.0,12,88
200,37,170.0,200,10.0,30,170
2000,37,1754.0,510,25.5,246,1754
10000,37,8935.0,538,26.9,1065,8935
20000,37,17943.0,581,29.05,2057,17943
40000,37,35978.0,652,32.6,4022,35978
60000,37,53959.0,713,35.65,6041,53959
80000,37,71937.0,795,39.75,8063,71937
100000,37,89895.0,859,42.95,10105,89895
200000,37,179835.0,1180,59.0,20165,179835
400000,37,359915.0,1852,92.6,40085,359915
600000,37,539846.0,2493,124.65,60154,539846
800000,37,719873.0,3206,160.3,80127,719873
1000000,37,899666.0,3889,194.45,100334,899666
2,38,1.0,2,0.1,1,1
3,38,2.0,3,0.15,1,2
100,38,84.0,100,5.0,16,84
200,38,171.0,200,10.0,29,171
2000,38,1711.0,1988,99.4,289,1711
10000,38,8535.0,9339,466.95,1465,8535
20000,38,17577.0,9375,468.75,2423,17577
40000,38,35613.0,9456,472.8,4387,35613
60000,38,53572.0,9510,475.5,6428,53572
80000,38,71531.0,9587,479.35,8469,71531
100000,38,89574.0,9649,482.45,10426,89574
200000,38,179465.0,9964,498.2,20535,179465
400000,38,359299.0,10622,531.1,40701,359299
600000,38,539323.0,11280,564.0,60677,539323
800000,38,719433.0,11960,598.0,80567,719433
1000000,38,899391.0,12605,630.25,100609,899391
2,39,1.0,2,0.1,1,1
3,39,2.0,3,0.15,1,2
100,39,82.0,100,5.0,18,82
200,39,165.0,200,10.0,35,165
2000,39,1660.0,2000,100.0,340,1660
10000,39,8882.0,2646,132.3,1118,8882
20000,39,17883.0,2674,133.7,2117,17883
40000,39,35783.0,2741,137.05,4217,35783
60000,39,53807.0,2815,140.75,6193,53807
80000,39,71747.0,2885,144.25,8253,71747
100000,39,89733.0,2947,147.35,10267,89733
200000,39,179879.0,3265,163.25,20121,179879
400000,39,360045.0,3908,195.4,39955,360045
600000,39,539852.0,4577,228.85,60148,539852
800000,39,719637.0,5210,260.5,80363,719637
1000000,39,899517.0,5908,295.4,100483,899517
2,40,2.0,2,0.1,0,2
3,40,3.0,3,0.15,0,3
100,40,88.0,100,5.0,12,88
200,40,178.0,200,10.0,22,178
2000,40,1709.0,1989,99.45,291,1709
10000,40,8515.0,9979,498.95,1485,8515
20000,40,17037.0,19958,997.9,2963,17037
40000,40,34032.0,39925,1996.25,5968,34032
60000,40,51501.0,50457,2522.85,8499,51501
80000,40,69490.0,50532,2526.6,10510,69490
100000,40,87393.0,50614,2530.7,12607,87393
200000,40,177456.0,50974,2548.7,22544,177456
400000,40,357272.0,51645,2582.25,42728,357272
600000,40,537365.0,52286,2614.3,62635,537365
800000,40,717281.0,52951,2647.55,82719,717281
1000000,40,897190.0,53589,2679.45,102810,897190
2,41,2.0,2,0.1,0,2
3,41,3.0,3,0.15,0,3
100,41,83.0,100,5.0,17,83
200,41,167.0,200,10.0,33,167
2000,41,1730.0,1369,68.45,270,1730
10000,41,8968.0,1404,70.2,1032,8968
20000,41,17961.0,1434,71.7,2039,17961
40000,41,35919.0,1510,75.5,4081,35919
60000,41,53825.0,1579,78.95,6175,53825
80000,41,71786.0,1660,83.0,8214,71786
100000,41,89831.0,1713,85.65,10169,89831
200000,41,179615.0,2034,101.7,20385,179615
400000,41,359531.0,2632,131.6,40469,359531
600000,41,539480.0,3314,165.7,60520,539480
800000,41,719465.0,3948,197.4,80535,719465
1000000,41,899619.0,4590,229.5,100381,899619
2,42,1.0,2,0.1,1,1
3,42,2.0,3,0.15,1,2
100,42,84.0,100,5.0,16,84
200,42,176.0,131,6.55,24,176
2000,42,1800.0,148,7.4,200,1800
10000,42,8984.0,180,9.0,1016,8984
20000,42,18013.0,212,10.6,1987,18013
40000,42,36022.0,283,14.15,3978,36022
60000,42,54032.0,354,17.7,5968,54032
80000,42,72102.0,424,21.2,7898,72102
100000,42,90152.0,484,24.2,9848,90152
200000,42,180165.0,789,39.45,19835,180165
400000,42,360211.0,1463,73.15,39789,360211
600000,42,540330.0,2139,106.95,59670,540330
800000,42,720154.0,2838,141.9,79846,720154
1000000,42,900062.0,3529,176.45,99938,900062
2,43,1.0,2,0.1,1,1
3,43,2.0,3,0.15,1,2
100,43,80.0,100,5.0,20,80
200,43,165.0,200,10.0,35,165
2000,43,1715.0,1097,54.85,285,1715
10000,43,8951.0,1129,56.45,1049,8951
20000,43,17922.0,1168,58.4,2078,17922
40000,43,35935.0,1225,61.25,4065,35935
60000,43,53956.0,1296,64.8,6044,53956
80000,43,71920.0,1356,67.8,8080,71920
100000,43,89884.0,1425,71.25,10116,89884
200000,43,179857.0,1766,88.3,20143,179857
400000,43,360055.0,2450,122.5,39945,360055
600000,43,539948.0,3121,156.05,60052,539948
800000,43,719937.0,3737,186.85,80063,719937
1000000,43,899961.0,4446,222.3,100039,899961
2,44,2.0,2,0.1,0,2
3,44,3.0,3,0.15,0,3
100,44,82.0,100,5.0,18,82
200,44,170.0,200,10.0,30,170
2000,44,1759.0,1212,60.6,241,1759
10000,44,8948.0,1239,61.95,1052,8948
20000,44,17938.0,1279,63.95,2062,17938
40000,44,35980.0,1348,67.4,4020,35980
60000,44,53926.0,1429,71.45,6074,53926
80000,44,71953.0,1495,74.75,8047,71953
100000,44,89954.0,1555,77.75,10046,89954
200000,44,180049.0,1879,93.95,19951,180049
400000,44,359886.0,2609,130.45,40114,359886
600000,44,539714.0,3259,162.95,60286,539714
800000,44,719640.0,3902,195.1,80360,719640
1000000,44,899635.0,4581,229.05,100365,899635
2,45,2.0,2,0.1,0,2
3,45,3.0,3,0.15,0,3
100,45,85.0,100,5.0,15,85
200,45,173.0,197,9.85,27,173
2000,45,1754.0,1040,52.0,246,1754
10000,45,8985.0,1067,53.35,1015,8985
20000,45,18041.0,1090,54.5,1959,18041
40000,45,36081.0,1164,58.2,3919,36081
60000,45,54107.0,1239,61.95,5893,54107
80000,45,72084.0,1307,65.35,7916,72084
100000,45,90103.0,1378,68.9,9897,90103
200000,45,180068.0,1743,87.15,19932,180068
400000,45,360037.0,2409,120.45,39963,360037
600000,45,539880.0,3096,154.8,60120,539880
800000,45,719906.0,3769,188.45,80094,719906
1000000,45,900096.0,4434,221.7,99904,900096
2,46,2.0,2,0.1,0,2
3,46,3.0,3,0.15,0,3
100,46,87.0,100,5.0,13,87
200,46,170.0,200,10.0,30,170
2000,46,1778.0,416,20.8,222,1778
10000,46,8966.0,443,22.15,1034,8966
20000,46,17943.0,645,32.25,2057,17943
40000,46,35953.0,718,35.9,4047,35953
60000,46,53921.0,769,38.45,6079,53921
80000,46,71890.0,834,41.7,8110,71890
100000,46,89840.0,905,45.25,10160,89840
200000,46,179913.0,1245,62.25,20087,179913
400000,46,359998.0,1930,96.5,40002,359998
600000,46,539836.0,2614,130.7,60164,539836
800000,46,719867.0,3275,163.75,80133,719867
1000000,46,899774.0,3998,199.9,100226,899774
2,47,2.0,2,0.1,0,2
3,47,3.0,3,0.15,0,3
100,47,84.0,100,5.0,16,84
200,47,172.0,200,10.0,28,172
2000,47,1699.0,1983,99.15,301,1699
10000,47,8523.0,9958,497.9,1477,8523
20000,47,17333.0,14022,701.1,2667,17333
40000,47,35299.0,14079,703.95,4701,35299
60000,47,53254.0,14155,707.75,6746,53254
80000,47,71246.0,14216,710.8,8754,71246
100000,47,89248.0,14282,714.1,10752,89248
200000,47,179454.0,14617,730.85,20546,179454
400000,47,359266.0,15291,764.55,40734,359266
600000,47,539351.0,15934,796.7,60649,539351
800000,47,719138.0,16594,829.7,80862,719138
1000000,47,898794.0,17222,861.1,101206,898794
2,48,1.0,2,0.1,1,1
3,48,1.0,3,0.15,2,1
100,48,85.0,100,5.0,15,85
200,48,166.0,198,9.9,34,166
2000,48,1698.0,1998,99.9,302,1698
10000,48,8504.0,9387,469.35,1496,8504
20000,48,17546.0,9421,471.05,2454,17546
40000,48,35567.0,9486,474.3,4433,35567
60000,48,53604.0,9542,477.1,6396,53604
80000,48,71557.0,9601,480.05,8443,71557
100000,48,89558.0,9662,483.1,10442,89558
200000,48,179555.0,10010,500.5,20445,179555
400000,48,359591.0,10703,535.15,40409,359591
600000,48,539457.0,11320,566.0,60543,539457
800000,48,719646.0,11926,596.3,80354,719646
1000000,48,899523.0,12602,630.1,100477,899523
2,49,1.0,2,0.1,1,1
3,49,2.0,3,0.15,1,2
100,49,86.0,100,5.0,14,86
200,49,169.0,200,10.0,31,169
2000,49,1689.0,1997,99.85,311,1689
10000,49,8506.0,9989,499.45,1494,8506
20000,49,17216.0,16353,817.65,2784,17216
40000,49,35232.0,16430,821.5,4768,35232
60000,49,53204.0,16496,824.8,6796,53204
80000,49,71181.0,16571,828.55,8819,71181
100000,49,89222.0,16629,831.45,10778,89222
200000,49,179263.0,16968,848.4,20737,179263
400000,49,359221.0,17639,881.95,40779,359221
600000,49,539432.0,18303,915.15,60568,539432
800000,49,719184.0,18977,948.85,80816,719184
1000000,49,899123.0,19668,983.4,100877,899123
2,50,2.0,2,0.1,0,2
3,50,3.0,3,0.15,0,3
100,50,91.0,42,2.1,9,91
200,50,179.0,78,3.9,21,179
2000,50,1800.0,85,4.25,200,1800
10000,50,9038.0,115,5.75,962,9038
20000,50,18047.0,176,8.8,1953,18047
40000,50,36041.0,238,11.9,3959,36041
60000,50,53988.0,297,14.85,6012,53988
80000,50,71904.0,359,17.95,8096,71904
100000,50,89783.0,431,21.55,10217,89783
200000,50,179710.0,784,39.2,20290,179710
400000,50,359583.0,1547,77.35,40417,359583
600000,50,539461.0,2269,113.45,60539,539461
800000,50,719196.0,2905,145.25,80804,719196
1000000,50,899034.0,3575,178.75,100966,899034
2,51,2.0,2,0.1,0,2
3,51,2.0,3,0.15,1,2
100,51,83.0,100,5.0,17,83
200,51,169.0,200,10.0,31,169
2000,51,1705.0,2000,100.0,295,1705
10000,51,8520.0,9975,498.75,1480,8520
20000,51,17040.0,19961,998.05,2960,17040
40000,51,34757.0,26170,1308.5,5243,34757
60000,51,52744.0,26234,1311.7,7256,52744
80000,51,70706.0,26318,1315.9,9294,70706
100000,51,88713.0,26396,1319.8,11287,88713
200000,51,178815.0,26751,1337.55,21185,178815
400000,51,358655.0,27422,1371.1,41345,358655
600000,51,538691.0,28107,1405.35,61309,538691
800000,51,718599.0,28756,1437.8,81401,718599
1000000,51,898588.0,29403,1470.15,101412,898588
2,52,2.0,2,0.1,0,2
3,52,3.0,3,0.15,0,3
100,52,83.0,77,3.85,17,83
200,52,166.0,174,8.7,34,166
2000,52,1712.0,1971,98.55,288,1712
10000,52,8524.0,9954,497.7,1476,8524
20000,52,16972.0,19943,997.15,3028,16972
40000,52,34025.0,39909,1995.45,5975,34025
60000,52,51807.0,43938,2196.9,8193,51807
80000,52,69783.0,44015,2200.75,10217,69783
100000,52,87841.0,44081,2204.05,12159,87841
200000,52,177768.0,44447,2222.35,22232,177768
400000,52,357521.0,45117,2255.85,42479,357521
600000,52,537652.0,45754,2287.7,62348,537652
800000,52,717595.0,46402,2320.1,82405,717595
1000000,52,897631.0,47093,2354.65,102369,897631
2,53,2.0,2,0.1,0,2
3,53,2.0,3,0.15,1,2
100,53,81.0,100,5.0,19,81
200,53,164.0,200,10.0,36,164
2000,53,1693.0,1997,99.85,307,1693
10000,53,8470.0,9984,499.2,1530,8470
20000,53,16934.0,19954,997.7,3066,16934
40000,53,34339.0,31845,1592.25,5661,34339
60000,53,52352.0,31906,1595.3,7648,52352
80000,53,70339.0,31981,1599.05,9661,70339
100000,53,88274.0,32046,1602.3,11726,88274
200000,53,178320.0,32432,1621.6,21680,178320
400000,53,358221.0,33084,1654.2,41779,358221
600000,53,538329.0,33757,1687.85,61671,538329
800000,53,718257.0,34425,1721.25,81743,718257
1000000,53,898177.0,35106,1755.3,101823,898177
2,54,2.0,2,0.1,0,2
3,54,3.0,3,0.15,0,3
100,54,88.0,100,5.0,12,88
200,54,180.0,135,6.75,20,180
2000,54,1801.0,156,7.8,199,1801
10000,54,8986.0,194,9.7,1014,8986
20000,54,17975.0,221,11.05,2025,17975
40000,54,35997.0,293,14.65,4003,35997
60000,54,54017.0,363,18.15,5983,54017
80000,54,71991.0,427,21.35,8009,71991
100000,54,89943.0,508,25.4,10057,89943
200000,54,179862.0,823,41.15,20138,179862
400000,54,359725.0,1484,74.2,40275,359725
600000,54,539690.0,2195,109.75,60310,539690
800000,54,719710.0,2869,143.45,80290,719710
1000000,54,899762.0,3500,175.0,100238,899762
2,55,2.0,2,0.1,0,2
3,55,2.0,3,0.15,1,2
100,55,83.0,100,5.0,17,83
200,55,164.0,200,10.0,36,164
2000,55,1734.0,634,31.7,266,1734
10000,55,8922.0,699,34.95,1078,8922
20000,55,17895.0,731,36.55,2105,17895
40000,55,35859.0,807,40.35,4141,35859
60000,55,53823.0,874,43.7,6177,53823
80000,55,71814.0,946,47.3,8186,71814
100000,55,89774.0,1023,51.15,10226,89774
200000,55,179875.0,1340,67.0,20125,179875
400000,55,360014.0,1996,99.8,39986,360014
600000,55,539883.0,2686,134.3,60117,539883
800000,55,719916.0,3328,166.4,80084,719916
1000000,55,899734.0,3967,198.35,100266,899734
2,56,2.0,2,0.1,0,2
3,56,3.0,3,0.15,0,3
100,56,93.0,100,5.0,7,93
200,56,182.0,200,10.0,18,182
2000,56,1812.0,276,13.8,188,1812
10000,56,8992.0,317,15.85,1008,8992
20000,56,17996.0,350,17.5,2004,17996
40000,56,35957.0,422,21.1,4043,35957
60000,56,53988.0,488,24.4,6012,53988
80000,56,71900.0,565,28.25,8100,71900
100000,56,89948.0,651,32.55,10052,89948
200000,56,180072.0,978,48.9,19928,180072
400000,56,360044.0,1647,82.35,39956,360044
600000,56,539900.0,2305,115.25,60100,539900
800000,56,720017.0,2986,149.3,79983,720017
1000000,56,900165.0,3630,181.5,99835,900165
2,57,2.0,2,0.1,0,2
3,57,2.0,3,0.15,1,2
100,57,76.0,100,5.0,24,76
200,57,162.0,200,10.0,38,162
2000,57,1681.0,2000,100.0,319,1681
10000,57,8864.0,2517,125.85,1136,8864
20000,57,17897.0,2549,127.45,2103,17897
40000,57,35990.0,2609,130.45,4010,35990
60000,57,53970.0,2685,134.25,6030,53970
80000,57,71879.0,2753,137.65,8121,71879
100000,57,89796.0,2822,141.1,10204,89796
200000,57,179672.0,3169,158.45,20328,179672
400000,57,359391.0,3849,192.45,40609,359391
600000,57,539421.0,4539,226.95,60579,539421
800000,57,719583.0,5179,258.95,80417,719583
1000000,57,899592.0,5821,291.05,100408,899592
2,58,2.0,2,0.1,0,2
3,58,3.0,3,0.15,0,3
100,58,84.0,100,5.0,16,84
200,58,175.0,138,6.9,25,175
2000,58,1806.0,145,7.25,194,1806
10000,58,8994.0,163,8.15,1006,8994
20000,58,18000.0,199,9.95,2000,18000
40000,58,35932.0,253,12.65,4068,35932
60000,58,53880.0,309,15.45,6120,53880
80000,58,71853.0,363,18.15,8147,71853
100000,58,89880.0,422,21.1,10120,89880
200000,58,179920.0,759,37.95,20080,179920
400000,58,359586.0,1446,72.3,40414,359586
600000,58,539452.0,2096,104.8,60548,539452
800000,58,719398.0,2742,137.1,80602,719398
1000000,58,899204.0,3408,170.4,100796,899204
2,59,2.0,2,0.1,0,2
3,59,3.0,3,0.15,0,3
100,59,87.0,25,1.25,13,87
200,59,174.0,25,1.25,26,174
2000,59,1810.0,38,1.9,190,1810
10000,59,9010.0,65,3.25,990,9010
20000,59,18044.0,102,5.1,1956,18044
40000,59,36052.0,176,8.8,3948,36052
60000,59,53992.0,232,11.6,6008,53992
80000,59,72062.0,289,14.45,7938,72062
100000,59,90184.0,351,17.55,9816,90184
200000,59,179993.0,679,33.95,20007,179993
400000,59,360027.0,1312,65.6,39973,360027
600000,59,540117.0,1976,98.8,59883,540117
800000,59,720172.0,2665,133.25,79828,720172
1000000,59,900280.0,3380,169.0,99720,900280
2,60,1.0,2,0.1,1,1
3,60,2.0,3,0.15,1,2
100,60,88.0,100,5.0,12,88
200,60,173.0,200,10.0,27,173
2000,60,1724.0,1232,61.6,276,1724
10000,60,8880.0,1264,63.2,1120,8880
20000,60,17884.0,1306,65.3,2116,17884
40000,60,35798.0,1382,69.1,4202,35798
60000,60,53795.0,1462,73.1,6205,53795
80000,60,71913.0,1520,76.0,8087,71913
100000,60,89913.0,1583,79.15,10087,89913
200000,60,179834.0,1918,95.9,20166,179834
400000,60,359910.0,2597,129.85,40090,359910
600000,60,539764.0,3287,164.35,60236,539764
800000,60,719808.0,3942,197.1,80192,719808
1000000,60,899836.0,4621,231.05,100164,899836
2,61,2.0,2,0.1,0,2
3,61,3.0,3,0.15,0,3
100,61,84.0,100,5.0,16,84
200,61,166.0,200,10.0,34,166
2000,61,1687.0,1998,99.9,313,1687
10000,61,8492.0,9985,499.25,1508,8492
20000,61,17056.0,19489,974.45,2944,17056
40000,61,35096.0,19549,977.45,4904,35096
60000,61,53098.0,19602,980.1,6902,53098
80000,61,71054.0,19671,983.55,8946,71054
100000,61,89048.0,19741,987.05,10952,89048
200000,61,178925.0,20072,1003.6,21075,178925
400000,61,359055.0,20740,1037.0,40945,359055
600000,61,539130.0,21411,1070.55,60870,539130
800000,61,718938.0,22094,1104.7,81062,718938
1000000,61,898950.0,22776,1138.8,101050,898950
2,62,2.0,2,0.1,0,2
3,62,3.0,3,0.15,0,3
100,62,81.0,90,4.5,19,81
200,62,175.0,93,4.65,25,175
2000,62,1799.0,98,4.9,201,1799
10000,62,9014.0,129,6.45,986,9014
20000,62,18015.0,162,8.1,1985,18015
40000,62,36002.0,229,11.45,3998,36002
60000,62,54027.0,298,14.9,5973,54027
80000,62,72083.0,360,18.0,7917,72083
100000,62,90158.0,437,21.85,9842,90158
200000,62,180051.0,731,36.55,19949,180051
400000,62,359997.0,1375,68.75,40003,359997
600000,62,539888.0,2058,102.9,60112,539888
800000,62,720080.0,2706,135.3,79920,720080
1000000,62,899811.0,3408,170.4,100189,899811
2,63,2.0,2,0.1,0,2
3,63,3.0,3,0.15,0,3
100,63,81.0,100,5.0,19,81
200,63,168.0,197,9.85,32,168
2000,63,1713.0,1989,99.45,287,1713
10000,63,8548.0,9959,497.95,1452,8548
20000,63,17564.0,10374,518.7,2436,17564
40000,63,35565.0,10439,521.95,4435,35565
60000,63,53533.0,10495,524.75,6467,53533
80000,63,71451.0,10561,528.05,8549,71451
100000,63,89460.0,10608,530.4,10540,89460
200000,63,179492.0,10970,548.5,20508,179492
400000,63,359391.0,11632,581.6,40609,359391
600000,63,539413.0,12258,612.9,60587,539413
800000,63,719337.0,12931,646.55,80663,719337
1000000,63,899264.0,13610,680.5,100736,899264
2,64,1.0,2,0.1,1,1
3,64,2.0,3,0.15,1,2
100,64,91.0,100,5.0,9,91
200,64,169.0,200,10.0,31,169
2000,64,1725.0,1972,98.6,275,1725
10000,64,8487.0,9954,497.7,1513,8487
20000,64,16987.0,19938,996.9,3013,16987
40000,64,34813.0,23168,1158.4,5187,34813
60000,64,52847.0,23237,1161.85,7153,52847
80000,64,70854.0,23308,1165.4,9146,70854
100000,64,88894.0,23362,1168.1,11106,88894
200000,64,178823.0,23698,1184.9,21177,178823
400000,64,358804.0,24386,1219.3,41196,358804
600000,64,538578.0,25112,1255.6,61422,538578
800000,64,718463.0,25751,1287.55,81537,718463
1000000,64,898422.0,26406,1320.3,101578,898422
2,65,2.0,2,0.1,0,2
3,65,2.0,3,0.15,1,2
100,65,89.0,100,5.0,11,89
200,65,170.0,200,10.0,30,170
2000,65,1677.0,1996,99.8,323,1677
10000,65,8477.0,9986,499.3,1523,8477
20000,65,17225.0,14643,732.15,2775,17225
40000,65,35245.0,14734,736.7,4755,35245
60000,65,53232.0,14800,740.0,6768,53232
80000,65,71362.0,14864,743.2,8638,71362
100000,65,89452.0,14931,746.55,10548,89452
200000,65,179430.0,15240,762.0,20570,179430
400000,65,359506.0,15825,791.25,40494,359506
600000,65,539307.0,16458,822.9,60693,539307
800000,65,719489.0,17121,856.05,80511,719489
1000000,65,899589.0,17756,887.8,100411,899589
2,66,2.0,2,0.1,0,2
3,66,3.0,3,0.15,0,3
100,66,85.0,94,4.7,15,85
200,66,172.0,194,9.7,28,172
2000,66,1734.0,1193,59.65,266,1734
10000,66,8929.0,1217,60.85,1071,8929
20000,66,17971.0,1253,62.65,2029,17971
40000,66,35977.0,1329,66.45,4023,35977
60000,66,54024.0,1408,70.4,5976,54024
80000,66,72094.0,1471,73.55,7906,72094
100000,66,90140.0,1538,76.9,9860,90140
200000,66,180142.0,1854,92.7,19858,180142
400000,66,360207.0,2494,124.7,39793,360207
600000,66,539989.0,3193,159.65,60011,539989
800000,66,719732.0,3877,193.85,80268,719732
1000000,66,899571.0,4550,227.5,100429,899571
2,67,1.0,2,0.1,1,1
3,67,2.0,3,0.15,1,2
100,67,88.0,100,5.0,12,88
200,67,178.0,200,10.0,22,178
2000,67,1767.0,538,26.9,233,1767
10000,67,8982.0,572,28.6,1018,8982
20000,67,18005.0,611,30.55,1995,18005
40000,67,35997.0,685,34.25,4003,35997
60000,67,53963.0,744,37.2,6037,53963
80000,67,71933.0,819,40.95,8067,71933
100000,67,89940.0,881,44.05,10060,89940
200000,67,180042.0,1192,59.6,19958,180042
400000,67,359972.0,1865,93.25,40028,359972
600000,67,540091.0,2559,127.95,59909,540091
800000,67,720088.0,3229,161.45,79912,720088
1000000,67,900167.0,3920,196.0,99833,900167
2,68,2.0,2,0.1,0,2
3,68,3.0,3,0.15,0,3
100,68,85.0,100,5.0,15,85
200,68,175.0,200,10.0,25,175
2000,68,1748.0,1975,98.75,252,1748
10000,68,8697.0,5869,293.45,1303,8697
20000,68,17669.0,5897,294.85,2331,17669
40000,68,35772.0,5958,297.9,4228,35772
60000,68,53785.0,6024,301.2,6215,53785
80000,68,71863.0,6096,304.8,8137,71863
100000,68,89923.0,6168,308.4,10077,89923
200000,68,179959.0,6498,324.9,20041,179959
400000,68,359985.0,7183,359.15,40015,359985
600000,68,539843.0,7856,392.8,60157,539843
800000,68,719867.0,8479,423.95,80133,719867
1000000,68,900114.0,9134,456.7,99886,900114
2,69,2.0,2,0.1,0,2
3,69,3.0,3,0.15,0,3
100,69,87.0,100,5.0,13,87
200,69,175.0,200,10.0,25,175
2000,69,1721.0,1994,99.7,279,1721
10000,69,8508.0,9980,499.0,1492,8508
20000,69,17001.0,19971,998.55,2999,17001
40000,69,34887.0,22739,1136.95,5113,34887
60000,69,52903.0,22805,1140.25,7097,52903
80000,69,70839.0,22862,1143.1,9161,70839
100000,69,88835.0,22916,1145.8,11165,88835
200000,69,178885.0,23258,1162.9,21115,178885
400000,69,358810.0,23888,1194.4,41190,358810
600000,69,539218.0,24567,1228.35,60782,539218
800000,69,719263.0,25242,1262.1,80737,719263
1000000,69,899213.0,25891,1294.55,100787,899213
2,70,2.0,2,0.1,0,2
3,70,3.0,3,0.15,0,3
100,70,89.0,100,5.0,11,89
200,70,173.0,193,9.65,27,173
2000,70,1717.0,1990,99.5,283,1717
10000,70,8465.0,9979,498.95,1535,8465
20000,70,17053.0,19961,998.05,2947,17053
40000,70,34020.0,39920,1996.0,5980,34020
60000,70,51674.0,47017,2350.85,8326,51674
80000,70,69663.0,47087,2354.35,10337,69663
100000,70,87659.0,47155,2357.75,12341,87659
200000,70,177515.0,47515,2375.75,22485,177515
400000,70,357682.0,48187,2409.35,42318,357682
600000,70,537570.0,48904,2445.2,62430,537570
800000,70,717236.0,49615,2480.75,82764,717236
1000000,70,897168.0,50334,2516.7,102832,897168
2,71,2.0,2,0.1,0,2
3,71,3.0,3,0.15,0,3
100,71,83.0,100,5.0,17,83
200,71,171.0,200,10.0,29,171
2000,71,1689.0,1990,99.5,311,1689
10000,71,8470.0,9916,495.8,1530,8470
20000,71,17384.0,10469,523.45,2616,17384
40000,71,35363.0,10527,526.35,4637,35363
60000,71,53424.0,10596,529.8,6576,53424
80000,71,71365.0,10653,532.65,8635,71365
100000,71,89380.0,10720,536.0,10620,89380
200000,71,179505.0,11059,552.95,20495,179505
400000,71,359405.0,11751,587.55,40595,359405
600000,71,539145.0,12404,620.2,60855,539145
800000,71,718944.0,13106,655.3,81056,718944
1000000,71,898967.0,13829,691.45,101033,898967
2,72,2.0,2,0.1,0,2
3,72,3.0,3,0.15,0,3
100,72,86.0,100,5.0,14,86
200,72,166.0,200,10.0,34,166
2000,72,1703.0,1989,99.45,297,1703
10000,72,8809.0,3146,157.3,1191,8809
20000,72,17797.0,3177,158.85,2203,17797
40000,72,35778.0,3223,161.15,4222,35778
60000,72,53719.0,3289,164.45,6281,53719
80000,72,71756.0,3361,168.05,8244,71756
100000,72,89755.0,3425,171.25,10245,89755
200000,72,179780.0,3746,187.3,20220,179780
400000,72,359946.0,4380,219.0,40054,359946
600000,72,540032.0,5035,251.75,59968,540032
800000,72,720141.0,5701,285.05,79859,720141
1000000,72,900133.0,6366,318.3,99867,900133
2,73,2.0,2,0.1,0,2
3,73,3.0,3,0.15,0,3
100,73,87.0,100,5.0,13,87
200,73,174.0,200,10.0,26,174
2000,73,1715.0,1975,98.75,285,1715
10000,73,8580.0,8693,434.65,1420,8580
20000,73,17573.0,8744,437.2,2427,17573
40000,73,35598.0,8887,444.35,4402,35598
60000,73,53554.0,8987,449.35,6446,53554
80000,73,71496.0,9060,453.0,8504,71496
100000,73,89552.0,9115,455.75,10448,89552
200000,73,179603.0,9467,473.35,20397,179603
400000,73,359363.0,10131,506.55,40637,359363
600000,73,539293.0,10889,544.45,60707,539293
800000,73,719168.0,11563,578.15,80832,719168
1000000,73,898988.0,12244,612.2,101012,898988
2,74,2.0,2,0.1,0,2
3,74,3.0,3,0.15,0,3
100,74,91.0,100,5.0,9,91
200,74,176.0,180,9.0,24,176
2000,74,1788.0,323,16.15,212,1788
10000,74,8994.0,338,16.9,1006,8994
20000,74,18062.0,366,18.3,1938,18062
40000,74,36031.0,425,21.25,3969,36031
60000,74,54030.0,490,24.5,5970,54030
80000,74,72081.0,563,28.15,7919,72081
100000,74,90163.0,633,31.65,9837,90163
200000,74,180201.0,992,49.6,19799,180201
400000,74,360099.0,1628,81.4,39901,360099
600000,74,540047.0,2303,115.15,59953,540047
800000,74,720032.0,3010,150.5,79968,720032
1000000,74,899899.0,3704,185.2,100101,899899
2,75,2.0,2,0.1,0,2
3,75,3.0,3,0.15,0,3
100,75,87.0,100,5.0,13,87
200,75,169.0,195,9.75,31,169
2000,75,1735.0,744,37.2,265,1735
10000,75,8894.0,820,41.0,1106,8894
20000,75,17913.0,859,42.95,2087,17913
40000,75,35946.0,929,46.45,4054,35946
60000,75,53873.0,1000,50.0,6127,53873
80000,75,71832.0,1051,52.55,8168,71832
100000,75,89845.0,1121,56.05,10155,89845
200000,75,179777.0,1458,72.9,20223,179777
400000,75,359616.0,2141,107.05,40384,359616
600000,75,539352.0,2813,140.65,60648,539352
800000,75,719497.0,3453,172.65,80503,719497
1000000,75,899235.0,4166,208.3,100765,899235
2,76,2.0,2,0.1,0,2
3,76,3.0,3,0.15,0,3
100,76,87.0,28,1.4,13,87
200,76,183.0,28,1.4,17,183
2000,76,1800.0,36,1.8,200,1800
10000,76,9001.0,60,3.0,999,9001
20000,76,18038.0,101,5.05,1962,18038
40000,76,36042.0,171,8.55,3958,36042
60000,76,54018.0,230,11.5,5982,54018
80000,76,71966.0,306,15.3,8034,71966
100000,76,90006.0,373,18.65,9994,90006
200000,76,179867.0,710,35.5,20133,179867
400000,76,359939.0,1352,67.6,40061,359939
600000,76,539812.0,1988,99.4,60188,539812
800000,76,719839.0,2648,132.4,80161,719839
1000000,76,900089.0,3280,164.0,99911,900089
2,77,1.0,2,0.1,1,1
3,77,1.0,3,0.15,2,1
100,77,87.0,100,5.0,13,87
200,77,173.0,200,10.0,27,173
2000,77,1772.0,531,26.55,228,1772
10000,77,8959.0,560,28.0,1041,8959
20000,77,17973.0,595,29.75,2027,17973
40000,77,35926.0,663,33.15,4074,35926
60000,77,53982.0,724,36.2,6018,53982
80000,77,71983.0,781,39.05,8017,71983
100000,77,89934.0,835,41.75,10066,89934
200000,77,179801.0,1161,58.05,20199,179801
400000,77,359951.0,1804,90.2,40049,359951
600000,77,539958.0,2483,124.15,60042,539958
800000,77,719766.0,3143,157.15,80234,719766
1000000,77,899705.0,3806,190.3,100295,899705
2,78,2.0,2,0.1,0,2
3,78,3.0,3,0.15,0,3
100,78,81.0,100,5.0,19,81
200,78,168.0,200,10.0,32,168
2000,78,1730.0,1995,99.75,270,1730
10000,78,8542.0,9980,499.0,1458,8542
20000,78,17010.0,19963,998.15,2990,17010
40000,78,34243.0,36180,1809.0,5757,34243
60000,78,52193.0,36244,1812.2,7807,52193
80000,78,70192.0,36304,1815.2,9808,70192
100000,78,88165.0,36391,1819.55,11835,88165
200000,78,178184.0,36732,1836.6,21816,178184
400000,78,357909.0,37380,1869.0,42091,357909
600000,78,537974.0,38047,1902.35,62026,537974
800000,78,717752.0,38747,1937.35,82248,717752
1000000,78,897548.0,39437,1971.85,102452,897548
2,79,2.0,2,0.1,0,2
3,79,3.0,3,0.15,0,3
100,79,85.0,100,5.0,15,85
200,79,168.0,200,10.0,32,168
2000,79,1725.0,2000,100.0,275,1725
10000,79,8507.0,9978,498.9,1493,8507
20000,79,17029.0,19964,998.2,2971,17029
40000,79,34050.0,39915,1995.75,5950,34050
60000,79,51516.0,50119,2505.95,8484,51516
80000,79,69504.0,50182,2509.1,10496,69504
100000,79,87403.0,50253,2512.65,12597,87403
200000,79,177332.0,50615,2530.75,22668,177332
400000,79,357074.0,51325,2566.25,42926,357074
600000,79,536934.0,51987,2599.35,63066,536934
800000,79,716723.0,52656,2632.8,83277,716723
1000000,79,896722.0,53283,2664.15,103278,896722
2,80,2.0,2,0.1,0,2
3,80,3.0,3,0.15,0,3
100,80,83.0,100,5.0,17,83
200,80,170.0,200,10.0,30,170
2000,80,1700.0,1999,99.95,300,1700
10000,80,8479.0,9983,499.15,1521,8479
20000,80,16926.0,19964,998.2,3074,16926
40000,80,33959.0,39917,1995.85,6041,33959
60000,80,51033.0,59884,2994.2,8967,51033
80000,80,68050.0,79861,3993.05,11950,68050
100000,80,85027.0,99783,4989.15,14973,85027
200000,80,174850.0,103419,5170.95,25150,174850
400000,80,354748.0,104091,5204.55,45252,354748
600000,80,534616.0,104752,5237.6,65384,534616
800000,80,714760.0,105398,5269.9,85240,714760
1000000,80,894798.0,106065,5303.25,105202,894798
2,81,2.0,2,0.1,0,2
3,81,3.0,3,0.15,0,3
100,81,87.0,100,5.0,13,87
200,81,176.0,200,10.0,24,176
2000,81,1696.0,2000,100.0,304,1696
10000,81,8555.0,9975,498.75,1445,8555
20000,81,17071.0,19953,997.65,2929,17071
40000,81,34035.0,39915,1995.75,5965,34035
60000,81,51155.0,59884,2994.2,8845,51155
80000,81,68640.0,69279,3463.95,11360,68640
100000,81,86703.0,69356,3467.8,13297,86703
200000,81,176608.0,69681,3484.05,23392,176608
400000,81,356451.0,70404,3520.2,43549,356451
600000,81,536810.0,71057,3552.85,63190,536810
800000,81,716890.0,71733,3586.65,83110,716890
1000000,81,896734.0,72400,3620.0,103266,896734
2,82,2.0,2,0.1,0,2
3,82,3.0,3,0.15,0,3
100,82,90.0,100,5.0,10,90
200,82,169.0,200,10.0,31,169
2000,82,1769.0,606,30.3,231,1769
10000,82,8958.0,653,32.65,1042,8958
20000,82,17912.0,680,34.0,2088,17912
40000,82,35905.0,734,36.7,4095,35905
60000,82,53861.0,814,40.7,6139,53861
80000,82,71929.0,896,44.8,8071,71929
100000,82,89950.0,963,48.15,10050,89950
200000,82,179885.0,1296,64.8,20115,179885
400000,82,359996.0,1978,98.9,40004,359996
600000,82,539934.0,2698,134.9,60066,539934
800000,82,720078.0,3352,167.6,79922,720078
1000000,82,900150.0,3999,199.95,99850,900150
2,83,2.0,2,0.1,0,2
3,83,3.0,3,0.15,0,3
100,83,78.0,100,5.0,22,78
200,83,166.0,161,8.05,34,166
2000,83,1796.0,163,8.15,204,1796
10000,83,8999.0,218,10.9,1001,8999
20000,83,18027.0,246,12.3,1973,18027
40000,83,35964.0,323,16.15,4036,35964
60000,83,54009.0,380,19.0,5991,54009
80000,83,72085.0,436,21.8,7915,72085
100000,83,90021.0,485,24.25,9979,90021
200000,83,179893.0,780,39.0,20107,179893
400000,83,359979.0,1404,70.2,40021,359979
600000,83,539881.0,2041,102.05,60119,539881
800000,83,719988.0,2723,136.15,80012,719988
1000000,83,899805.0,3409,170.45,100195,899805
2,84,2.0,2,0.1,0,2
3,84,3.0,3,0.15,0,3
100,84,82.0,100,5.0,18,82
200,84,174.0,112,5.6,26,174
2000,84,1813.0,115,5.75,187,1813
10000,84,9027.0,143,7.15,973,9027
20000,84,18011.0,163,8.15,1989,18011
40000,84,35922.0,240,12.0,4078,35922
60000,84,53919.0,316,15.8,6081,53919
80000,84,71871.0,390,19.5,8129,71871
100000,84,89892.0,456,22.8,10108,89892
200000,84,179802.0,811,40.55,20198,179802
400000,84,359718.0,1498,74.9,40282,359718
600000,84,539615.0,2170,108.5,60385,539615
800000,84,719652.0,2813,140.65,80348,719652
1000000,84,899670.0,3433,171.65,100330,899670
2,85,2.0,2,0.1,0,2
3,85,3.0,3,0.15,0,3
100,85,85.0,99,4.95,15,85
200,85,170.0,199,9.95,30,170
2000,85,1714.0,1994,99.7,286,1714
10000,85,8538.0,9959,497.95,1462,8538
20000,85,17079.0,19228,961.4,2921,17079
40000,85,35072.0,19281,964.05,4928,35072
60000,85,53133.0,19347,967.35,6867,53133
80000,85,71143.0,19397,969.85,8857,71143
100000,85,89096.0,19470,973.5,10904,89096
200000,85,179127.0,19800,990.0,20873,179127
400000,85,358914.0,20432,1021.6,41086,358914
600000,85,538810.0,21103,1055.15,61190,538810
800000,85,718862.0,21740,1087.0,81138,718862
1000000,85,898908.0,22454,1122.7,101092,898908
2,86,2.0,2,0.1,0,2
3,86,3.0,3,0.15,0,3
100,86,86.0,100,5.0,14,86
200,86,168.0,200,10.0,32,168
2000,86,1687.0,1997,99.85,313,1687
10000,86,8809.0,3667,183.35,1191,8809
20000,86,17811.0,3700,185.0,2189,17811
40000,86,35785.0,3882,194.1,4215,35785
60000,86,53722.0,3946,197.3,6278,53722
80000,86,71757.0,4027,201.35,8243,71757
100000,86,89782.0,4108,205.4,10218,89782
200000,86,179757.0,4437,221.85,20243,179757
400000,86,359680.0,5132,256.6,40320,359680
600000,86,539675.0,5801,290.05,60325,539675
800000,86,719509.0,6474,323.7,80491,719509
1000000,86,899498.0,7145,357.25,100502,899498
2,87,2.0,2,0.1,0,2
3,87,3.0,3,0.15,0,3
100,87,89.0,100,5.0,11,89
200,87,172.0,200,10.0,28,172
2000,87,1720.0,1996,99.8,280,1720
10000,87,8658.0,6985,349.25,1342,8658
20000,87,17648.0,7007,350.35,2352,17648
40000,87,35660.0,7082,354.1,4340,35660
60000,87,53652.0,7163,358.15,6348,53652
80000,87,71656.0,7230,361.5,8344,71656
100000,87,89719.0,7299,364.95,10281,89719
200000,87,179823.0,7640,382.0,20177,179823
400000,87,359786.0,8247,412.35,40214,359786
600000,87,539956.0,8946,447.3,60044,539956
800000,87,720045.0,9525,476.25,79955,720045
1000000,87,900116.0,10146,507.3,99884,900116
2,88,2.0,2,0.1,0,2
3,88,3.0,3,0.15,0,3
100,88,84.0,100,5.0,16,84
200,88,162.0,200,10.0,38,162
2000,88,1704.0,1995,99.75,296,1704
10000,88,8540.0,9981,499.05,1460,8540
20000,88,17044.0,19963,998.15,2956,17044
40000,88,34001.0,39931,1996.55,5999,34001
60000,88,50963.0,59901,2995.05,9037,50963
80000,88,68208.0,74614,3730.7,11792,68208
100000,88,86147.0,74687,3734.35,13853,86147
200000,88,176065.0,74977,3748.85,23935,176065
400000,88,355991.0,75685,3784.25,44009,355991
600000,88,536103.0,76320,3816.0,63897,536103
800000,88,716028.0,77015,3850.75,83972,716028
1000000,88,895957.0,77696,3884.8,104043,895957
2,89,1.0,2,0.1,1,1
3,89,2.0,3,0.15,1,2
100,89,78.0,100,5.0,22,78
200,89,158.0,200,10.0,42,158
2000,89,1775.0,298,14.9,225,1775
10000,89,8968.0,324,16.2,1032,8968
20000,89,17918.0,350,17.5,2082,17918
40000,89,35895.0,423,21.15,4105,35895
60000,89,53896.0,505,25.25,6104,53896
80000,89,71924.0,581,29.05,8076,71924
100000,89,89904.0,634,31.7,10096,89904
200000,89,180033.0,987,49.35,19967,180033
400000,89,360066.0,1626,81.3,39934,360066
600000,89,540030.0,2269,113.45,59970,540030
800000,89,720200.0,2959,147.95,79800,720200
1000000,89,900064.0,3670,183.5,99936,900064
2,90,2.0,2,0.1,0,2
3,90,3.0,3,0.15,0,3
100,90,94.0,100,5.0,6,94
200,90,179.0,134,6.7,21,179
2000,90,1793.0,145,7.25,207,1793
10000,90,8974.0,168,8.4,1026,8974
20000,90,17956.0,199,9.95,2044,17956
40000,90,35939.0,267,13.35,4061,35939
60000,90,53966.0,319,15.95,6034,53966
80000,90,71864.0,377,18.85,8136,71864
100000,90,89938.0,433,21.65,10062,89938
200000,90,179840.0,756,37.8,20160,179840
400000,90,360056.0,1387,69.35,39944,360056
600000,90,539964.0,2019,100.95,60036,539964
800000,90,719985.0,2654,132.7,80015,719985
1000000,90,899735.0,3336,166.8,100265,899735
2,91,2.0,2,0.1,0,2
3,91,3.0,3,0.15,0,3
100,91,90.0,99,4.95,10,90
200,91,171.0,197,9.85,29,171
2000,91,1708.0,1994,99.7,292,1708
10000,91,8553.0,9981,499.05,1447,8553
20000,91,17086.0,19947,997.35,2914,17086
40000,91,34730.0,27925,1396.25,5270,34730
60000,91,52682.0,27988,1399.4,7318,52682
80000,91,70626.0,28040,1402.0,9374,70626
100000,91,88560.0,28105,1405.25,11440,88560
200000,91,178502.0,28436,1421.8,21498,178502
400000,91,358438.0,29105,1455.25,41562,358438
600000,91,538347.0,29752,1487.6,61653,538347
800000,91,718299.0,30409,1520.45,81701,718299
1000000,91,898248.0,31102,1555.1,101752,898248
2,92,2.0,2,0.1,0,2
3,92,3.0,3,0.15,0,3
100,92,83.0,100,5.0,17,83
200,92,171.0,200,10.0,29,171
2000,92,1746.0,965,48.25,254,1746
10000,92,8967.0,997,49.85,1033,8967
20000,92,17926.0,1033,51.65,2074,17926
40000,92,35910.0,1101,55.05,4090,35910
60000,92,53902.0,1178,58.9,6098,53902
80000,92,71974.0,1256,62.8,8026,71974
100000,92,89936.0,1320,66.0,10064,89936
200000,92,179909.0,1649,82.45,20091,179909
400000,92,359861.0,2301,115.05,40139,359861
600000,92,539820.0,2941,147.05,60180,539820
800000,92,719552.0,3623,181.15,80448,719552
1000000,92,899544.0,4258,212.9,100456,899544
2,93,2.0,2,0.1,0,2
3,93,3.0,3,0.15,0,3
100,93,88.0,100,5.0,12,88
200,93,177.0,200,10.0,23,177
2000,93,1715.0,1206,60.3,285,1715
10000,93,8912.0,1226,61.3,1088,8912
20000,93,17928.0,1259,62.95,2072,17928
40000,93,35976.0,1323,66.15,4024,35976
60000,93,53995.0,1382,69.1,6005,53995
80000,93,72064.0,1456,72.8,7936,72064
100000,93,90109.0,1515,75.75,9891,90109
200000,93,179981.0,1837,91.85,20019,179981
400000,93,359966.0,2522,126.1,40034,359966
600000,93,539973.0,3202,160.1,60027,539973
800000,93,719901.0,3872,193.6,80099,719901
1000000,93,899953.0,4510,225.5,100047,899953
2,94,1.0,2,0.1,1,1
3,94,2.0,3,0.15,1,2
100,94,87.0,100,5.0,13,87
200,94,170.0,200,10.0,30,170
2000,94,1709.0,1925,96.25,291,1709
10000,94,8923.0,1954,97.7,1077,8923
20000,94,17889.0,1981,99.05,2111,17889
40000,94,35902.0,2054,102.7,4098,35902
60000,94,53889.0,2123,106.15,6111,53889
80000,94,71917.0,2191,109.55,8083,71917
100000,94,89958.0,2257,112.85,10042,89958
200000,94,179916.0,2602,130.1,20084,179916
400000,94,359723.0,3261,163.05,40277,359723
600000,94,539658.0,3953,197.65,60342,539658
800000,94,719872.0,4632,231.6,80128,719872
1000000,94,899797.0,5267,263.35,100203,899797
2,95,0.0,2,0.1,2,0
3,95,0.0,3,0.15,3,0
100,95,84.0,100,5.0,16,84
200,95,170.0,200,10.0,30,170
2000,95,1704.0,1996,99.8,296,1704
10000,95,8549.0,9975,498.75,1451,8549
20000,95,17379.0,13725,686.25,2621,17379
40000,95,35374.0,13790,689.5,4626,35374
60000,95,53310.0,13848,692.4,6690,53310
80000,95,71262.0,13898,694.9,8738,71262
100000,95,89236.0,13955,697.75,10764,89236
200000,95,179223.0,14298,714.9,20777,179223
400000,95,359076.0,14937,746.85,40924,359076
600000,95,538957.0,15617,780.85,61043,538957
800000,95,718948.0,16259,812.95,81052,718948
1000000,95,898900.0,16936,846.8,101100,898900
2,96,1.0,2,0.1,1,1
3,96,2.0,3,0.15,1,2
100,96,80.0,100,5.0,20,80
200,96,168.0,200,10.0,32,168
2000,96,1680.0,1887,94.35,320,1680
10000,96,8831.0,1914,95.7,1169,8831
20000,96,17818.0,1949,97.45,2182,17818
40000,96,35868.0,2005,100.25,4132,35868
60000,96,53881.0,2073,103.65,6119,53881
80000,96,72000.0,2128,106.4,8000,72000
100000,96,90008.0,2183,109.15,9992,90008
200000,96,180094.0,2526,126.3,19906,180094
400000,96,360074.0,3148,157.4,39926,360074
600000,96,539899.0,3809,190.45,60101,539899
800000,96,719926.0,4482,224.1,80074,719926
1000000,96,899841.0,5127,256.35,100159,899841
2,97,2.0,2,0.1,0,2
3,97,3.0,3,0.15,0,3
100,97,88.0,100,5.0,12,88
200,97,175.0,200,10.0,25,175
2000,97,1710.0,1995,99.75,290,1710
10000,97,8816.0,3770,188.5,1184,8816
20000,97,17789.0,3803,190.15,2211,17789
40000,97,35829.0,3868,193.4,4171,35829
60000,97,53882.0,3930,196.5,6118,53882
80000,97,71891.0,3991,199.55,8109,71891
100000,97,89881.0,4064,203.2,10119,89881
200000,97,179982.0,4419,220.95,20018,179982
400000,97,360069.0,5082,254.1,39931,360069
600000,97,540165.0,5760,288.0,59835,540165
800000,97,720068.0,6447,322.35,79932,720068
1000000,97,900170.0,7140,357.0,99830,900170
2,98,2.0,2,0.1,0,2
3,98,3.0,3,0.15,0,3
100,98,87.0,19,0.95,13,87
200,98,177.0,20,1.0,23,177
2000,98,1791.0,26,1.3,209,1791
10000,98,8978.0,52,2.6,1022,8978
20000,98,17981.0,90,4.5,2019,17981
40000,98,35976.0,155,7.75,4024,35976
60000,98,54003.0,217,10.85,5997,54003
80000,98,72033.0,288,14.4,7967,72033
100000,98,90059.0,353,17.65,9941,90059
200000,98,180030.0,690,34.5,19970,180030
400000,98,359785.0,1344,67.2,40215,359785
600000,98,539886.0,2012,100.6,60114,539886
800000,98,719776.0,2713,135.65,80224,719776
1000000,98,899695.0,3395,169.75,100305,899695
2,99,0.0,2,0.1,2,0
3,99,1.0,3,0.15,2,1
100,99,85.0,100,5.0,15,85
200,99,167.0,200,10.0,33,167
2000,99,1772.0,440,22.0,228,1772
10000,99,8982.0,454,22.7,1018,8982
20000,99,17989.0,486,24.3,2011,17989
40000,99,35947.0,548,27.4,4053,35947
60000,99,53973.0,612,30.6,6027,53973
80000,99,72014.0,674,33.7,7986,72014
100000,99,90010.0,742,37.1,9990,90010
200000,99,180061.0,1091,54.55,19939,180061
400000,99,359764.0,1743,87.15,40236,359764
600000,99,539697.0,2424,121.2,60303,539697
800000,99,719570.0,3086,154.3,80430,719570
1000000,99,899692.0,3750,187.5,100308,899692
2,100,2.0,2,0.1,0,2
3,100,3.0,3,0.15,0,3
100,100,90.0,100,5.0,10,90
200,100,174.0,178,8.9,26,174
2000,100,1790.0,180,9.0,210,1790
10000,100,8977.0,212,10.6,1023,8977
20000,100,17936.0,238,11.9,2064,17936
40000,100,36038.0,302,15.1,3962,36038
60000,100,54058.0,358,17.9,5942,54058
80000,100,72045.0,436,21.8,7955,72045
100000,100,90019.0,507,25.35,9981,90019
200000,100,180030.0,875,43.75,19970,180030
400000,100,359778.0,1514,75.7,40222,359778
600000,100,539864.0,2176,108.8,60136,539864
800000,100,719812.0,2861,143.05,80188,719812
1000000,100,899575.0,3509,175.45,100425,899575
