Timestep,Iteration,Total Reward,Suboptimal Arms,Total Regret,Zeros Count,Ones Count
2,1,2.0,1,0.09,0,2
3,1,3.0,2,0.18,0,3
100,1,88.0,65,5.85,12,88
200,1,173.0,125,11.25,27,173
2000,1,1705.0,653,58.77,295,1705
10000,1,8759.0,1224,110.16,1241,8759
20000,1,17651.0,1364,122.76,2349,17651
40000,1,35461.0,1472,132.48,4539,35461
60000,1,53167.0,1539,138.51,6833,53167
80000,1,71049.0,1686,151.74,8951,71049
100000,1,88851.0,1704,153.36,11149,88851
200000,1,177703.0,2028,182.52,22297,177703
400000,1,355640.0,2325,209.25,44360,355640
600000,1,533880.0,2395,215.55,66120,533880
800000,1,711890.0,2423,218.07,88110,711890
1000000,1,889974.0,2457,221.13,110026,889974
2,2,2.0,1,0.09,0,2
3,2,3.0,2,0.18,0,3
100,2,74.0,68,6.12,26,74
200,2,158.0,125,11.25,42,158
2000,2,1707.0,655,58.95,293,1707
10000,2,8820.0,1025,92.25,1180,8820
20000,2,17692.0,1182,106.38,2308,17692
40000,2,35529.0,1374,123.66,4471,35529
60000,2,53330.0,1416,127.44,6670,53330
80000,2,71036.0,1520,136.8,8964,71036
100000,2,88769.0,1575,141.75,11231,88769
200000,2,177584.0,1724,155.16,22416,177584
400000,2,355633.0,1840,165.6,44367,355633
600000,2,533662.0,1863,167.67,66338,533662
800000,2,711733.0,1903,171.27,88267,711733
1000000,2,889883.0,1947,175.23,110117,889883
2,3,1.0,1,0.09,1,1
3,3,1.0,2,0.18,2,1
100,3,84.0,64,5.76,16,84
200,3,169.0,121,10.89,31,169
2000,3,1738.0,595,53.55,262,1738
10000,3,8825.0,1190,107.1,1175,8825
20000,3,17687.0,1571,141.39,2313,17687
40000,3,35442.0,1997,179.73,4558,35442
60000,3,53235.0,2146,193.14,6765,53235
80000,3,71071.0,2183,196.47,8929,71071
100000,3,88904.0,2211,198.99,11096,88904
200000,3,177879.0,2395,215.55,22121,177879
400000,3,355842.0,2647,238.23,44158,355842
600000,3,533882.0,2726,245.34,66118,533882
800000,3,712006.0,2784,250.56,87994,712006
1000000,3,889946.0,2836,255.24,110054,889946
2,4,2.0,1,0.09,0,2
3,4,3.0,2,0.18,0,3
100,4,79.0,62,5.58,21,79
200,4,162.0,118,10.62,38,162
2000,4,1705.0,770,69.3,295,1705
10000,4,8701.0,1430,128.7,1299,8701
20000,4,17643.0,1545,139.05,2357,17643
40000,4,35452.0,1624,146.16,4548,35452
60000,4,53213.0,1753,157.77,6787,53213
80000,4,70953.0,1779,160.11,9047,70953
100000,4,88715.0,1866,167.94,11285,88715
200000,4,177601.0,1964,176.76,22399,177601
400000,4,355552.0,2130,191.7,44448,355552
600000,4,533698.0,2169,195.21,66302,533698
800000,4,711544.0,2202,198.18,88456,711544
1000000,4,889512.0,2239,201.51,110488,889512
2,5,1.0,1,0.09,1,1
3,5,2.0,2,0.18,1,2
100,5,86.0,66,5.94,14,86
200,5,173.0,127,11.43,27,173
2000,5,1703.0,867,78.03,297,1703
10000,5,8748.0,1422,127.98,1252,8748
20000,5,17592.0,1609,144.81,2408,17592
40000,5,35374.0,1846,166.14,4626,35374
60000,5,53165.0,2031,182.79,6835,53165
80000,5,70882.0,2105,189.45,9118,70882
100000,5,88644.0,2219,199.71,11356,88644
200000,5,177583.0,2452,220.68,22417,177583
400000,5,355599.0,2502,225.18,44401,355599
600000,5,533674.0,2565,230.85,66326,533674
800000,5,711430.0,2600,234.0,88570,711430
1000000,5,889385.0,2633,236.97,110615,889385
2,6,2.0,1,0.09,0,2
3,6,3.0,2,0.18,0,3
100,6,89.0,66,5.94,11,89
200,6,176.0,129,11.61,24,176
2000,6,1749.0,799,71.91,251,1749
10000,6,8833.0,1463,131.67,1167,8833
20000,6,17692.0,1745,157.05,2308,17692
40000,6,35468.0,1965,176.85,4532,35468
60000,6,53224.0,2046,184.14,6776,53224
80000,6,71031.0,2084,187.56,8969,71031
100000,6,88828.0,2127,191.43,11172,88828
200000,6,177875.0,2398,215.82,22125,177875
400000,6,355799.0,2495,224.55,44201,355799
600000,6,533740.0,2530,227.7,66260,533740
800000,6,711519.0,2562,230.58,88481,711519
1000000,6,889633.0,2609,234.81,110367,889633
2,7,1.0,1,0.09,1,1
3,7,2.0,2,0.18,1,2
100,7,78.0,61,5.49,22,78
200,7,158.0,121,10.89,42,158
2000,7,1709.0,656,59.04,291,1709
10000,7,8766.0,1320,118.8,1234,8766
20000,7,17649.0,1470,132.3,2351,17649
40000,7,35442.0,1826,164.34,4558,35442
60000,7,53236.0,1957,176.13,6764,53236
80000,7,71046.0,2006,180.54,8954,71046
100000,7,88833.0,2039,183.51,11167,88833
200000,7,177947.0,2242,201.78,22053,177947
400000,7,356123.0,2334,210.06,43877,356123
600000,7,534226.0,2385,214.65,65774,534226
800000,7,712164.0,2497,224.73,87836,712164
1000000,7,890204.0,2521,226.89,109796,890204
2,8,2.0,1,0.09,0,2
3,8,3.0,2,0.18,0,3
100,8,83.0,65,5.85,17,83
200,8,165.0,115,10.35,35,165
2000,8,1715.0,762,68.58,285,1715
10000,8,8773.0,1443,129.87,1227,8773
20000,8,17606.0,1634,147.06,2394,17606
40000,8,35398.0,1924,173.16,4602,35398
60000,8,53205.0,2057,185.13,6795,53205
80000,8,71013.0,2143,192.87,8987,71013
100000,8,88822.0,2161,194.49,11178,88822
200000,8,177749.0,2285,205.65,22251,177749
400000,8,355621.0,2346,211.14,44379,355621
600000,8,533683.0,2439,219.51,66317,533683
800000,8,711662.0,2455,220.95,88338,711662
1000000,8,889688.0,2510,225.9,110312,889688
2,9,2.0,1,0.09,0,2
3,9,3.0,2,0.18,0,3
100,9,83.0,65,5.85,17,83
200,9,167.0,126,11.34,33,167
2000,9,1702.0,782,70.38,298,1702
10000,9,8800.0,1083,97.47,1200,8800
20000,9,17682.0,1264,113.76,2318,17682
40000,9,35557.0,1465,131.85,4443,35557
60000,9,53404.0,1599,143.91,6596,53404
80000,9,71123.0,1711,153.99,8877,71123
100000,9,88899.0,1791,161.19,11101,88899
200000,9,177910.0,1852,166.68,22090,177910
400000,9,355811.0,2002,180.18,44189,355811
600000,9,533958.0,2061,185.49,66042,533958
800000,9,712071.0,2084,187.56,87929,712071
1000000,9,889919.0,2091,188.19,110081,889919
2,10,2.0,1,0.09,0,2
3,10,3.0,2,0.18,0,3
100,10,85.0,65,5.85,15,85
200,10,170.0,128,11.52,30,170
2000,10,1742.0,838,75.42,258,1742
10000,10,8810.0,1696,152.64,1190,8810
20000,10,17618.0,2003,180.27,2382,17618
40000,10,35401.0,2165,194.85,4599,35401
60000,10,53126.0,2319,208.71,6874,53126
80000,10,70902.0,2335,210.15,9098,70902
100000,10,88711.0,2380,214.2,11289,88711
200000,10,177676.0,2512,226.08,22324,177676
400000,10,355409.0,2703,243.27,44591,355409
600000,10,533446.0,2813,253.17,66554,533446
800000,10,711727.0,2845,256.05,88273,711727
1000000,10,889731.0,2933,263.97,110269,889731
2,11,2.0,1,0.09,0,2
3,11,3.0,2,0.18,0,3
100,11,87.0,66,5.94,13,87
200,11,172.0,123,11.07,28,172
2000,11,1732.0,791,71.19,268,1732
10000,11,8825.0,1284,115.56,1175,8825
20000,11,17706.0,1476,132.84,2294,17706
40000,11,35487.0,1712,154.08,4513,35487
60000,11,53264.0,1889,170.01,6736,53264
80000,11,71039.0,1937,174.33,8961,71039
100000,11,88779.0,1988,178.92,11221,88779
200000,11,177967.0,2061,185.49,22033,177967
400000,11,355968.0,2165,194.85,44032,355968
600000,11,533924.0,2233,200.97,66076,533924
800000,11,712065.0,2264,203.76,87935,712065
1000000,11,890011.0,2333,209.97,109989,890011
2,12,2.0,1,0.09,0,2
3,12,3.0,2,0.18,0,3
100,12,84.0,67,6.03,16,84
200,12,171.0,134,12.06,29,171
2000,12,1698.0,770,69.3,302,1698
10000,12,8730.0,1574,141.66,1270,8730
20000,12,17576.0,1903,171.27,2424,17576
40000,12,35336.0,2044,183.96,4664,35336
60000,12,53138.0,2150,193.5,6862,53138
80000,12,70947.0,2176,195.84,9053,70947
100000,12,88832.0,2184,196.56,11168,88832
200000,12,177879.0,2532,227.88,22121,177879
400000,12,355858.0,2794,251.46,44142,355858
600000,12,533773.0,2860,257.4,66227,533773
800000,12,711573.0,2924,263.16,88427,711573
1000000,12,889574.0,3000,270.0,110426,889574
2,13,1.0,1,0.09,1,1
3,13,2.0,2,0.18,1,2
100,13,78.0,64,5.76,22,78
200,13,159.0,123,11.07,41,159
2000,13,1694.0,812,73.08,306,1694
10000,13,8760.0,1375,123.75,1240,8760
20000,13,17619.0,1697,152.73,2381,17619
40000,13,35430.0,1922,172.98,4570,35430
60000,13,53196.0,2018,181.62,6804,53196
80000,13,70985.0,2228,200.52,9015,70985
100000,13,88795.0,2245,202.05,11205,88795
200000,13,177860.0,2389,215.01,22140,177860
400000,13,355916.0,2552,229.68,44084,355916
600000,13,533859.0,2719,244.71,66141,533859
800000,13,711768.0,2744,246.96,88232,711768
1000000,13,889678.0,2763,248.67,110322,889678
2,14,1.0,1,0.09,1,1
3,14,2.0,2,0.18,1,2
100,14,73.0,66,5.94,27,73
200,14,153.0,128,11.52,47,153
2000,14,1703.0,701,63.09,297,1703
10000,14,8792.0,1191,107.19,1208,8792
20000,14,17643.0,1452,130.68,2357,17643
40000,14,35369.0,1599,143.91,4631,35369
60000,14,53230.0,1617,145.53,6770,53230
80000,14,71012.0,1689,152.01,8988,71012
100000,14,88857.0,1756,158.04,11143,88857
200000,14,177753.0,1825,164.25,22247,177753
400000,14,355539.0,2006,180.54,44461,355539
600000,14,533469.0,2090,188.1,66531,533469
800000,14,711469.0,2106,189.54,88531,711469
1000000,14,889478.0,2184,196.56,110522,889478
2,15,1.0,1,0.09,1,1
3,15,2.0,2,0.18,1,2
100,15,80.0,66,5.94,20,80
200,15,164.0,128,11.52,36,164
2000,15,1705.0,753,67.77,295,1705
10000,15,8709.0,1699,152.91,1291,8709
20000,15,17571.0,1794,161.46,2429,17571
40000,15,35355.0,1950,175.5,4645,35355
60000,15,53054.0,2072,186.48,6946,53054
80000,15,70832.0,2117,190.53,9168,70832
100000,15,88565.0,2203,198.27,11435,88565
200000,15,177666.0,2314,208.26,22334,177666
400000,15,355666.0,2555,229.95,44334,355666
600000,15,533822.0,2588,232.92,66178,533822
800000,15,711752.0,2643,237.87,88248,711752
1000000,15,889830.0,2669,240.21,110170,889830
2,16,2.0,1,0.09,0,2
3,16,3.0,2,0.18,0,3
100,16,90.0,65,5.85,10,90
200,16,174.0,134,12.06,26,174
2000,16,1721.0,751,67.59,279,1721
10000,16,8793.0,1406,126.54,1207,8793
20000,16,17721.0,1627,146.43,2279,17721
40000,16,35444.0,1794,161.46,4556,35444
60000,16,53194.0,2060,185.4,6806,53194
80000,16,70946.0,2135,192.15,9054,70946
100000,16,88729.0,2152,193.68,11271,88729
200000,16,177643.0,2390,215.1,22357,177643
400000,16,355729.0,2497,224.73,44271,355729
600000,16,533623.0,2550,229.5,66377,533623
800000,16,711605.0,2590,233.1,88395,711605
1000000,16,889844.0,2674,240.66,110156,889844
2,17,2.0,1,0.09,0,2
3,17,3.0,2,0.18,0,3
100,17,84.0,66,5.94,16,84
200,17,168.0,129,11.61,32,168
2000,17,1726.0,804,72.36,274,1726
10000,17,8838.0,1305,117.45,1162,8838
20000,17,17715.0,1561,140.49,2285,17715
40000,17,35452.0,1740,156.6,4548,35452
60000,17,53272.0,1877,168.93,6728,53272
80000,17,71014.0,2002,180.18,8986,71014
100000,17,88763.0,2085,187.65,11237,88763
200000,17,177645.0,2307,207.63,22355,177645
400000,17,355485.0,2371,213.39,44515,355485
600000,17,533378.0,2459,221.31,66622,533378
800000,17,711312.0,2483,223.47,88688,711312
1000000,17,889290.0,2527,227.43,110710,889290
2,18,1.0,1,0.09,1,1
3,18,2.0,2,0.18,1,2
100,18,80.0,63,5.67,20,80
200,18,167.0,123,11.07,33,167
2000,18,1712.0,833,74.97,288,1712
10000,18,8772.0,1510,135.9,1228,8772
20000,18,17710.0,1740,156.6,2290,17710
40000,18,35464.0,1961,176.49,4536,35464
60000,18,53244.0,2081,187.29,6756,53244
80000,18,71068.0,2110,189.9,8932,71068
100000,18,88846.0,2151,193.59,11154,88846
200000,18,177813.0,2324,209.16,22187,177813
400000,18,355787.0,2447,220.23,44213,355787
600000,18,533950.0,2503,225.27,66050,533950
800000,18,711792.0,2589,233.01,88208,711792
1000000,18,889920.0,2609,234.81,110080,889920
2,19,2.0,1,0.09,0,2
3,19,2.0,2,0.18,1,2
100,19,85.0,66,5.94,15,85
200,19,174.0,123,11.07,26,174
2000,19,1713.0,711,63.99,287,1713
10000,19,8765.0,1266,113.94,1235,8765
20000,19,17671.0,1425,128.25,2329,17671
40000,19,35410.0,1762,158.58,4590,35410
60000,19,53239.0,1812,163.08,6761,53239
80000,19,70962.0,1919,172.71,9038,70962
100000,19,88786.0,1969,177.21,11214,88786
200000,19,177890.0,2088,187.92,22110,177890
400000,19,355905.0,2246,202.14,44095,355905
600000,19,533882.0,2335,210.15,66118,533882
800000,19,711882.0,2432,218.88,88118,711882
1000000,19,889704.0,2476,222.84,110296,889704
2,20,1.0,1,0.09,1,1
3,20,2.0,2,0.18,1,2
100,20,81.0,64,5.76,19,81
200,20,159.0,118,10.62,41,159
2000,20,1708.0,758,68.22,292,1708
10000,20,8794.0,1275,114.75,1206,8794
20000,20,17690.0,1423,128.07,2310,17690
40000,20,35442.0,1655,148.95,4558,35442
60000,20,53254.0,1722,154.98,6746,53254
80000,20,71090.0,1963,176.67,8910,71090
100000,20,88841.0,2030,182.7,11159,88841
200000,20,177866.0,2188,196.92,22134,177866
400000,20,355839.0,2288,205.92,44161,355839
600000,20,533745.0,2383,214.47,66255,533745
800000,20,711797.0,2409,216.81,88203,711797
1000000,20,889577.0,2428,218.52,110423,889577
2,21,2.0,1,0.09,0,2
3,21,3.0,2,0.18,0,3
100,21,80.0,63,5.67,20,80
200,21,171.0,126,11.34,29,171
2000,21,1745.0,791,71.19,255,1745
10000,21,8771.0,1648,148.32,1229,8771
20000,21,17702.0,1801,162.09,2298,17702
40000,21,35487.0,1981,178.29,4513,35487
60000,21,53304.0,2081,187.29,6696,53304
80000,21,71095.0,2165,194.85,8905,71095
100000,21,88896.0,2185,196.65,11104,88896
200000,21,177790.0,2408,216.72,22210,177790
400000,21,355726.0,2635,237.15,44274,355726
600000,21,533642.0,2694,242.46,66358,533642
800000,21,711545.0,2826,254.34,88455,711545
1000000,21,889457.0,2848,256.32,110543,889457
2,22,1.0,1,0.09,1,1
3,22,2.0,2,0.18,1,2
100,22,87.0,65,5.85,13,87
200,22,174.0,129,11.61,26,174
2000,22,1717.0,860,77.4,283,1717
10000,22,8732.0,1451,130.59,1268,8732
20000,22,17646.0,1567,141.03,2354,17646
40000,22,35436.0,1768,159.12,4564,35436
60000,22,53234.0,1833,164.97,6766,53234
80000,22,70977.0,1948,175.32,9023,70977
100000,22,88842.0,1969,177.21,11158,88842
200000,22,177848.0,2202,198.18,22152,177848
400000,22,356015.0,2396,215.64,43985,356015
600000,22,533951.0,2494,224.46,66049,533951
800000,22,711672.0,2666,239.94,88328,711672
1000000,22,889614.0,2719,244.71,110386,889614
2,23,2.0,1,0.09,0,2
3,23,3.0,2,0.18,0,3
100,23,84.0,65,5.85,16,84
200,23,165.0,122,10.98,35,165
2000,23,1730.0,749,67.41,270,1730
10000,23,8846.0,1410,126.9,1154,8846
20000,23,17686.0,1766,158.94,2314,17686
40000,23,35550.0,2142,192.78,4450,35550
60000,23,53340.0,2323,209.07,6660,53340
80000,23,71161.0,2430,218.7,8839,71161
100000,23,88977.0,2453,220.77,11023,88977
200000,23,177893.0,2771,249.39,22107,177893
400000,23,355772.0,2962,266.58,44228,355772
600000,23,533811.0,3036,273.24,66189,533811
800000,23,711911.0,3175,285.75,88089,711911
1000000,23,890226.0,3181,286.29,109774,890226
2,24,2.0,1,0.09,0,2
3,24,3.0,2,0.18,0,3
100,24,76.0,64,5.76,24,76
200,24,153.0,123,11.07,47,153
2000,24,1737.0,598,53.82,263,1737
10000,24,8795.0,1085,97.65,1205,8795
20000,24,17660.0,1362,122.58,2340,17660
40000,24,35400.0,1698,152.82,4600,35400
60000,24,53160.0,1873,168.57,6840,53160
80000,24,70938.0,1967,177.03,9062,70938
100000,24,88732.0,1988,178.92,11268,88732
200000,24,177659.0,2057,185.13,22341,177659
400000,24,355393.0,2142,192.78,44607,355393
600000,24,533418.0,2200,198.0,66582,533418
800000,24,711184.0,2274,204.66,88816,711184
1000000,24,889032.0,2294,206.46,110968,889032
2,25,2.0,1,0.09,0,2
3,25,3.0,2,0.18,0,3
100,25,86.0,66,5.94,14,86
200,25,167.0,123,11.07,33,167
2000,25,1692.0,857,77.13,308,1692
10000,25,8728.0,1518,136.62,1272,8728
20000,25,17617.0,1642,147.78,2383,17617
40000,25,35415.0,1777,159.93,4585,35415
60000,25,53234.0,1814,163.26,6766,53234
80000,25,71016.0,1882,169.38,8984,71016
100000,25,88892.0,1907,171.63,11108,88892
200000,25,177914.0,2042,183.78,22086,177914
400000,25,355844.0,2383,214.47,44156,355844
600000,25,533858.0,2470,222.3,66142,533858
800000,25,712136.0,2475,222.75,87864,712136
1000000,25,890287.0,2540,228.6,109713,890287
2,26,1.0,1,0.09,1,1
3,26,2.0,2,0.18,1,2
100,26,85.0,64,5.76,15,85
200,26,169.0,120,10.8,31,169
2000,26,1721.0,705,63.45,279,1721
10000,26,8766.0,1180,106.2,1234,8766
20000,26,17632.0,1418,127.62,2368,17632
40000,26,35471.0,1527,137.43,4529,35471
60000,26,53256.0,1657,149.13,6744,53256
80000,26,71098.0,1679,151.11,8902,71098
100000,26,88912.0,1826,164.34,11088,88912
200000,26,177725.0,1969,177.21,22275,177725
400000,26,355993.0,2032,182.88,44007,355993
600000,26,534172.0,2092,188.28,65828,534172
800000,26,712268.0,2389,215.01,87732,712268
1000000,26,890289.0,2420,217.8,109711,890289
2,27,1.0,1,0.09,1,1
3,27,2.0,2,0.18,1,2
100,27,87.0,65,5.85,13,87
200,27,171.0,123,11.07,29,171
2000,27,1735.0,631,56.79,265,1735
10000,27,8828.0,1143,102.87,1172,8828
20000,27,17717.0,1310,117.9,2283,17717
40000,27,35467.0,1585,142.65,4533,35467
60000,27,53293.0,1713,154.17,6707,53293
80000,27,71092.0,1734,156.06,8908,71092
100000,27,88923.0,1764,158.76,11077,88923
200000,27,178001.0,1926,173.34,21999,178001
400000,27,356095.0,2377,213.93,43905,356095
600000,27,534280.0,2479,223.11,65720,534280
800000,27,712242.0,2544,228.96,87758,712242
1000000,27,890127.0,2563,230.67,109873,890127
2,28,1.0,1,0.09,1,1
3,28,1.0,2,0.18,2,1
100,28,79.0,64,5.76,21,79
200,28,169.0,125,11.25,31,169
2000,28,1720.0,729,65.61,280,1720
10000,28,8742.0,1318,118.62,1258,8742
20000,28,17605.0,1520,136.8,2395,17605
40000,28,35330.0,1736,156.24,4670,35330
60000,28,53161.0,1773,159.57,6839,53161
80000,28,71090.0,1779,160.11,8910,71090
100000,28,88865.0,1812,163.08,11135,88865
200000,28,177835.0,1901,171.09,22165,177835
400000,28,355905.0,2001,180.09,44095,355905
600000,28,533760.0,2026,182.34,66240,533760
800000,28,712029.0,2039,183.51,87971,712029
1000000,28,889823.0,2058,185.22,110177,889823
2,29,2.0,1,0.09,0,2
3,29,2.0,2,0.18,1,2
100,29,91.0,67,6.03,9,91
200,29,167.0,128,11.52,33,167
2000,29,1744.0,802,72.18,256,1744
10000,29,8785.0,1260,113.4,1215,8785
20000,29,17658.0,1396,125.64,2342,17658
40000,29,35484.0,1547,139.23,4516,35484
60000,29,53353.0,1642,147.78,6647,53353
80000,29,71126.0,1666,149.94,8874,71126
100000,29,88889.0,1707,153.63,11111,88889
200000,29,177985.0,1789,161.01,22015,177985
400000,29,355932.0,2101,189.09,44068,355932
600000,29,533692.0,2287,205.83,66308,533692
800000,29,711559.0,2318,208.62,88441,711559
1000000,29,889580.0,2349,211.41,110420,889580
2,30,1.0,1,0.09,1,1
3,30,2.0,2,0.18,1,2
100,30,84.0,63,5.67,16,84
200,30,166.0,119,10.71,34,166
2000,30,1711.0,726,65.34,289,1711
10000,30,8761.0,1302,117.18,1239,8761
20000,30,17632.0,1437,129.33,2368,17632
40000,30,35458.0,1727,155.43,4542,35458
60000,30,53209.0,1829,164.61,6791,53209
80000,30,71087.0,1857,167.13,8913,71087
100000,30,88819.0,1903,171.27,11181,88819
200000,30,177625.0,2177,195.93,22375,177625
400000,30,355779.0,2324,209.16,44221,355779
600000,30,533955.0,2457,221.13,66045,533955
800000,30,712101.0,2485,223.65,87899,712101
1000000,30,890081.0,2523,227.07,109919,890081
2,31,2.0,1,0.09,0,2
3,31,3.0,2,0.18,0,3
100,31,78.0,65,5.85,22,78
200,31,160.0,126,11.34,40,160
2000,31,1705.0,894,80.46,295,1705
10000,31,8771.0,1501,135.09,1229,8771
20000,31,17652.0,1791,161.19,2348,17652
40000,31,35445.0,2047,184.23,4555,35445
60000,31,53226.0,2154,193.86,6774,53226
80000,31,70943.0,2276,204.84,9057,70943
100000,31,88759.0,2285,205.65,11241,88759
200000,31,177738.0,2599,233.91,22262,177738
400000,31,355961.0,2683,241.47,44039,355961
600000,31,534031.0,2787,250.83,65969,534031
800000,31,712179.0,2825,254.25,87821,712179
1000000,31,890100.0,2970,267.3,109900,890100
2,32,1.0,1,0.09,1,1
3,32,2.0,2,0.18,1,2
100,32,81.0,65,5.85,19,81
200,32,171.0,126,11.34,29,171
2000,32,1742.0,805,72.45,258,1742
10000,32,8835.0,1389,125.01,1165,8835
20000,32,17780.0,1527,137.43,2220,17780
40000,32,35600.0,1721,154.89,4400,35600
60000,32,53381.0,1840,165.6,6619,53381
80000,32,71235.0,1930,173.7,8765,71235
100000,32,89036.0,2016,181.44,10964,89036
200000,32,177884.0,2248,202.32,22116,177884
400000,32,355860.0,2459,221.31,44140,355860
600000,32,533813.0,2597,233.73,66187,533813
800000,32,711908.0,2651,238.59,88092,711908
1000000,32,890048.0,2664,239.76,109952,890048
2,33,2.0,1,0.09,0,2
3,33,3.0,2,0.18,0,3
100,33,83.0,63,5.67,17,83
200,33,170.0,125,11.25,30,170
2000,33,1709.0,737,66.33,291,1709
10000,33,8768.0,1346,121.14,1232,8768
20000,33,17593.0,1562,140.58,2407,17593
40000,33,35335.0,1760,158.4,4665,35335
60000,33,53184.0,1839,165.51,6816,53184
80000,33,70923.0,1857,167.13,9077,70923
100000,33,88625.0,1882,169.38,11375,88625
200000,33,177717.0,2023,182.07,22283,177717
400000,33,355636.0,2170,195.3,44364,355636
600000,33,533490.0,2286,205.74,66510,533490
800000,33,711726.0,2326,209.34,88274,711726
1000000,33,889768.0,2336,210.24,110232,889768
2,34,2.0,1,0.09,0,2
3,34,3.0,2,0.18,0,3
100,34,83.0,64,5.76,17,83
200,34,162.0,127,11.43,38,162
2000,34,1717.0,654,58.86,283,1717
10000,34,8862.0,1020,91.8,1138,8862
20000,34,17700.0,1188,106.92,2300,17700
40000,34,35482.0,1480,133.2,4518,35482
60000,34,53256.0,1571,141.39,6744,53256
80000,34,71032.0,1617,145.53,8968,71032
100000,34,88902.0,1668,150.12,11098,88902
200000,34,177726.0,1829,164.61,22274,177726
400000,34,355544.0,1925,173.25,44456,355544
600000,34,533535.0,1977,177.93,66465,533535
800000,34,711516.0,1995,179.55,88484,711516
1000000,34,889512.0,2022,181.98,110488,889512
2,35,1.0,1,0.09,1,1
3,35,2.0,2,0.18,1,2
100,35,78.0,59,5.31,22,78
200,35,160.0,112,10.08,40,160
2000,35,1699.0,667,60.03,301,1699
10000,35,8796.0,1024,92.16,1204,8796
20000,35,17641.0,1176,105.84,2359,17641
40000,35,35391.0,1324,119.16,4609,35391
60000,35,53117.0,1510,135.9,6883,53117
80000,35,70964.0,1639,147.51,9036,70964
100000,35,88803.0,1661,149.49,11197,88803
200000,35,177781.0,1777,159.93,22219,177781
400000,35,355783.0,1889,170.01,44217,355783
600000,35,533722.0,1975,177.75,66278,533722
800000,35,711671.0,2068,186.12,88329,711671
1000000,35,889882.0,2085,187.65,110118,889882
2,36,2.0,1,0.09,0,2
3,36,3.0,2,0.18,0,3
100,36,83.0,64,5.76,17,83
200,36,164.0,120,10.8,36,164
2000,36,1717.0,718,64.62,283,1717
10000,36,8788.0,1228,110.52,1212,8788
20000,36,17683.0,1444,129.96,2317,17683
40000,36,35500.0,1516,136.44,4500,35500
60000,36,53312.0,1629,146.61,6688,53312
80000,36,71099.0,1660,149.4,8901,71099
100000,36,88888.0,1687,151.83,11112,88888
200000,36,177912.0,1908,171.72,22088,177912
400000,36,355981.0,1974,177.66,44019,355981
600000,36,533898.0,2023,182.07,66102,533898
800000,36,711984.0,2080,187.2,88016,711984
1000000,36,889708.0,2178,196.02,110292,889708
2,37,2.0,1,0.09,0,2
3,37,3.0,2,0.18,0,3
100,37,86.0,65,5.85,14,86
200,37,172.0,122,10.98,28,172
2000,37,1749.0,626,56.34,251,1749
10000,37,8821.0,1103,99.27,1179,8821
20000,37,17689.0,1335,120.15,2311,17689
40000,37,35483.0,1502,135.18,4517,35483
60000,37,53257.0,1692,152.28,6743,53257
80000,37,70911.0,1862,167.58,9089,70911
100000,37,88684.0,1890,170.1,11316,88684
200000,37,177437.0,2077,186.93,22563,177437
400000,37,355550.0,2286,205.74,44450,355550
600000,37,533477.0,2444,219.96,66523,533477
800000,37,711654.0,2467,222.03,88346,711654
1000000,37,889472.0,2493,224.37,110528,889472
2,38,2.0,1,0.09,0,2
3,38,3.0,2,0.18,0,3
100,38,88.0,67,6.03,12,88
200,38,173.0,136,12.24,27,173
2000,38,1716.0,754,67.86,284,1716
10000,38,8783.0,1360,122.4,1217,8783
20000,38,17624.0,1664,149.76,2376,17624
40000,38,35356.0,2044,183.96,4644,35356
60000,38,53148.0,2107,189.63,6852,53148
80000,38,70945.0,2143,192.87,9055,70945
100000,38,88834.0,2146,193.14,11166,88834
200000,38,177922.0,2258,203.22,22078,177922
400000,38,355893.0,2409,216.81,44107,355893
600000,38,533892.0,2518,226.62,66108,533892
800000,38,711733.0,2602,234.18,88267,711733
1000000,38,889714.0,2622,235.98,110286,889714
2,39,2.0,1,0.09,0,2
3,39,3.0,2,0.18,0,3
100,39,83.0,67,6.03,17,83
200,39,163.0,126,11.34,37,163
2000,39,1734.0,661,59.49,266,1734
10000,39,8808.0,1334,120.06,1192,8808
20000,39,17633.0,1618,145.62,2367,17633
40000,39,35446.0,1754,157.86,4554,35446
60000,39,53228.0,1875,168.75,6772,53228
80000,39,71024.0,1888,169.92,8976,71024
100000,39,88886.0,1940,174.6,11114,88886
200000,39,177848.0,2060,185.4,22152,177848
400000,39,355785.0,2301,207.09,44215,355785
600000,39,533599.0,2352,211.68,66401,533599
800000,39,711775.0,2378,214.02,88225,711775
1000000,39,889740.0,2461,221.49,110260,889740
2,40,2.0,1,0.09,0,2
3,40,2.0,2,0.18,1,2
100,40,81.0,62,5.58,19,81
200,40,167.0,123,11.07,33,167
2000,40,1708.0,685,61.65,292,1708
10000,40,8783.0,1290,116.1,1217,8783
20000,40,17594.0,1462,131.58,2406,17594
40000,40,35395.0,1526,137.34,4605,35395
60000,40,53149.0,1599,143.91,6851,53149
80000,40,70937.0,1645,148.05,9063,70937
100000,40,88751.0,1709,153.81,11249,88751
200000,40,177813.0,1802,162.18,22187,177813
400000,40,355604.0,1956,176.04,44396,355604
600000,40,533583.0,2015,181.35,66417,533583
800000,40,711605.0,2049,184.41,88395,711605
1000000,40,889763.0,2095,188.55,110237,889763
2,41,2.0,1,0.09,0,2
3,41,3.0,2,0.18,0,3
100,41,85.0,65,5.85,15,85
200,41,166.0,123,11.07,34,166
2000,41,1733.0,736,66.24,267,1733
10000,41,8799.0,1538,138.42,1201,8799
20000,41,17679.0,1814,163.26,2321,17679
40000,41,35512.0,2095,188.55,4488,35512
60000,41,53321.0,2399,215.91,6679,53321
80000,41,71197.0,2455,220.95,8803,71197
100000,41,88969.0,2521,226.89,11031,88969
200000,41,177868.0,2651,238.59,22132,177868
400000,41,356130.0,2807,252.63,43870,356130
600000,41,534003.0,2874,258.66,65997,534003
800000,41,711984.0,2976,267.84,88016,711984
1000000,41,890027.0,3008,270.72,109973,890027
2,42,2.0,1,0.09,0,2
3,42,3.0,2,0.18,0,3
100,42,81.0,64,5.76,19,81
200,42,161.0,116,10.44,39,161
2000,42,1708.0,766,68.94,292,1708
10000,42,8770.0,1453,130.77,1230,8770
20000,42,17680.0,1706,153.54,2320,17680
40000,42,35485.0,1896,170.64,4515,35485
60000,42,53318.0,1999,179.91,6682,53318
80000,42,71152.0,2075,186.75,8848,71152
100000,42,88979.0,2200,198.0,11021,88979
200000,42,178202.0,2329,209.61,21798,178202
400000,42,356170.0,2458,221.22,43830,356170
600000,42,533973.0,2574,231.66,66027,533973
800000,42,711674.0,2640,237.6,88326,711674
1000000,42,889767.0,2647,238.23,110233,889767
2,43,2.0,1,0.09,0,2
3,43,3.0,2,0.18,0,3
100,43,81.0,67,6.03,19,81
200,43,167.0,129,11.61,33,167
2000,43,1696.0,844,75.96,304,1696
10000,43,8818.0,1279,115.11,1182,8818
20000,43,17701.0,1551,139.59,2299,17701
40000,43,35476.0,1761,158.49,4524,35476
60000,43,53263.0,1802,162.18,6737,53263
80000,43,71047.0,1874,168.66,8953,71047
100000,43,88885.0,1884,169.56,11115,88885
200000,43,177921.0,2050,184.5,22079,177921
400000,43,356012.0,2167,195.03,43988,356012
600000,43,533749.0,2222,199.98,66251,533749
800000,43,711729.0,2317,208.53,88271,711729
1000000,43,889872.0,2330,209.7,110128,889872
2,44,2.0,1,0.09,0,2
3,44,3.0,2,0.18,0,3
100,44,87.0,66,5.94,13,87
200,44,177.0,129,11.61,23,177
2000,44,1714.0,689,62.01,286,1714
10000,44,8767.0,1155,103.95,1233,8767
20000,44,17625.0,1310,117.9,2375,17625
40000,44,35387.0,1471,132.39,4613,35387
60000,44,53229.0,1517,136.53,6771,53229
80000,44,71001.0,1591,143.19,8999,71001
100000,44,88776.0,1618,145.62,11224,88776
200000,44,177601.0,1741,156.69,22399,177601
400000,44,355249.0,1797,161.73,44751,355249
600000,44,533276.0,1820,163.8,66724,533276
800000,44,711293.0,1952,175.68,88707,711293
1000000,44,889333.0,1960,176.4,110667,889333
2,45,2.0,1,0.09,0,2
3,45,3.0,2,0.18,0,3
100,45,86.0,66,5.94,14,86
200,45,169.0,132,11.88,31,169
2000,45,1722.0,939,84.51,278,1722
10000,45,8759.0,1655,148.95,1241,8759
20000,45,17636.0,2014,181.26,2364,17636
40000,45,35402.0,2141,192.69,4598,35402
60000,45,53139.0,2265,203.85,6861,53139
80000,45,70981.0,2338,210.42,9019,70981
100000,45,88726.0,2406,216.54,11274,88726
200000,45,177855.0,2535,228.15,22145,177855
400000,45,355783.0,2617,235.53,44217,355783
600000,45,533633.0,2793,251.37,66367,533633
800000,45,711450.0,2981,268.29,88550,711450
1000000,45,889696.0,3008,270.72,110304,889696
2,46,2.0,1,0.09,0,2
3,46,3.0,2,0.18,0,3
100,46,83.0,63,5.67,17,83
200,46,167.0,117,10.53,33,167
2000,46,1693.0,584,52.56,307,1693
10000,46,8722.0,1152,103.68,1278,8722
20000,46,17618.0,1400,126.0,2382,17618
40000,46,35446.0,1519,136.71,4554,35446
60000,46,53215.0,1686,151.74,6785,53215
80000,46,71007.0,1733,155.97,8993,71007
100000,46,88771.0,1768,159.12,11229,88771
200000,46,177636.0,1951,175.59,22364,177636
400000,46,355544.0,2093,188.37,44456,355544
600000,46,533352.0,2148,193.32,66648,533352
800000,46,711294.0,2177,195.93,88706,711294
1000000,46,889365.0,2205,198.45,110635,889365
2,47,1.0,1,0.09,1,1
3,47,1.0,2,0.18,2,1
100,47,82.0,65,5.85,18,82
200,47,163.0,120,10.8,37,163
2000,47,1712.0,673,60.57,288,1712
10000,47,8776.0,1253,112.77,1224,8776
20000,47,17662.0,1380,124.2,2338,17662
40000,47,35428.0,1668,150.12,4572,35428
60000,47,53226.0,1724,155.16,6774,53226
80000,47,71020.0,1771,159.39,8980,71020
100000,47,88765.0,1860,167.4,11235,88765
200000,47,177766.0,1964,176.76,22234,177766
400000,47,355981.0,2078,187.02,44019,355981
600000,47,534154.0,2112,190.08,65846,534154
800000,47,711842.0,2259,203.31,88158,711842
1000000,47,889876.0,2298,206.82,110124,889876
2,48,2.0,1,0.09,0,2
3,48,3.0,2,0.18,0,3
100,48,77.0,62,5.58,23,77
200,48,159.0,123,11.07,41,159
2000,48,1729.0,608,54.72,271,1729
10000,48,8820.0,1122,100.98,1180,8820
20000,48,17691.0,1315,118.35,2309,17691
40000,48,35492.0,1372,123.48,4508,35492
60000,48,53302.0,1462,131.58,6698,53302
80000,48,71045.0,1544,138.96,8955,71045
100000,48,88899.0,1572,141.48,11101,88899
200000,48,177962.0,1679,151.11,22038,177962
400000,48,355804.0,1869,168.21,44196,355804
600000,48,533769.0,1916,172.44,66231,533769
800000,48,711773.0,1958,176.22,88227,711773
1000000,48,889737.0,1972,177.48,110263,889737
2,49,2.0,1,0.09,0,2
3,49,3.0,2,0.18,0,3
100,49,86.0,65,5.85,14,86
200,49,167.0,127,11.43,33,167
2000,49,1725.0,788,70.92,275,1725
10000,49,8807.0,1358,122.22,1193,8807
20000,49,17684.0,1644,147.96,2316,17684
40000,49,35509.0,1743,156.87,4491,35509
60000,49,53274.0,1845,166.05,6726,53274
80000,49,71048.0,1886,169.74,8952,71048
100000,49,88888.0,1904,171.36,11112,88888
200000,49,177914.0,2018,181.62,22086,177914
400000,49,355953.0,2220,199.8,44047,355953
600000,49,534030.0,2346,211.14,65970,534030
800000,49,711813.0,2373,213.57,88187,711813
1000000,49,889912.0,2388,214.92,110088,889912
2,50,2.0,1,0.09,0,2
3,50,3.0,2,0.18,0,3
100,50,86.0,67,6.03,14,86
200,50,165.0,132,11.88,35,165
2000,50,1714.0,628,56.52,286,1714
10000,50,8760.0,1194,107.46,1240,8760
20000,50,17620.0,1373,123.57,2380,17620
40000,50,35429.0,1506,135.54,4571,35429
60000,50,53174.0,1592,143.28,6826,53174
80000,50,70996.0,1635,147.15,9004,70996
100000,50,88808.0,1657,149.13,11192,88808
200000,50,177643.0,1774,159.66,22357,177643
400000,50,355405.0,1873,168.57,44595,355405
600000,50,533587.0,1915,172.35,66413,533587
800000,50,711622.0,1957,176.13,88378,711622
1000000,50,889711.0,1992,179.28,110289,889711
2,51,2.0,1,0.09,0,2
3,51,3.0,2,0.18,0,3
100,51,81.0,63,5.67,19,81
200,51,164.0,124,11.16,36,164
2000,51,1704.0,835,75.15,296,1704
10000,51,8796.0,1372,123.48,1204,8796
20000,51,17674.0,1729,155.61,2326,17674
40000,51,35410.0,2005,180.45,4590,35410
60000,51,53177.0,2081,187.29,6823,53177
80000,51,70953.0,2129,191.61,9047,70953
100000,51,88749.0,2196,197.64,11251,88749
200000,51,177703.0,2471,222.39,22297,177703
400000,51,355506.0,2549,229.41,44494,355506
600000,51,533484.0,2640,237.6,66516,533484
800000,51,711387.0,2686,241.74,88613,711387
1000000,51,889178.0,2752,247.68,110822,889178
2,52,2.0,1,0.09,0,2
3,52,3.0,2,0.18,0,3
100,52,89.0,66,5.94,11,89
200,52,167.0,136,12.24,33,167
2000,52,1712.0,787,70.83,288,1712
10000,52,8800.0,1289,116.01,1200,8800
20000,52,17643.0,1638,147.42,2357,17643
40000,52,35421.0,1830,164.7,4579,35421
60000,52,53169.0,1974,177.66,6831,53169
80000,52,70883.0,2056,185.04,9117,70883
100000,52,88677.0,2101,189.09,11323,88677
200000,52,177617.0,2303,207.27,22383,177617
400000,52,355666.0,2435,219.15,44334,355666
600000,52,533662.0,2521,226.89,66338,533662
800000,52,711780.0,2604,234.36,88220,711780
1000000,52,889849.0,2626,236.34,110151,889849
2,53,2.0,1,0.09,0,2
3,53,3.0,2,0.18,0,3
100,53,80.0,64,5.76,20,80
200,53,163.0,124,11.16,37,163
2000,53,1686.0,875,78.75,314,1686
10000,53,8726.0,1326,119.34,1274,8726
20000,53,17571.0,1523,137.07,2429,17571
40000,53,35409.0,1580,142.2,4591,35409
60000,53,53273.0,1662,149.58,6727,53273
80000,53,71116.0,1696,152.64,8884,71116
100000,53,88955.0,1749,157.41,11045,88955
200000,53,177950.0,2036,183.24,22050,177950
400000,53,355922.0,2258,203.22,44078,355922
600000,53,534015.0,2334,210.06,65985,534015
800000,53,712088.0,2396,215.64,87912,712088
1000000,53,890022.0,2412,217.08,109978,890022
2,54,2.0,1,0.09,0,2
3,54,3.0,2,0.18,0,3
100,54,86.0,66,5.94,14,86
200,54,165.0,132,11.88,35,165
2000,54,1717.0,745,67.05,283,1717
10000,54,8809.0,1231,110.79,1191,8809
20000,54,17748.0,1467,132.03,2252,17748
40000,54,35562.0,1606,144.54,4438,35562
60000,54,53247.0,1792,161.28,6753,53247
80000,54,71000.0,1885,169.65,9000,71000
100000,54,88799.0,1897,170.73,11201,88799
200000,54,177748.0,1994,179.46,22252,177748
400000,54,355463.0,2220,199.8,44537,355463
600000,54,533207.0,2264,203.76,66793,533207
800000,54,711253.0,2320,208.8,88747,711253
1000000,54,889380.0,2334,210.06,110620,889380
2,55,2.0,1,0.09,0,2
3,55,2.0,2,0.18,1,2
100,55,82.0,66,5.94,18,82
200,55,159.0,135,12.15,41,159
2000,55,1720.0,780,70.2,280,1720
10000,55,8788.0,1395,125.55,1212,8788
20000,55,17617.0,1842,165.78,2383,17617
40000,55,35409.0,2103,189.27,4591,35409
60000,55,53206.0,2258,203.22,6794,53206
80000,55,71108.0,2272,204.48,8892,71108
100000,55,88907.0,2315,208.35,11093,88907
200000,55,177835.0,2595,233.55,22165,177835
400000,55,355709.0,2946,265.14,44291,355709
600000,55,533835.0,2984,268.56,66165,533835
800000,55,711862.0,3164,284.76,88138,711862
1000000,55,889967.0,3199,287.91,110033,889967
2,56,2.0,1,0.09,0,2
3,56,3.0,2,0.18,0,3
100,56,81.0,65,5.85,19,81
200,56,167.0,121,10.89,33,167
2000,56,1722.0,563,50.67,278,1722
10000,56,8790.0,1185,106.65,1210,8790
20000,56,17688.0,1498,134.82,2312,17688
40000,56,35416.0,1639,147.51,4584,35416
60000,56,53129.0,1760,158.4,6871,53129
80000,56,70948.0,1796,161.64,9052,70948
100000,56,88743.0,1860,167.4,11257,88743
200000,56,177657.0,2082,187.38,22343,177657
400000,56,355510.0,2181,196.29,44490,355510
600000,56,533423.0,2228,200.52,66577,533423
800000,56,711290.0,2275,204.75,88710,711290
1000000,56,888993.0,2309,207.81,111007,888993
2,57,1.0,1,0.09,1,1
3,57,2.0,2,0.18,1,2
100,57,81.0,64,5.76,19,81
200,57,163.0,126,11.34,37,163
2000,57,1723.0,753,67.77,277,1723
10000,57,8814.0,1051,94.59,1186,8814
20000,57,17685.0,1248,112.32,2315,17685
40000,57,35527.0,1413,127.17,4473,35527
60000,57,53262.0,1567,141.03,6738,53262
80000,57,71060.0,1586,142.74,8940,71060
100000,57,88920.0,1602,144.18,11080,88920
200000,57,177821.0,1977,177.93,22179,177821
400000,57,355700.0,2078,187.02,44300,355700
600000,57,533698.0,2112,190.08,66302,533698
800000,57,711953.0,2134,192.06,88047,711953
1000000,57,889797.0,2153,193.77,110203,889797
2,58,1.0,1,0.09,1,1
3,58,2.0,2,0.18,1,2
100,58,82.0,63,5.67,18,82
200,58,164.0,123,11.07,36,164
2000,58,1709.0,786,70.74,291,1709
10000,58,8782.0,1335,120.15,1218,8782
20000,58,17722.0,1508,135.72,2278,17722
40000,58,35477.0,1737,156.33,4523,35477
60000,58,53315.0,1845,166.05,6685,53315
80000,58,71048.0,1931,173.79,8952,71048
100000,58,88924.0,1950,175.5,11076,88924
200000,58,178088.0,2005,180.45,21912,178088
400000,58,356239.0,2150,193.5,43761,356239
600000,58,534363.0,2287,205.83,65637,534363
800000,58,711998.0,2382,214.38,88002,711998
1000000,58,889907.0,2395,215.55,110093,889907
2,59,1.0,1,0.09,1,1
3,59,1.0,2,0.18,2,1
100,59,79.0,66,5.94,21,79
200,59,159.0,134,12.06,41,159
2000,59,1693.0,688,61.92,307,1693
10000,59,8742.0,1055,94.95,1258,8742
20000,59,17629.0,1312,118.08,2371,17629
40000,59,35336.0,1537,138.33,4664,35336
60000,59,53058.0,1642,147.78,6942,53058
80000,59,70954.0,1666,149.94,9046,70954
100000,59,88745.0,1750,157.5,11255,88745
200000,59,177617.0,1924,173.16,22383,177617
400000,59,355537.0,2034,183.06,44463,355537
600000,59,533543.0,2173,195.57,66457,533543
800000,59,711435.0,2291,206.19,88565,711435
1000000,59,889274.0,2347,211.23,110726,889274
2,60,2.0,1,0.09,0,2
3,60,3.0,2,0.18,0,3
100,60,81.0,69,6.21,19,81
200,60,161.0,130,11.7,39,161
2000,60,1721.0,619,55.71,279,1721
10000,60,8781.0,1195,107.55,1219,8781
20000,60,17647.0,1527,137.43,2353,17647
40000,60,35381.0,1718,154.62,4619,35381
60000,60,53183.0,1814,163.26,6817,53183
80000,60,70940.0,1843,165.87,9060,70940
100000,60,88626.0,1938,174.42,11374,88626
200000,60,177467.0,2142,192.78,22533,177467
400000,60,355520.0,2610,234.9,44480,355520
600000,60,533378.0,2724,245.16,66622,533378
800000,60,711394.0,2807,252.63,88606,711394
1000000,60,889277.0,2813,253.17,110723,889277
2,61,2.0,1,0.09,0,2
3,61,3.0,2,0.18,0,3
100,61,84.0,66,5.94,16,84
200,61,158.0,132,11.88,42,158
2000,61,1686.0,837,75.33,314,1686
10000,61,8736.0,1380,124.2,1264,8736
20000,61,17650.0,1576,141.84,2350,17650
40000,61,35379.0,1738,156.42,4621,35379
60000,61,53215.0,1763,158.67,6785,53215
80000,61,70965.0,1869,168.21,9035,70965
100000,61,88785.0,1904,171.36,11215,88785
200000,61,177780.0,2096,188.64,22220,177780
400000,61,355913.0,2191,197.19,44087,355913
600000,61,533864.0,2260,203.4,66136,533864
800000,61,711938.0,2274,204.66,88062,711938
1000000,61,890019.0,2283,205.47,109981,890019
2,62,1.0,1,0.09,1,1
3,62,2.0,2,0.18,1,2
100,62,82.0,64,5.76,18,82
200,62,166.0,126,11.34,34,166
2000,62,1734.0,759,68.31,266,1734
10000,62,8826.0,1336,120.24,1174,8826
20000,62,17682.0,1545,139.05,2318,17682
40000,62,35413.0,1910,171.9,4587,35413
60000,62,53193.0,2063,185.67,6807,53193
80000,62,71071.0,2078,187.02,8929,71071
100000,62,88964.0,2093,188.37,11036,88964
200000,62,177870.0,2336,210.24,22130,177870
400000,62,355849.0,2508,225.72,44151,355849
600000,62,533858.0,2601,234.09,66142,533858
800000,62,711999.0,2711,243.99,88001,711999
1000000,62,889969.0,2788,250.92,110031,889969
2,63,2.0,1,0.09,0,2
3,63,3.0,2,0.18,0,3
100,63,77.0,63,5.67,23,77
200,63,158.0,121,10.89,42,158
2000,63,1683.0,1008,90.72,317,1683
10000,63,8749.0,1547,139.23,1251,8749
20000,63,17635.0,1907,171.63,2365,17635
40000,63,35432.0,2110,189.9,4568,35432
60000,63,53257.0,2195,197.55,6743,53257
80000,63,71093.0,2243,201.87,8907,71093
100000,63,88907.0,2267,204.03,11093,88907
200000,63,177901.0,2388,214.92,22099,177901
400000,63,355977.0,2507,225.63,44023,355977
600000,63,534078.0,2632,236.88,65922,534078
800000,63,712473.0,2691,242.19,87527,712473
1000000,63,890316.0,2721,244.89,109684,890316
2,64,2.0,1,0.09,0,2
3,64,2.0,2,0.18,1,2
100,64,83.0,63,5.67,17,83
200,64,165.0,122,10.98,35,165
2000,64,1687.0,748,67.32,313,1687
10000,64,8786.0,1230,110.7,1214,8786
20000,64,17630.0,1439,129.51,2370,17630
40000,64,35351.0,1651,148.59,4649,35351
60000,64,53093.0,1806,162.54,6907,53093
80000,64,70838.0,1838,165.42,9162,70838
100000,64,88619.0,1977,177.93,11381,88619
200000,64,177752.0,2110,189.9,22248,177752
400000,64,355689.0,2403,216.27,44311,355689
600000,64,533684.0,2547,229.23,66316,533684
800000,64,711646.0,2565,230.85,88354,711646
1000000,64,889540.0,2611,234.99,110460,889540
2,65,2.0,1,0.09,0,2
3,65,3.0,2,0.18,0,3
100,65,88.0,66,5.94,12,88
200,65,173.0,131,11.79,27,173
2000,65,1720.0,693,62.37,280,1720
10000,65,8795.0,1446,130.14,1205,8795
20000,65,17646.0,1655,148.95,2354,17646
40000,65,35447.0,1939,174.51,4553,35447
60000,65,53239.0,2033,182.97,6761,53239
80000,65,71043.0,2152,193.68,8957,71043
100000,65,88855.0,2247,202.23,11145,88855
200000,65,177639.0,2517,226.53,22361,177639
400000,65,355578.0,2639,237.51,44422,355578
600000,65,533435.0,2705,243.45,66565,533435
800000,65,711604.0,2728,245.52,88396,711604
1000000,65,889477.0,2867,258.03,110523,889477
2,66,1.0,1,0.09,1,1
3,66,2.0,2,0.18,1,2
100,66,78.0,62,5.58,22,78
200,66,161.0,126,11.34,39,161
2000,66,1707.0,753,67.77,293,1707
10000,66,8733.0,1529,137.61,1267,8733
20000,66,17608.0,1656,149.04,2392,17608
40000,66,35470.0,1783,160.47,4530,35470
60000,66,53332.0,1916,172.44,6668,53332
80000,66,71136.0,1965,176.85,8864,71136
100000,66,88883.0,2037,183.33,11117,88883
200000,66,177805.0,2144,192.96,22195,177805
400000,66,355912.0,2362,212.58,44088,355912
600000,66,534231.0,2416,217.44,65769,534231
800000,66,712178.0,2461,221.49,87822,712178
1000000,66,890202.0,2505,225.45,109798,890202
2,67,2.0,1,0.09,0,2
3,67,3.0,2,0.18,0,3
100,67,85.0,64,5.76,15,85
200,67,173.0,124,11.16,27,173
2000,67,1718.0,809,72.81,282,1718
10000,67,8793.0,1464,131.76,1207,8793
20000,67,17691.0,1636,147.24,2309,17691
40000,67,35490.0,1885,169.65,4510,35490
60000,67,53203.0,2042,183.78,6797,53203
80000,67,71046.0,2117,190.53,8954,71046
100000,67,88877.0,2143,192.87,11123,88877
200000,67,177909.0,2345,211.05,22091,177909
400000,67,355923.0,2722,244.98,44077,355923
600000,67,533926.0,2871,258.39,66074,533926
800000,67,711642.0,2932,263.88,88358,711642
1000000,67,889620.0,2995,269.55,110380,889620
2,68,2.0,1,0.09,0,2
3,68,3.0,2,0.18,0,3
100,68,79.0,59,5.31,21,79
200,68,162.0,117,10.53,38,162
2000,68,1729.0,692,62.28,271,1729
10000,68,8767.0,1323,119.07,1233,8767
20000,68,17641.0,1516,136.44,2359,17641
40000,68,35463.0,1629,146.61,4537,35463
60000,68,53262.0,1747,157.23,6738,53262
80000,68,71027.0,1810,162.9,8973,71027
100000,68,88763.0,1855,166.95,11237,88763
200000,68,177723.0,2134,192.06,22277,177723
400000,68,355796.0,2195,197.55,44204,355796
600000,68,534050.0,2269,204.21,65950,534050
800000,68,712219.0,2320,208.8,87781,712219
1000000,68,890337.0,2361,212.49,109663,890337
2,69,2.0,1,0.09,0,2
3,69,3.0,2,0.18,0,3
100,69,80.0,65,5.85,20,80
200,69,174.0,129,11.61,26,174
2000,69,1717.0,745,67.05,283,1717
10000,69,8796.0,1540,138.6,1204,8796
20000,69,17706.0,1770,159.3,2294,17706
40000,69,35520.0,2061,185.49,4480,35520
60000,69,53345.0,2131,191.79,6655,53345
80000,69,71011.0,2286,205.74,8989,71011
100000,69,88781.0,2375,213.75,11219,88781
200000,69,177813.0,2569,231.21,22187,177813
400000,69,355791.0,2766,248.94,44209,355791
600000,69,533744.0,2861,257.49,66256,533744
800000,69,711646.0,2914,262.26,88354,711646
1000000,69,889816.0,2979,268.11,110184,889816
2,70,1.0,1,0.09,1,1
3,70,2.0,2,0.18,1,2
100,70,89.0,66,5.94,11,89
200,70,173.0,121,10.89,27,173
2000,70,1724.0,688,61.92,276,1724
10000,70,8791.0,1151,103.59,1209,8791
20000,70,17688.0,1274,114.66,2312,17688
40000,70,35383.0,1485,133.65,4617,35383
60000,70,53148.0,1523,137.07,6852,53148
80000,70,70847.0,1637,147.33,9153,70847
100000,70,88592.0,1687,151.83,11408,88592
200000,70,177620.0,1790,161.1,22380,177620
400000,70,355470.0,1902,171.18,44530,355470
600000,70,533345.0,1952,175.68,66655,533345
800000,70,711178.0,1984,178.56,88822,711178
1000000,70,889153.0,1992,179.28,110847,889153
2,71,2.0,1,0.09,0,2
3,71,3.0,2,0.18,0,3
100,71,72.0,66,5.94,28,72
200,71,158.0,130,11.7,42,158
2000,71,1700.0,805,72.45,300,1700
10000,71,8750.0,1333,119.97,1250,8750
20000,71,17636.0,1505,135.45,2364,17636
40000,71,35379.0,1770,159.3,4621,35379
60000,71,53151.0,1835,165.15,6849,53151
80000,71,70932.0,1907,171.63,9068,70932
100000,71,88726.0,1950,175.5,11274,88726
200000,71,177793.0,2069,186.21,22207,177793
400000,71,355642.0,2434,219.06,44358,355642
600000,71,533695.0,2477,222.93,66305,533695
800000,71,711754.0,2580,232.2,88246,711754
1000000,71,889850.0,2599,233.91,110150,889850
2,72,1.0,1,0.09,1,1
3,72,2.0,2,0.18,1,2
100,72,85.0,64,5.76,15,85
200,72,172.0,124,11.16,28,172
2000,72,1680.0,763,68.67,320,1680
10000,72,8711.0,1283,115.47,1289,8711
20000,72,17592.0,1470,132.3,2408,17592
40000,72,35308.0,1645,148.05,4692,35308
60000,72,53167.0,1668,150.12,6833,53167
80000,72,70979.0,1793,161.37,9021,70979
100000,72,88771.0,1825,164.25,11229,88771
200000,72,177787.0,1910,171.9,22213,177787
400000,72,355551.0,1982,178.38,44449,355551
600000,72,533489.0,2150,193.5,66511,533489
800000,72,711557.0,2217,199.53,88443,711557
1000000,72,889591.0,2253,202.77,110409,889591
2,73,2.0,1,0.09,0,2
3,73,2.0,2,0.18,1,2
100,73,86.0,66,5.94,14,86
200,73,167.0,128,11.52,33,167
2000,73,1706.0,787,70.83,294,1706
10000,73,8834.0,1137,102.33,1166,8834
20000,73,17695.0,1317,118.53,2305,17695
40000,73,35406.0,1540,138.6,4594,35406
60000,73,53152.0,1602,144.18,6848,53152
80000,73,70924.0,1721,154.89,9076,70924
100000,73,88663.0,1772,159.48,11337,88663
200000,73,177721.0,2155,193.95,22279,177721
400000,73,355624.0,2294,206.46,44376,355624
600000,73,533696.0,2338,210.42,66304,533696
800000,73,711649.0,2420,217.8,88351,711649
1000000,73,889528.0,2458,221.22,110472,889528
2,74,2.0,1,0.09,0,2
3,74,3.0,2,0.18,0,3
100,74,86.0,65,5.85,14,86
200,74,167.0,131,11.79,33,167
2000,74,1714.0,812,73.08,286,1714
10000,74,8771.0,1444,129.96,1229,8771
20000,74,17683.0,1515,136.35,2317,17683
40000,74,35502.0,1672,150.48,4498,35502
60000,74,53272.0,1843,165.87,6728,53272
80000,74,71162.0,1962,176.58,8838,71162
100000,74,88860.0,2032,182.88,11140,88860
200000,74,177844.0,2247,202.23,22156,177844
400000,74,355859.0,2414,217.26,44141,355859
600000,74,533892.0,2463,221.67,66108,533892
800000,74,711979.0,2490,224.1,88021,711979
1000000,74,889955.0,2531,227.79,110045,889955
2,75,1.0,1,0.09,1,1
3,75,2.0,2,0.18,1,2
100,75,80.0,66,5.94,20,80
200,75,166.0,129,11.61,34,166
2000,75,1706.0,809,72.81,294,1706
10000,75,8737.0,1402,126.18,1263,8737
20000,75,17602.0,1531,137.79,2398,17602
40000,75,35407.0,1621,145.89,4593,35407
60000,75,53230.0,1652,148.68,6770,53230
80000,75,71003.0,1741,156.69,8997,71003
100000,75,88786.0,1853,166.77,11214,88786
200000,75,177849.0,2015,181.35,22151,177849
400000,75,355844.0,2205,198.45,44156,355844
600000,75,534028.0,2261,203.49,65972,534028
800000,75,711963.0,2303,207.27,88037,711963
1000000,75,889819.0,2332,209.88,110181,889819
2,76,2.0,1,0.09,0,2
3,76,2.0,2,0.18,1,2
100,76,81.0,62,5.58,19,81
200,76,164.0,122,10.98,36,164
2000,76,1707.0,746,67.14,293,1707
10000,76,8772.0,1107,99.63,1228,8772
20000,76,17678.0,1410,126.9,2322,17678
40000,76,35529.0,1587,142.83,4471,35529
60000,76,53334.0,1698,152.82,6666,53334
80000,76,71104.0,1789,161.01,8896,71104
100000,76,88891.0,1906,171.54,11109,88891
200000,76,178026.0,2022,181.98,21974,178026
400000,76,355915.0,2444,219.96,44085,355915
600000,76,534026.0,2504,225.36,65974,534026
800000,76,711959.0,2665,239.85,88041,711959
1000000,76,889739.0,2688,241.92,110261,889739
2,77,2.0,1,0.09,0,2
3,77,3.0,2,0.18,0,3
100,77,83.0,64,5.76,17,83
200,77,170.0,120,10.8,30,170
2000,77,1683.0,754,67.86,317,1683
10000,77,8759.0,1096,98.64,1241,8759
20000,77,17659.0,1278,115.02,2341,17659
40000,77,35361.0,1535,138.15,4639,35361
60000,77,53181.0,1599,143.91,6819,53181
80000,77,70955.0,1670,150.3,9045,70955
100000,77,88742.0,1691,152.19,11258,88742
200000,77,177571.0,1960,176.4,22429,177571
400000,77,355477.0,2154,193.86,44523,355477
600000,77,533761.0,2227,200.43,66239,533761
800000,77,711795.0,2283,205.47,88205,711795
1000000,77,890090.0,2326,209.34,109910,890090
2,78,2.0,1,0.09,0,2
3,78,3.0,2,0.18,0,3
100,78,85.0,64,5.76,15,85
200,78,173.0,128,11.52,27,173
2000,78,1711.0,909,81.81,289,1711
10000,78,8776.0,1646,148.14,1224,8776
20000,78,17688.0,1822,163.98,2312,17688
40000,78,35465.0,2139,192.51,4535,35465
60000,78,53283.0,2255,202.95,6717,53283
80000,78,71059.0,2313,208.17,8941,71059
100000,78,88855.0,2344,210.96,11145,88855
200000,78,177860.0,2415,217.35,22140,177860
400000,78,355854.0,2559,230.31,44146,355854
600000,78,533833.0,2631,236.79,66167,533833
800000,78,711776.0,2655,238.95,88224,711776
1000000,78,889687.0,2703,243.27,110313,889687
2,79,2.0,1,0.09,0,2
3,79,2.0,2,0.18,1,2
100,79,82.0,64,5.76,18,82
200,79,167.0,125,11.25,33,167
2000,79,1718.0,833,74.97,282,1718
10000,79,8739.0,1520,136.8,1261,8739
20000,79,17653.0,1597,143.73,2347,17653
40000,79,35359.0,1914,172.26,4641,35359
60000,79,53173.0,2037,183.33,6827,53173
80000,79,70877.0,2100,189.0,9123,70877
100000,79,88589.0,2133,191.97,11411,88589
200000,79,177617.0,2188,196.92,22383,177617
400000,79,355510.0,2337,210.33,44490,355510
600000,79,533423.0,2396,215.64,66577,533423
800000,79,711281.0,2422,217.98,88719,711281
1000000,79,889093.0,2492,224.28,110907,889093
2,80,2.0,1,0.09,0,2
3,80,3.0,2,0.18,0,3
100,80,84.0,64,5.76,16,84
200,80,165.0,116,10.44,35,165
2000,80,1721.0,595,53.55,279,1721
10000,80,8691.0,1254,112.86,1309,8691
20000,80,17528.0,1460,131.4,2472,17528
40000,80,35350.0,1553,139.77,4650,35350
60000,80,53121.0,1596,143.64,6879,53121
80000,80,70869.0,1698,152.82,9131,70869
100000,80,88682.0,1778,160.02,11318,88682
200000,80,177695.0,1905,171.45,22305,177695
400000,80,355752.0,2046,184.14,44248,355752
600000,80,533775.0,2077,186.93,66225,533775
800000,80,711729.0,2102,189.18,88271,711729
1000000,80,889761.0,2160,194.4,110239,889761
2,81,2.0,1,0.09,0,2
3,81,3.0,2,0.18,0,3
100,81,86.0,66,5.94,14,86
200,81,174.0,127,11.43,26,174
2000,81,1735.0,809,72.81,265,1735
10000,81,8764.0,1557,140.13,1236,8764
20000,81,17663.0,1750,157.5,2337,17663
40000,81,35513.0,1857,167.13,4487,35513
60000,81,53312.0,2051,184.59,6688,53312
80000,81,71083.0,2098,188.82,8917,71083
100000,81,88844.0,2183,196.47,11156,88844
200000,81,177789.0,2293,206.37,22211,177789
400000,81,355597.0,2454,220.86,44403,355597
600000,81,533541.0,2496,224.64,66459,533541
800000,81,711867.0,2526,227.34,88133,711867
1000000,81,889995.0,2581,232.29,110005,889995
2,82,1.0,1,0.09,1,1
3,82,1.0,2,0.18,2,1
100,82,79.0,64,5.76,21,79
200,82,166.0,119,10.71,34,166
2000,82,1707.0,820,73.8,293,1707
10000,82,8726.0,1547,139.23,1274,8726
20000,82,17582.0,1770,159.3,2418,17582
40000,82,35344.0,1916,172.44,4656,35344
60000,82,53096.0,2096,188.64,6904,53096
80000,82,70918.0,2119,190.71,9082,70918
100000,82,88742.0,2237,201.33,11258,88742
200000,82,177644.0,2544,228.96,22356,177644
400000,82,355546.0,2824,254.16,44454,355546
600000,82,533400.0,2876,258.84,66600,533400
800000,82,711544.0,2906,261.54,88456,711544
1000000,82,889656.0,2943,264.87,110344,889656
2,83,1.0,1,0.09,1,1
3,83,1.0,2,0.18,2,1
100,83,85.0,64,5.76,15,85
200,83,168.0,124,11.16,32,168
2000,83,1728.0,663,59.67,272,1728
10000,83,8782.0,1280,115.2,1218,8782
20000,83,17687.0,1475,132.75,2313,17687
40000,83,35503.0,1735,156.15,4497,35503
60000,83,53301.0,1975,177.75,6699,53301
80000,83,71127.0,2151,193.59,8873,71127
100000,83,88905.0,2213,199.17,11095,88905
200000,83,177720.0,2401,216.09,22280,177720
400000,83,355419.0,2507,225.63,44581,355419
600000,83,533412.0,2689,242.01,66588,533412
800000,83,711393.0,2761,248.49,88607,711393
1000000,83,889043.0,2805,252.45,110957,889043
2,84,1.0,1,0.09,1,1
3,84,2.0,2,0.18,1,2
100,84,85.0,68,6.12,15,85
200,84,167.0,130,11.7,33,167
2000,84,1685.0,873,78.57,315,1685
10000,84,8793.0,1340,120.6,1207,8793
20000,84,17665.0,1556,140.04,2335,17665
40000,84,35445.0,1699,152.91,4555,35445
60000,84,53191.0,1833,164.97,6809,53191
80000,84,71000.0,1930,173.7,9000,71000
100000,84,88729.0,2035,183.15,11271,88729
200000,84,177839.0,2237,201.33,22161,177839
400000,84,355810.0,2391,215.19,44190,355810
600000,84,533771.0,2471,222.39,66229,533771
800000,84,711723.0,2516,226.44,88277,711723
1000000,84,889923.0,2635,237.15,110077,889923
2,85,2.0,1,0.09,0,2
3,85,3.0,2,0.18,0,3
100,85,86.0,65,5.85,14,86
200,85,167.0,124,11.16,33,167
2000,85,1718.0,724,65.16,282,1718
10000,85,8818.0,1496,134.64,1182,8818
20000,85,17700.0,1707,153.63,2300,17700
40000,85,35439.0,1995,179.55,4561,35439
60000,85,53188.0,2063,185.67,6812,53188
80000,85,71016.0,2082,187.38,8984,71016
100000,85,88782.0,2201,198.09,11218,88782
200000,85,177684.0,2323,209.07,22316,177684
400000,85,355675.0,2411,216.99,44325,355675
600000,85,533630.0,2442,219.78,66370,533630
800000,85,711580.0,2558,230.22,88420,711580
1000000,85,889496.0,2595,233.55,110504,889496
2,86,2.0,1,0.09,0,2
3,86,2.0,2,0.18,1,2
100,86,80.0,65,5.85,20,80
200,86,162.0,129,11.61,38,162
2000,86,1702.0,816,73.44,298,1702
10000,86,8792.0,1372,123.48,1208,8792
20000,86,17668.0,1800,162.0,2332,17668
40000,86,35395.0,1953,175.77,4605,35395
60000,86,53267.0,2007,180.63,6733,53267
80000,86,71060.0,2094,188.46,8940,71060
100000,86,88837.0,2145,193.05,11163,88837
200000,86,177862.0,2403,216.27,22138,177862
400000,86,355869.0,2501,225.09,44131,355869
600000,86,533877.0,2534,228.06,66123,533877
800000,86,711793.0,2571,231.39,88207,711793
1000000,86,889631.0,2629,236.61,110369,889631
2,87,2.0,1,0.09,0,2
3,87,3.0,2,0.18,0,3
100,87,85.0,67,6.03,15,85
200,87,168.0,129,11.61,32,168
2000,87,1702.0,705,63.45,298,1702
10000,87,8748.0,1105,99.45,1252,8748
20000,87,17640.0,1239,111.51,2360,17640
40000,87,35404.0,1336,120.24,4596,35404
60000,87,53237.0,1420,127.8,6763,53237
80000,87,71015.0,1468,132.12,8985,71015
100000,87,88745.0,1547,139.23,11255,88745
200000,87,177740.0,1854,166.86,22260,177740
400000,87,355874.0,1959,176.31,44126,355874
600000,87,533619.0,2019,181.71,66381,533619
800000,87,711683.0,2100,189.0,88317,711683
1000000,87,889718.0,2124,191.16,110282,889718
2,88,1.0,1,0.09,1,1
3,88,2.0,2,0.18,1,2
100,88,87.0,66,5.94,13,87
200,88,169.0,130,11.7,31,169
2000,88,1721.0,729,65.61,279,1721
10000,88,8776.0,1365,122.85,1224,8776
20000,88,17700.0,1594,143.46,2300,17700
40000,88,35516.0,1808,162.72,4484,35516
60000,88,53375.0,1899,170.91,6625,53375
80000,88,71217.0,1985,178.65,8783,71217
100000,88,89035.0,2009,180.81,10965,89035
200000,88,178199.0,2304,207.36,21801,178199
400000,88,356284.0,2455,220.95,43716,356284
600000,88,533956.0,2618,235.62,66044,533956
800000,88,712026.0,2687,241.83,87974,712026
1000000,88,890088.0,2764,248.76,109912,890088
2,89,2.0,1,0.09,0,2
3,89,3.0,2,0.18,0,3
100,89,87.0,65,5.85,13,87
200,89,173.0,125,11.25,27,173
2000,89,1720.0,680,61.2,280,1720
10000,89,8780.0,1357,122.13,1220,8780
20000,89,17695.0,1572,141.48,2305,17695
40000,89,35446.0,1789,161.01,4554,35446
60000,89,53226.0,2159,194.31,6774,53226
80000,89,71043.0,2227,200.43,8957,71043
100000,89,88803.0,2265,203.85,11197,88803
200000,89,177674.0,2467,222.03,22326,177674
400000,89,355617.0,2605,234.45,44383,355617
600000,89,533387.0,2676,240.84,66613,533387
800000,89,711362.0,2691,242.19,88638,711362
1000000,89,889651.0,2700,243.0,110349,889651
2,90,2.0,1,0.09,0,2
3,90,2.0,2,0.18,1,2
100,90,91.0,67,6.03,9,91
200,90,180.0,133,11.97,20,180
2000,90,1735.0,838,75.42,265,1735
10000,90,8798.0,1535,138.15,1202,8798
20000,90,17714.0,1858,167.22,2286,17714
40000,90,35544.0,1974,177.66,4456,35544
60000,90,53259.0,2146,193.14,6741,53259
80000,90,71067.0,2181,196.29,8933,71067
100000,90,88910.0,2193,197.37,11090,88910
200000,90,177772.0,2378,214.02,22228,177772
400000,90,355813.0,2466,221.94,44187,355813
600000,90,533660.0,2689,242.01,66340,533660
800000,90,711815.0,2729,245.61,88185,711815
1000000,90,889734.0,2763,248.67,110266,889734
2,91,2.0,1,0.09,0,2
3,91,3.0,2,0.18,0,3
100,91,83.0,63,5.67,17,83
200,91,165.0,118,10.62,35,165
2000,91,1700.0,723,65.07,300,1700
10000,91,8786.0,1154,103.86,1214,8786
20000,91,17704.0,1442,129.78,2296,17704
40000,91,35393.0,1697,152.73,4607,35393
60000,91,53209.0,1727,155.43,6791,53209
80000,91,70945.0,1822,163.98,9055,70945
100000,91,88773.0,1837,165.33,11227,88773
200000,91,177701.0,1980,178.2,22299,177701
400000,91,355627.0,2209,198.81,44373,355627
600000,91,533716.0,2287,205.83,66284,533716
800000,91,711740.0,2309,207.81,88260,711740
1000000,91,889599.0,2331,209.79,110401,889599
2,92,1.0,1,0.09,1,1
3,92,1.0,2,0.18,2,1
100,92,83.0,63,5.67,17,83
200,92,167.0,116,10.44,33,167
2000,92,1714.0,457,41.13,286,1714
10000,92,8803.0,882,79.38,1197,8803
20000,92,17693.0,1071,96.39,2307,17693
40000,92,35440.0,1257,113.13,4560,35440
60000,92,53274.0,1306,117.54,6726,53274
80000,92,71118.0,1360,122.4,8882,71118
100000,92,88948.0,1501,135.09,11052,88948
200000,92,177899.0,1713,154.17,22101,177899
400000,92,355833.0,1839,165.51,44167,355833
600000,92,533899.0,1916,172.44,66101,533899
800000,92,711745.0,1955,175.95,88255,711745
1000000,92,889855.0,2088,187.92,110145,889855
2,93,2.0,1,0.09,0,2
3,93,3.0,2,0.18,0,3
100,93,79.0,66,5.94,21,79
200,93,154.0,132,11.88,46,154
2000,93,1697.0,706,63.54,303,1697
10000,93,8748.0,1384,124.56,1252,8748
20000,93,17686.0,1496,134.64,2314,17686
40000,93,35421.0,1760,158.4,4579,35421
60000,93,53223.0,1864,167.76,6777,53223
80000,93,71070.0,1896,170.64,8930,71070
100000,93,88990.0,1907,171.63,11010,88990
200000,93,177897.0,2052,184.68,22103,177897
400000,93,355776.0,2197,197.73,44224,355776
600000,93,533815.0,2218,199.62,66185,533815
800000,93,711943.0,2225,200.25,88057,711943
1000000,93,890107.0,2252,202.68,109893,890107
2,94,2.0,1,0.09,0,2
3,94,2.0,2,0.18,1,2
100,94,86.0,65,5.85,14,86
200,94,170.0,121,10.89,30,170
2000,94,1678.0,775,69.75,322,1678
10000,94,8757.0,1247,112.23,1243,8757
20000,94,17637.0,1436,129.24,2363,17637
40000,94,35363.0,1606,144.54,4637,35363
60000,94,53237.0,1618,145.62,6763,53237
80000,94,71170.0,1690,152.1,8830,71170
100000,94,89036.0,1704,153.36,10964,89036
200000,94,178116.0,1767,159.03,21884,178116
400000,94,356200.0,2004,180.36,43800,356200
600000,94,534199.0,2120,190.8,65801,534199
800000,94,711988.0,2152,193.68,88012,711988
1000000,94,889928.0,2203,198.27,110072,889928
2,95,1.0,1,0.09,1,1
3,95,2.0,2,0.18,1,2
100,95,86.0,66,5.94,14,86
200,95,173.0,131,11.79,27,173
2000,95,1732.0,831,74.79,268,1732
10000,95,8752.0,1802,162.18,1248,8752
20000,95,17613.0,2052,184.68,2387,17613
40000,95,35310.0,2301,207.09,4690,35310
60000,95,53100.0,2339,210.51,6900,53100
80000,95,70838.0,2413,217.17,9162,70838
100000,95,88639.0,2490,224.1,11361,88639
200000,95,177385.0,2614,235.26,22615,177385
400000,95,355574.0,2808,252.72,44426,355574
600000,95,533509.0,2917,262.53,66491,533509
800000,95,711582.0,2981,268.29,88418,711582
1000000,95,889496.0,3015,271.35,110504,889496
2,96,2.0,1,0.09,0,2
3,96,3.0,2,0.18,0,3
100,96,88.0,66,5.94,12,88
200,96,170.0,125,11.25,30,170
2000,96,1702.0,824,74.16,298,1702
10000,96,8743.0,1484,133.56,1257,8743
20000,96,17635.0,1816,163.44,2365,17635
40000,96,35401.0,1961,176.49,4599,35401
60000,96,53201.0,2087,187.83,6799,53201
80000,96,71011.0,2256,203.04,8989,71011
100000,96,88796.0,2305,207.45,11204,88796
200000,96,177925.0,2370,213.3,22075,177925
400000,96,355892.0,2502,225.18,44108,355892
600000,96,534108.0,2557,230.13,65892,534108
800000,96,712007.0,2604,234.36,87993,712007
1000000,96,890100.0,2625,236.25,109900,890100
2,97,1.0,1,0.09,1,1
3,97,2.0,2,0.18,1,2
100,97,79.0,63,5.67,21,79
200,97,167.0,122,10.98,33,167
2000,97,1732.0,719,64.71,268,1732
10000,97,8780.0,1299,116.91,1220,8780
20000,97,17634.0,1559,140.31,2366,17634
40000,97,35457.0,1729,155.61,4543,35457
60000,97,53215.0,1847,166.23,6785,53215
80000,97,70956.0,1979,178.11,9044,70956
100000,97,88754.0,2063,185.67,11246,88754
200000,97,177766.0,2243,201.87,22234,177766
400000,97,355393.0,2389,215.01,44607,355393
600000,97,533491.0,2489,224.01,66509,533491
800000,97,711463.0,2561,230.49,88537,711463
1000000,97,889605.0,2602,234.18,110395,889605
2,98,1.0,1,0.09,1,1
3,98,2.0,2,0.18,1,2
100,98,83.0,64,5.76,17,83
200,98,162.0,125,11.25,38,162
2000,98,1703.0,874,78.66,297,1703
10000,98,8737.0,1819,163.71,1263,8737
20000,98,17603.0,2040,183.6,2397,17603
40000,98,35345.0,2182,196.38,4655,35345
60000,98,53166.0,2287,205.83,6834,53166
80000,98,70956.0,2330,209.7,9044,70956
100000,98,88785.0,2392,215.28,11215,88785
200000,98,177774.0,2523,227.07,22226,177774
400000,98,355845.0,2833,254.97,44155,355845
600000,98,533925.0,2927,263.43,66075,533925
800000,98,711770.0,3018,271.62,88230,711770
1000000,98,889663.0,3133,281.97,110337,889663
2,99,1.0,1,0.09,1,1
3,99,1.0,2,0.18,2,1
100,99,83.0,64,5.76,17,83
200,99,169.0,129,11.61,31,169
2000,99,1721.0,740,66.6,279,1721
10000,99,8737.0,1232,110.88,1263,8737
20000,99,17623.0,1351,121.59,2377,17623
40000,99,35299.0,1459,131.31,4701,35299
60000,99,53055.0,1630,146.7,6945,53055
80000,99,70846.0,1654,148.86,9154,70846
100000,99,88697.0,1682,151.38,11303,88697
200000,99,177606.0,1797,161.73,22394,177606
400000,99,355613.0,1882,169.38,44387,355613
600000,99,533651.0,1937,174.33,66349,533651
800000,99,711661.0,1947,175.23,88339,711661
1000000,99,889582.0,1962,176.58,110418,889582
2,100,2.0,1,0.09,0,2
3,100,3.0,2,0.18,0,3
100,100,78.0,64,5.76,22,78
200,100,160.0,133,11.97,40,160
2000,100,1691.0,858,77.22,309,1691
10000,100,8763.0,1339,120.51,1237,8763
20000,100,17615.0,1525,137.25,2385,17615
40000,100,35469.0,1598,143.82,4531,35469
60000,100,53300.0,1638,147.42,6700,53300
80000,100,71079.0,1706,153.54,8921,71079
100000,100,88900.0,1760,158.4,11100,88900
200000,100,177923.0,1905,171.45,22077,177923
400000,100,355843.0,2046,184.14,44157,355843
600000,100,533997.0,2101,189.09,66003,533997
800000,100,711718.0,2317,208.53,88282,711718
1000000,100,889680.0,2601,234.09,110320,889680
