Timestep,Iteration,Total Reward,Suboptimal Arms,Total Regret,Zeros Count,Ones Count
2,1,2.0,2,0.18,0,2
3,1,3.0,2,0.18,0,3
100,1,79.0,67,6.03,21,79
200,1,157.0,131,11.79,43,157
2000,1,1729.0,535,48.15,271,1729
10000,1,8857.0,700,63.0,1143,8857
20000,1,17783.0,751,67.59,2217,17783
40000,1,35540.0,802,72.18,4460,35540
60000,1,53343.0,823,74.07,6657,53343
80000,1,71164.0,954,85.86,8836,71164
100000,1,88951.0,960,86.4,11049,88951
200000,1,177996.0,967,87.03,22004,177996
400000,1,356104.0,994,89.46,43896,356104
600000,1,534027.0,1008,90.72,65973,534027
800000,1,712213.0,1013,91.17,87787,712213
1000000,1,890312.0,1013,91.17,109688,890312
2,2,2.0,2,0.18,0,2
3,2,3.0,2,0.18,0,3
100,2,83.0,62,5.58,17,83
200,2,169.0,104,9.36,31,169
2000,2,1733.0,562,50.58,267,1733
10000,2,8828.0,888,79.92,1172,8828
20000,2,17677.0,974,87.66,2323,17677
40000,2,35464.0,1053,94.77,4536,35464
60000,2,53274.0,1070,96.3,6726,53274
80000,2,71188.0,1070,96.3,8812,71188
100000,2,88929.0,1071,96.39,11071,88929
200000,2,177943.0,1196,107.64,22057,177943
400000,2,356166.0,1277,114.93,43834,356166
600000,2,534167.0,1346,121.14,65833,534167
800000,2,712502.0,1346,121.14,87498,712502
1000000,2,890387.0,1346,121.14,109613,890387
2,3,1.0,2,0.18,1,1
3,3,2.0,2,0.18,1,2
100,3,82.0,76,6.84,18,82
200,3,172.0,126,11.34,28,172
2000,3,1763.0,453,40.77,237,1763
10000,3,8801.0,769,69.21,1199,8801
20000,3,17693.0,808,72.72,2307,17693
40000,3,35485.0,916,82.44,4515,35485
60000,3,53264.0,923,83.07,6736,53264
80000,3,70958.0,939,84.51,9042,70958
100000,3,88882.0,939,84.51,11118,88882
200000,3,177833.0,941,84.69,22167,177833
400000,3,355962.0,946,85.14,44038,355962
600000,3,533957.0,980,88.2,66043,533957
800000,3,711851.0,991,89.19,88149,711851
1000000,3,889649.0,1004,90.36,110351,889649
2,4,1.0,2,0.18,1,1
3,4,2.0,2,0.18,1,2
100,4,86.0,61,5.49,14,86
200,4,178.0,103,9.27,22,178
2000,4,1749.0,449,40.41,251,1749
10000,4,8833.0,1065,95.85,1167,8833
20000,4,17779.0,1106,99.54,2221,17779
40000,4,35580.0,1162,104.58,4420,35580
60000,4,53392.0,1295,116.55,6608,53392
80000,4,71108.0,1355,121.95,8892,71108
100000,4,88884.0,1359,122.31,11116,88884
200000,4,177864.0,1469,132.21,22136,177864
400000,4,355907.0,1475,132.75,44093,355907
600000,4,533906.0,1476,132.84,66094,533906
800000,4,711908.0,1488,133.92,88092,711908
1000000,4,890014.0,1489,134.01,109986,890014
2,5,1.0,2,0.18,1,1
3,5,1.0,2,0.18,2,1
100,5,89.0,61,5.49,11,89
200,5,166.0,115,10.35,34,166
2000,5,1747.0,454,40.86,253,1747
10000,5,8840.0,714,64.26,1160,8840
20000,5,17765.0,816,73.44,2235,17765
40000,5,35569.0,825,74.25,4431,35569
60000,5,53461.0,830,74.7,6539,53461
80000,5,71289.0,837,75.33,8711,71289
100000,5,89117.0,839,75.51,10883,89117
200000,5,178125.0,880,79.2,21875,178125
400000,5,356120.0,885,79.65,43880,356120
600000,5,534334.0,885,79.65,65666,534334
800000,5,712426.0,886,79.74,87574,712426
1000000,5,890577.0,886,79.74,109423,890577
2,6,2.0,2,0.18,0,2
3,6,3.0,2,0.18,0,3
100,6,85.0,55,4.95,15,85
200,6,171.0,119,10.71,29,171
2000,6,1726.0,494,44.46,274,1726
10000,6,8851.0,709,63.81,1149,8851
20000,6,17739.0,746,67.14,2261,17739
40000,6,35574.0,772,69.48,4426,35574
60000,6,53324.0,824,74.16,6676,53324
80000,6,71141.0,888,79.92,8859,71141
100000,6,88919.0,893,80.37,11081,88919
200000,6,177998.0,905,81.45,22002,177998
400000,6,356050.0,931,83.79,43950,356050
600000,6,533956.0,939,84.51,66044,533956
800000,6,711877.0,1013,91.17,88123,711877
1000000,6,889745.0,1013,91.17,110255,889745
2,7,2.0,2,0.18,0,2
3,7,3.0,2,0.18,0,3
100,7,87.0,58,5.22,13,87
200,7,175.0,100,9.0,25,175
2000,7,1726.0,720,64.8,274,1726
10000,7,8832.0,967,87.03,1168,8832
20000,7,17725.0,1215,109.35,2275,17725
40000,7,35510.0,1269,114.21,4490,35510
60000,7,53299.0,1285,115.65,6701,53299
80000,7,71041.0,1317,118.53,8959,71041
100000,7,88909.0,1319,118.71,11091,88909
200000,7,178028.0,1321,118.89,21972,178028
400000,7,356219.0,1331,119.79,43781,356219
600000,7,534379.0,1382,124.38,65621,534379
800000,7,712293.0,1383,124.47,87707,712293
1000000,7,890099.0,1386,124.74,109901,890099
2,8,2.0,2,0.18,0,2
3,8,3.0,2,0.18,0,3
100,8,89.0,70,6.3,11,89
200,8,173.0,117,10.53,27,173
2000,8,1732.0,450,40.5,268,1732
10000,8,8803.0,838,75.42,1197,8803
20000,8,17701.0,883,79.47,2299,17701
40000,8,35524.0,894,80.46,4476,35524
60000,8,53353.0,912,82.08,6647,53353
80000,8,71123.0,935,84.15,8877,71123
100000,8,88948.0,938,84.42,11052,88948
200000,8,177850.0,980,88.2,22150,177850
400000,8,355831.0,993,89.37,44169,355831
600000,8,533702.0,997,89.73,66298,533702
800000,8,711742.0,997,89.73,88258,711742
1000000,8,889622.0,997,89.73,110378,889622
2,9,1.0,2,0.18,1,1
3,9,2.0,2,0.18,1,2
100,9,75.0,67,6.03,25,75
200,9,158.0,144,12.96,42,158
2000,9,1699.0,656,59.04,301,1699
10000,9,8824.0,939,84.51,1176,8824
20000,9,17708.0,1024,92.16,2292,17708
40000,9,35480.0,1059,95.31,4520,35480
60000,9,53225.0,1065,95.85,6775,53225
80000,9,70984.0,1088,97.92,9016,70984
100000,9,88807.0,1088,97.92,11193,88807
200000,9,177839.0,1110,99.9,22161,177839
400000,9,355786.0,1363,122.67,44214,355786
600000,9,533597.0,1390,125.1,66403,533597
800000,9,711765.0,1390,125.1,88235,711765
1000000,9,889746.0,1395,125.55,110254,889746
2,10,2.0,2,0.18,0,2
3,10,2.0,2,0.18,1,2
100,10,83.0,52,4.68,17,83
200,10,165.0,101,9.09,35,165
2000,10,1748.0,581,52.29,252,1748
10000,10,8781.0,945,85.05,1219,8781
20000,10,17725.0,980,88.2,2275,17725
40000,10,35579.0,982,88.38,4421,35579
60000,10,53381.0,1008,90.72,6619,53381
80000,10,71207.0,1052,94.68,8793,71207
100000,10,88980.0,1055,94.95,11020,88980
200000,10,177810.0,1066,95.94,22190,177810
400000,10,355724.0,1078,97.02,44276,355724
600000,10,533640.0,1082,97.38,66360,533640
800000,10,711794.0,1082,97.38,88206,711794
1000000,10,889807.0,1082,97.38,110193,889807
2,11,2.0,2,0.18,0,2
3,11,3.0,2,0.18,0,3
100,11,88.0,63,5.67,12,88
200,11,173.0,125,11.25,27,173
2000,11,1743.0,605,54.45,257,1743
10000,11,8865.0,894,80.46,1135,8865
20000,11,17715.0,1027,92.43,2285,17715
40000,11,35532.0,1054,94.86,4468,35532
60000,11,53343.0,1134,102.06,6657,53343
80000,11,71126.0,1240,111.6,8874,71126
100000,11,88937.0,1246,112.14,11063,88937
200000,11,177999.0,1261,113.49,22001,177999
400000,11,356151.0,1265,113.85,43849,356151
600000,11,534117.0,1265,113.85,65883,534117
800000,11,712114.0,1287,115.83,87886,712114
1000000,11,890334.0,1289,116.01,109666,890334
2,12,2.0,2,0.18,0,2
3,12,3.0,2,0.18,0,3
100,12,86.0,59,5.31,14,86
200,12,165.0,124,11.16,35,165
2000,12,1729.0,559,50.31,271,1729
10000,12,8782.0,996,89.64,1218,8782
20000,12,17706.0,997,89.73,2294,17706
40000,12,35454.0,1065,95.85,4546,35454
60000,12,53250.0,1078,97.02,6750,53250
80000,12,71038.0,1089,98.01,8962,71038
100000,12,88835.0,1091,98.19,11165,88835
200000,12,177684.0,1099,98.91,22316,177684
400000,12,355618.0,1116,100.44,44382,355618
600000,12,533538.0,1120,100.8,66462,533538
800000,12,711480.0,1125,101.25,88520,711480
1000000,12,889661.0,1125,101.25,110339,889661
2,13,2.0,2,0.18,0,2
3,13,3.0,2,0.18,0,3
100,13,84.0,51,4.59,16,84
200,13,161.0,93,8.37,39,161
2000,13,1720.0,425,38.25,280,1720
10000,13,8779.0,654,58.86,1221,8779
20000,13,17706.0,655,58.95,2294,17706
40000,13,35542.0,740,66.6,4458,35542
60000,13,53378.0,742,66.78,6622,53378
80000,13,71224.0,750,67.5,8776,71224
100000,13,89055.0,750,67.5,10945,89055
200000,13,177992.0,773,69.57,22008,177992
400000,13,355977.0,817,73.53,44023,355977
600000,13,533889.0,817,73.53,66111,533889
800000,13,711890.0,817,73.53,88110,711890
1000000,13,889954.0,817,73.53,110046,889954
2,14,2.0,2,0.18,0,2
3,14,3.0,2,0.18,0,3
100,14,88.0,52,4.68,12,88
200,14,171.0,102,9.18,29,171
2000,14,1746.0,404,36.36,254,1746
10000,14,8841.0,851,76.59,1159,8841
20000,14,17724.0,982,88.38,2276,17724
40000,14,35590.0,999,89.91,4410,35590
60000,14,53390.0,1092,98.28,6610,53390
80000,14,71156.0,1109,99.81,8844,71156
100000,14,88980.0,1111,99.99,11020,88980
200000,14,177925.0,1145,103.05,22075,177925
400000,14,356094.0,1148,103.32,43906,356094
600000,14,533903.0,1159,104.31,66097,533903
800000,14,711802.0,1180,106.2,88198,711802
1000000,14,889976.0,1180,106.2,110024,889976
2,15,1.0,2,0.18,1,1
3,15,2.0,2,0.18,1,2
100,15,82.0,57,5.13,18,82
200,15,162.0,92,8.28,38,162
2000,15,1750.0,245,22.05,250,1750
10000,15,8830.0,400,36.0,1170,8830
20000,15,17751.0,402,36.18,2249,17751
40000,15,35564.0,445,40.05,4436,35564
60000,15,53327.0,602,54.18,6673,53327
80000,15,71196.0,602,54.18,8804,71196
100000,15,88967.0,612,55.08,11033,88967
200000,15,177941.0,690,62.1,22059,177941
400000,15,356053.0,712,64.08,43947,356053
600000,15,534046.0,722,64.98,65954,534046
800000,15,712174.0,722,64.98,87826,712174
1000000,15,890149.0,731,65.79,109851,890149
2,16,2.0,2,0.18,0,2
3,16,3.0,2,0.18,0,3
100,16,77.0,54,4.86,23,77
200,16,166.0,76,6.84,34,166
2000,16,1738.0,332,29.88,262,1738
10000,16,8788.0,564,50.76,1212,8788
20000,16,17640.0,590,53.1,2360,17640
40000,16,35450.0,590,53.1,4550,35450
60000,16,53279.0,590,53.1,6721,53279
80000,16,71008.0,620,55.8,8992,71008
100000,16,88816.0,620,55.8,11184,88816
200000,16,177713.0,643,57.87,22287,177713
400000,16,355858.0,648,58.32,44142,355858
600000,16,533794.0,659,59.31,66206,533794
800000,16,711813.0,659,59.31,88187,711813
1000000,16,889529.0,659,59.31,110471,889529
2,17,2.0,2,0.18,0,2
3,17,3.0,2,0.18,0,3
100,17,81.0,48,4.32,19,81
200,17,158.0,107,9.63,42,158
2000,17,1742.0,484,43.56,258,1742
10000,17,8807.0,756,68.04,1193,8807
20000,17,17697.0,782,70.38,2303,17697
40000,17,35536.0,787,70.83,4464,35536
60000,17,53351.0,790,71.1,6649,53351
80000,17,71052.0,798,71.82,8948,71052
100000,17,88880.0,820,73.8,11120,88880
200000,17,177807.0,862,77.58,22193,177807
400000,17,355669.0,926,83.34,44331,355669
600000,17,533441.0,940,84.6,66559,533441
800000,17,711398.0,989,89.01,88602,711398
1000000,17,889512.0,989,89.01,110488,889512
2,18,1.0,2,0.18,1,1
3,18,2.0,2,0.18,1,2
100,18,82.0,63,5.67,18,82
200,18,166.0,105,9.45,34,166
2000,18,1724.0,404,36.36,276,1724
10000,18,8784.0,554,49.86,1216,8784
20000,18,17691.0,555,49.95,2309,17691
40000,18,35473.0,558,50.22,4527,35473
60000,18,53199.0,563,50.67,6801,53199
80000,18,71023.0,563,50.67,8977,71023
100000,18,88801.0,572,51.48,11199,88801
200000,18,178008.0,576,51.84,21992,178008
400000,18,355723.0,680,61.2,44277,355723
600000,18,533409.0,684,61.56,66591,533409
800000,18,711390.0,706,63.54,88610,711390
1000000,18,889052.0,709,63.81,110948,889052
2,19,1.0,2,0.18,1,1
3,19,2.0,2,0.18,1,2
100,19,83.0,46,4.14,17,83
200,19,172.0,81,7.29,28,172
2000,19,1733.0,536,48.24,267,1733
10000,19,8788.0,718,64.62,1212,8788
20000,19,17666.0,761,68.49,2334,17666
40000,19,35408.0,775,69.75,4592,35408
60000,19,53142.0,781,70.29,6858,53142
80000,19,70970.0,786,70.74,9030,70970
100000,19,88706.0,834,75.06,11294,88706
200000,19,177608.0,838,75.42,22392,177608
400000,19,355422.0,841,75.69,44578,355422
600000,19,533520.0,841,75.69,66480,533520
800000,19,711291.0,841,75.69,88709,711291
1000000,19,889145.0,841,75.69,110855,889145
2,20,2.0,2,0.18,0,2
3,20,3.0,2,0.18,0,3
100,20,89.0,52,4.68,11,89
200,20,172.0,103,9.27,28,172
2000,20,1744.0,501,45.09,256,1744
10000,20,8840.0,666,59.94,1160,8840
20000,20,17734.0,706,63.54,2266,17734
40000,20,35532.0,737,66.33,4468,35532
60000,20,53359.0,742,66.78,6641,53359
80000,20,71104.0,746,67.14,8896,71104
100000,20,88921.0,751,67.59,11079,88921
200000,20,177976.0,911,81.99,22024,177976
400000,20,355536.0,1103,99.27,44464,355536
600000,20,533446.0,1107,99.63,66554,533446
800000,20,711674.0,1107,99.63,88326,711674
1000000,20,889725.0,1110,99.9,110275,889725
2,21,2.0,2,0.18,0,2
3,21,3.0,2,0.18,0,3
100,21,77.0,67,6.03,23,77
200,21,157.0,129,11.61,43,157
2000,21,1723.0,493,44.37,277,1723
10000,21,8830.0,614,55.26,1170,8830
20000,21,17732.0,645,58.05,2268,17732
40000,21,35516.0,662,59.58,4484,35516
60000,21,53210.0,720,64.8,6790,53210
80000,21,70928.0,721,64.89,9072,70928
100000,21,88669.0,722,64.98,11331,88669
200000,21,177819.0,722,64.98,22181,177819
400000,21,355683.0,737,66.33,44317,355683
600000,21,533712.0,737,66.33,66288,533712
800000,21,711792.0,737,66.33,88208,711792
1000000,21,889819.0,737,66.33,110181,889819
2,22,1.0,2,0.18,1,1
3,22,2.0,2,0.18,1,2
100,22,79.0,49,4.41,21,79
200,22,166.0,89,8.01,34,166
2000,22,1720.0,500,45.0,280,1720
10000,22,8790.0,857,77.13,1210,8790
20000,22,17696.0,888,79.92,2304,17696
40000,22,35433.0,897,80.73,4567,35433
60000,22,53232.0,936,84.24,6768,53232
80000,22,71048.0,939,84.51,8952,71048
100000,22,88821.0,940,84.6,11179,88821
200000,22,177797.0,960,86.4,22203,177797
400000,22,355824.0,985,88.65,44176,355824
600000,22,533956.0,985,88.65,66044,533956
800000,22,711854.0,986,88.74,88146,711854
1000000,22,889936.0,990,89.1,110064,889936
2,23,2.0,2,0.18,0,2
3,23,3.0,2,0.18,0,3
100,23,85.0,57,5.13,15,85
200,23,167.0,106,9.54,33,167
2000,23,1731.0,538,48.42,269,1731
10000,23,8790.0,938,84.42,1210,8790
20000,23,17688.0,964,86.76,2312,17688
40000,23,35472.0,977,87.93,4528,35472
60000,23,53280.0,980,88.2,6720,53280
80000,23,71084.0,984,88.56,8916,71084
100000,23,88877.0,985,88.65,11123,88877
200000,23,177758.0,992,89.28,22242,177758
400000,23,355921.0,1011,90.99,44079,355921
600000,23,534331.0,1011,90.99,65669,534331
800000,23,712278.0,1044,93.96,87722,712278
1000000,23,890139.0,1044,93.96,109861,890139
2,24,2.0,2,0.18,0,2
3,24,3.0,2,0.18,0,3
100,24,87.0,61,5.49,13,87
200,24,164.0,120,10.8,36,164
2000,24,1660.0,785,70.65,340,1660
10000,24,8788.0,801,72.09,1212,8788
20000,24,17680.0,826,74.34,2320,17680
40000,24,35473.0,901,81.09,4527,35473
60000,24,53259.0,931,83.79,6741,53259
80000,24,71025.0,943,84.87,8975,71025
100000,24,88833.0,944,84.96,11167,88833
200000,24,177831.0,954,85.86,22169,177831
400000,24,355628.0,965,86.85,44372,355628
600000,24,533375.0,984,88.56,66625,533375
800000,24,711471.0,984,88.56,88529,711471
1000000,24,889605.0,986,88.74,110395,889605
2,25,1.0,2,0.18,1,1
3,25,2.0,2,0.18,1,2
100,25,85.0,40,3.6,15,85
200,25,169.0,83,7.47,31,169
2000,25,1724.0,445,40.05,276,1724
10000,25,8871.0,528,47.52,1129,8871
20000,25,17755.0,709,63.81,2245,17755
40000,25,35534.0,741,66.69,4466,35534
60000,25,53403.0,749,67.41,6597,53403
80000,25,71099.0,782,70.38,8901,71099
100000,25,88914.0,875,78.75,11086,88914
200000,25,177986.0,884,79.56,22014,177986
400000,25,355814.0,919,82.71,44186,355814
600000,25,533910.0,940,84.6,66090,533910
800000,25,711888.0,940,84.6,88112,711888
1000000,25,889840.0,940,84.6,110160,889840
2,26,2.0,2,0.18,0,2
3,26,2.0,2,0.18,1,2
100,26,81.0,63,5.67,19,81
200,26,163.0,106,9.54,37,163
2000,26,1729.0,539,48.51,271,1729
10000,26,8864.0,804,72.36,1136,8864
20000,26,17674.0,905,81.45,2326,17674
40000,26,35493.0,928,83.52,4507,35493
60000,26,53291.0,934,84.06,6709,53291
80000,26,71130.0,937,84.33,8870,71130
100000,26,88854.0,949,85.41,11146,88854
200000,26,177965.0,956,86.04,22035,177965
400000,26,355648.0,992,89.28,44352,355648
600000,26,533407.0,996,89.64,66593,533407
800000,26,711541.0,996,89.64,88459,711541
1000000,26,889390.0,1015,91.35,110610,889390
2,27,0.0,2,0.18,2,0
3,27,1.0,2,0.18,2,1
100,27,77.0,68,6.12,23,77
200,27,162.0,116,10.44,38,162
2000,27,1730.0,379,34.11,270,1730
10000,27,8823.0,754,67.86,1177,8823
20000,27,17697.0,820,73.8,2303,17697
40000,27,35519.0,824,74.16,4481,35519
60000,27,53292.0,833,74.97,6708,53292
80000,27,71133.0,833,74.97,8867,71133
100000,27,88869.0,958,86.22,11131,88869
200000,27,177869.0,1083,97.47,22131,177869
400000,27,355954.0,1093,98.37,44046,355954
600000,27,533991.0,1096,98.64,66009,533991
800000,27,711938.0,1098,98.82,88062,711938
1000000,27,889947.0,1100,99.0,110053,889947
2,28,1.0,2,0.18,1,1
3,28,2.0,2,0.18,1,2
100,28,88.0,51,4.59,12,88
200,28,173.0,93,8.37,27,173
2000,28,1694.0,586,52.74,306,1694
10000,28,8819.0,682,61.38,1181,8819
20000,28,17714.0,748,67.32,2286,17714
40000,28,35565.0,769,69.21,4435,35565
60000,28,53408.0,793,71.37,6592,53408
80000,28,71120.0,796,71.64,8880,71120
100000,28,88912.0,797,71.73,11088,88912
200000,28,178013.0,801,72.09,21987,178013
400000,28,355755.0,812,73.08,44245,355755
600000,28,533869.0,812,73.08,66131,533869
800000,28,711713.0,812,73.08,88287,711713
1000000,28,889734.0,814,73.26,110266,889734
2,29,2.0,2,0.18,0,2
3,29,3.0,2,0.18,0,3
100,29,86.0,44,3.96,14,86
200,29,172.0,78,7.02,28,172
2000,29,1748.0,338,30.42,252,1748
10000,29,8835.0,642,57.78,1165,8835
20000,29,17677.0,654,58.86,2323,17677
40000,29,35499.0,655,58.95,4501,35499
60000,29,53278.0,663,59.67,6722,53278
80000,29,71045.0,671,60.39,8955,71045
100000,29,88903.0,671,60.39,11097,88903
200000,29,177897.0,675,60.75,22103,177897
400000,29,355717.0,679,61.11,44283,355717
600000,29,533807.0,679,61.11,66193,533807
800000,29,711822.0,679,61.11,88178,711822
1000000,29,889917.0,679,61.11,110083,889917
2,30,0.0,2,0.18,2,0
3,30,1.0,2,0.18,2,1
100,30,79.0,42,3.78,21,79
200,30,163.0,60,5.4,37,163
2000,30,1749.0,283,25.47,251,1749
10000,30,8852.0,582,52.38,1148,8852
20000,30,17738.0,602,54.18,2262,17738
40000,30,35538.0,715,64.35,4462,35538
60000,30,53274.0,750,67.5,6726,53274
80000,30,71051.0,751,67.59,8949,71051
100000,30,88811.0,752,67.68,11189,88811
200000,30,177828.0,754,67.86,22172,177828
400000,30,355742.0,1172,105.48,44258,355742
600000,30,533952.0,1172,105.48,66048,533952
800000,30,711919.0,1181,106.29,88081,711919
1000000,30,890078.0,1181,106.29,109922,890078
2,31,2.0,2,0.18,0,2
3,31,2.0,2,0.18,1,2
100,31,86.0,60,5.4,14,86
200,31,168.0,101,9.09,32,168
2000,31,1722.0,504,45.36,278,1722
10000,31,8815.0,754,67.86,1185,8815
20000,31,17713.0,790,71.1,2287,17713
40000,31,35514.0,807,72.63,4486,35514
60000,31,53309.0,851,76.59,6691,53309
80000,31,71135.0,939,84.51,8865,71135
100000,31,89003.0,970,87.3,10997,89003
200000,31,177920.0,1087,97.83,22080,177920
400000,31,355718.0,1105,99.45,44282,355718
600000,31,533710.0,1110,99.9,66290,533710
800000,31,711697.0,1112,100.08,88303,711697
1000000,31,889916.0,1112,100.08,110084,889916
2,32,2.0,2,0.18,0,2
3,32,3.0,2,0.18,0,3
100,32,84.0,58,5.22,16,84
200,32,167.0,119,10.71,33,167
2000,32,1728.0,380,34.2,272,1728
10000,32,8866.0,491,44.19,1134,8866
20000,32,17847.0,491,44.19,2153,17847
40000,32,35644.0,521,46.89,4356,35644
60000,32,53483.0,527,47.43,6517,53483
80000,32,71259.0,539,48.51,8741,71259
100000,32,89135.0,566,50.94,10865,89135
200000,32,178150.0,606,54.54,21850,178150
400000,32,356390.0,614,55.26,43610,356390
600000,32,534623.0,624,56.16,65377,534623
800000,32,712680.0,624,56.16,87320,712680
1000000,32,890639.0,624,56.16,109361,890639
2,33,2.0,2,0.18,0,2
3,33,3.0,2,0.18,0,3
100,33,84.0,53,4.77,16,84
200,33,166.0,95,8.55,34,166
2000,33,1720.0,346,31.14,280,1720
10000,33,8816.0,573,51.57,1184,8816
20000,33,17654.0,824,74.16,2346,17654
40000,33,35536.0,824,74.16,4464,35536
60000,33,53333.0,826,74.34,6667,53333
80000,33,71208.0,826,74.34,8792,71208
100000,33,88966.0,838,75.42,11034,88966
200000,33,177944.0,847,76.23,22056,177944
400000,33,356045.0,848,76.32,43955,356045
600000,33,534023.0,1005,90.45,65977,534023
800000,33,711993.0,1010,90.9,88007,711993
1000000,33,889976.0,1010,90.9,110024,889976
2,34,2.0,2,0.18,0,2
3,34,3.0,2,0.18,0,3
100,34,89.0,64,5.76,11,89
200,34,170.0,98,8.82,30,170
2000,34,1733.0,506,45.54,267,1733
10000,34,8854.0,661,59.49,1146,8854
20000,34,17786.0,666,59.94,2214,17786
40000,34,35540.0,737,66.33,4460,35540
60000,34,53229.0,871,78.39,6771,53229
80000,34,71014.0,883,79.47,8986,71014
100000,34,88851.0,883,79.47,11149,88851
200000,34,177758.0,903,81.27,22242,177758
400000,34,355983.0,904,81.36,44017,355983
600000,34,534017.0,904,81.36,65983,534017
800000,34,711919.0,957,86.13,88081,711919
1000000,34,889872.0,959,86.31,110128,889872
2,35,1.0,2,0.18,1,1
3,35,2.0,2,0.18,1,2
100,35,78.0,67,6.03,22,78
200,35,160.0,123,11.07,40,160
2000,35,1741.0,447,40.23,259,1741
10000,35,8831.0,719,64.71,1169,8831
20000,35,17750.0,739,66.51,2250,17750
40000,35,35474.0,849,76.41,4526,35474
60000,35,53271.0,892,80.28,6729,53271
80000,35,71082.0,949,85.41,8918,71082
100000,35,88869.0,950,85.5,11131,88869
200000,35,177933.0,965,86.85,22067,177933
400000,35,356178.0,966,86.94,43822,356178
600000,35,534330.0,966,86.94,65670,534330
800000,35,712325.0,995,89.55,87675,712325
1000000,35,890590.0,1001,90.09,109410,890590
2,36,1.0,2,0.18,1,1
3,36,2.0,2,0.18,1,2
100,36,83.0,49,4.41,17,83
200,36,169.0,79,7.11,31,169
2000,36,1741.0,459,41.31,259,1741
10000,36,8822.0,745,67.05,1178,8822
20000,36,17652.0,851,76.59,2348,17652
40000,36,35439.0,863,77.67,4561,35439
60000,36,53247.0,874,78.66,6753,53247
80000,36,71058.0,874,78.66,8942,71058
100000,36,88841.0,879,79.11,11159,88841
200000,36,177715.0,888,79.92,22285,177715
400000,36,356115.0,921,82.89,43885,356115
600000,36,534033.0,921,82.89,65967,534033
800000,36,712017.0,955,85.95,87983,712017
1000000,36,889929.0,957,86.13,110071,889929
2,37,2.0,2,0.18,0,2
3,37,3.0,2,0.18,0,3
100,37,84.0,59,5.31,16,84
200,37,168.0,86,7.74,32,168
2000,37,1734.0,519,46.71,266,1734
10000,37,8839.0,647,58.23,1161,8839
20000,37,17710.0,666,59.94,2290,17710
40000,37,35475.0,674,60.66,4525,35475
60000,37,53331.0,678,61.02,6669,53331
80000,37,71202.0,678,61.02,8798,71202
100000,37,88963.0,695,62.55,11037,88963
200000,37,177931.0,749,67.41,22069,177931
400000,37,356162.0,751,67.59,43838,356162
600000,37,533943.0,752,67.68,66057,533943
800000,37,711830.0,754,67.86,88170,711830
1000000,37,889792.0,754,67.86,110208,889792
2,38,2.0,2,0.18,0,2
3,38,3.0,2,0.18,0,3
100,38,89.0,50,4.5,11,89
200,38,173.0,99,8.91,27,173
2000,38,1763.0,319,28.71,237,1763
10000,38,8855.0,743,66.87,1145,8855
20000,38,17786.0,775,69.75,2214,17786
40000,38,35541.0,818,73.62,4459,35541
60000,38,53344.0,880,79.2,6656,53344
80000,38,71222.0,883,79.47,8778,71222
100000,38,89023.0,922,82.98,10977,89023
200000,38,178066.0,956,86.04,21934,178066
400000,38,356145.0,997,89.73,43855,356145
600000,38,534187.0,999,89.91,65813,534187
800000,38,712263.0,999,89.91,87737,712263
1000000,38,890119.0,1018,91.62,109881,890119
2,39,2.0,2,0.18,0,2
3,39,3.0,2,0.18,0,3
100,39,83.0,73,6.57,17,83
200,39,159.0,144,12.96,41,159
2000,39,1718.0,497,44.73,282,1718
10000,39,8868.0,646,58.14,1132,8868
20000,39,17741.0,711,63.99,2259,17741
40000,39,35517.0,732,65.88,4483,35517
60000,39,53315.0,734,66.06,6685,53315
80000,39,71044.0,743,66.87,8956,71044
100000,39,88781.0,769,69.21,11219,88781
200000,39,177762.0,771,69.39,22238,177762
400000,39,355629.0,774,69.66,44371,355629
600000,39,533893.0,774,69.66,66107,533893
800000,39,712145.0,774,69.66,87855,712145
1000000,39,890346.0,774,69.66,109654,890346
2,40,1.0,2,0.18,1,1
3,40,2.0,2,0.18,1,2
100,40,82.0,58,5.22,18,82
200,40,168.0,112,10.08,32,168
2000,40,1737.0,477,42.93,263,1737
10000,40,8846.0,698,62.82,1154,8846
20000,40,17712.0,763,68.67,2288,17712
40000,40,35492.0,809,72.81,4508,35492
60000,40,53311.0,811,72.99,6689,53311
80000,40,71099.0,811,72.99,8901,71099
100000,40,88921.0,867,78.03,11079,88921
200000,40,178028.0,882,79.38,21972,178028
400000,40,356199.0,885,79.65,43801,356199
600000,40,534200.0,885,79.65,65800,534200
800000,40,712274.0,935,84.15,87726,712274
1000000,40,890403.0,946,85.14,109597,890403
2,41,1.0,2,0.18,1,1
3,41,2.0,2,0.18,1,2
100,41,83.0,61,5.49,17,83
200,41,171.0,104,9.36,29,171
2000,41,1752.0,381,34.29,248,1752
10000,41,8785.0,517,46.53,1215,8785
20000,41,17663.0,544,48.96,2337,17663
40000,41,35379.0,583,52.47,4621,35379
60000,41,53157.0,591,53.19,6843,53157
80000,41,70933.0,621,55.89,9067,70933
100000,41,88734.0,621,55.89,11266,88734
200000,41,177582.0,637,57.33,22418,177582
400000,41,355507.0,749,67.41,44493,355507
600000,41,533626.0,749,67.41,66374,533626
800000,41,711442.0,749,67.41,88558,711442
1000000,41,889439.0,750,67.5,110561,889439
2,42,2.0,2,0.18,0,2
3,42,3.0,2,0.18,0,3
100,42,89.0,64,5.76,11,89
200,42,166.0,108,9.72,34,166
2000,42,1715.0,594,53.46,285,1715
10000,42,8673.0,1544,138.96,1327,8673
20000,42,17615.0,1544,138.96,2385,17615
40000,42,35417.0,1544,138.96,4583,35417
60000,42,53233.0,1544,138.96,6767,53233
80000,42,71056.0,1548,139.32,8944,71056
100000,42,88907.0,1567,141.03,11093,88907
200000,42,177881.0,1577,141.93,22119,177881
400000,42,356007.0,1622,145.98,43993,356007
600000,42,533761.0,1630,146.7,66239,533761
800000,42,711785.0,1630,146.7,88215,711785
1000000,42,889850.0,1784,160.56,110150,889850
2,43,2.0,2,0.18,0,2
3,43,3.0,2,0.18,0,3
100,43,81.0,36,3.24,19,81
200,43,166.0,54,4.86,34,166
2000,43,1753.0,192,17.28,247,1753
10000,43,8889.0,302,27.18,1111,8889
20000,43,17832.0,316,28.44,2168,17832
40000,43,35749.0,316,28.44,4251,35749
60000,43,53588.0,317,28.53,6412,53588
80000,43,71340.0,361,32.49,8660,71340
100000,43,89123.0,362,32.58,10877,89123
200000,43,178125.0,382,34.38,21875,178125
400000,43,356301.0,383,34.47,43699,356301
600000,43,534417.0,383,34.47,65583,534417
800000,43,712539.0,383,34.47,87461,712539
1000000,43,890354.0,383,34.47,109646,890354
2,44,2.0,2,0.18,0,2
3,44,3.0,2,0.18,0,3
100,44,85.0,67,6.03,15,85
200,44,168.0,131,11.79,32,168
2000,44,1745.0,411,36.99,255,1745
10000,44,8830.0,589,53.01,1170,8830
20000,44,17729.0,602,54.18,2271,17729
40000,44,35572.0,668,60.12,4428,35572
60000,44,53430.0,675,60.75,6570,53430
80000,44,71268.0,700,63.0,8732,71268
100000,44,89095.0,701,63.09,10905,89095
200000,44,177949.0,770,69.3,22051,177949
400000,44,355899.0,843,75.87,44101,355899
600000,44,534051.0,844,75.96,65949,534051
800000,44,711983.0,846,76.14,88017,711983
1000000,44,889986.0,846,76.14,110014,889986
2,45,2.0,2,0.18,0,2
3,45,3.0,2,0.18,0,3
100,45,91.0,54,4.86,9,91
200,45,183.0,103,9.27,17,183
2000,45,1760.0,525,47.25,240,1760
10000,45,8865.0,949,85.41,1135,8865
20000,45,17814.0,1045,94.05,2186,17814
40000,45,35605.0,1118,100.62,4395,35605
60000,45,53366.0,1169,105.21,6634,53366
80000,45,71173.0,1182,106.38,8827,71173
100000,45,88947.0,1242,111.78,11053,88947
200000,45,177858.0,1274,114.66,22142,177858
400000,45,355745.0,1282,115.38,44255,355745
600000,45,533960.0,1282,115.38,66040,533960
800000,45,711930.0,1306,117.54,88070,711930
1000000,45,889663.0,1313,118.17,110337,889663
2,46,2.0,2,0.18,0,2
3,46,3.0,2,0.18,0,3
100,46,79.0,57,5.13,21,79
200,46,162.0,86,7.74,38,162
2000,46,1740.0,234,21.06,260,1740
10000,46,8812.0,387,34.83,1188,8812
20000,46,17677.0,389,35.01,2323,17677
40000,46,35568.0,393,35.37,4432,35568
60000,46,53313.0,394,35.46,6687,53313
80000,46,71065.0,394,35.46,8935,71065
100000,46,88860.0,404,36.36,11140,88860
200000,46,177772.0,598,53.82,22228,177772
400000,46,355786.0,598,53.82,44214,355786
600000,46,533928.0,616,55.44,66072,533928
800000,46,711925.0,621,55.89,88075,711925
1000000,46,889851.0,627,56.43,110149,889851
2,47,2.0,2,0.18,0,2
3,47,3.0,2,0.18,0,3
100,47,79.0,44,3.96,21,79
200,47,157.0,95,8.55,43,157
2000,47,1707.0,534,48.06,293,1707
10000,47,8821.0,638,57.42,1179,8821
20000,47,17737.0,648,58.32,2263,17737
40000,47,35545.0,667,60.03,4455,35545
60000,47,53327.0,714,64.26,6673,53327
80000,47,71167.0,766,68.94,8833,71167
100000,47,88980.0,766,68.94,11020,88980
200000,47,177756.0,975,87.75,22244,177756
400000,47,355531.0,1144,102.96,44469,355531
600000,47,533685.0,1148,103.32,66315,533685
800000,47,711668.0,1148,103.32,88332,711668
1000000,47,889632.0,1153,103.77,110368,889632
2,48,1.0,2,0.18,1,1
3,48,2.0,2,0.18,1,2
100,48,85.0,44,3.96,15,85
200,48,176.0,86,7.74,24,176
2000,48,1737.0,475,42.75,263,1737
10000,48,8841.0,757,68.13,1159,8841
20000,48,17686.0,940,84.6,2314,17686
40000,48,35447.0,1039,93.51,4553,35447
60000,48,53221.0,1057,95.13,6779,53221
80000,48,71013.0,1062,95.58,8987,71013
100000,48,88865.0,1062,95.58,11135,88865
200000,48,177828.0,1145,103.05,22172,177828
400000,48,355811.0,1156,104.04,44189,355811
600000,48,533898.0,1156,104.04,66102,533898
800000,48,711717.0,1157,104.13,88283,711717
1000000,48,889695.0,1418,127.62,110305,889695
2,49,1.0,2,0.18,1,1
3,49,1.0,2,0.18,2,1
100,49,77.0,54,4.86,23,77
200,49,164.0,96,8.64,36,164
2000,49,1721.0,582,52.38,279,1721
10000,49,8828.0,1075,96.75,1172,8828
20000,49,17728.0,1215,109.35,2272,17728
40000,49,35569.0,1336,120.24,4431,35569
60000,49,53379.0,1350,121.5,6621,53379
80000,49,71208.0,1353,121.77,8792,71208
100000,49,88949.0,1364,122.76,11051,88949
200000,49,177881.0,1384,124.56,22119,177881
400000,49,355867.0,1391,125.19,44133,355867
600000,49,533904.0,1395,125.55,66096,533904
800000,49,712179.0,1395,125.55,87821,712179
1000000,49,890296.0,1397,125.73,109704,890296
2,50,2.0,2,0.18,0,2
3,50,3.0,2,0.18,0,3
100,50,90.0,65,5.85,10,90
200,50,173.0,139,12.51,27,173
2000,50,1714.0,816,73.44,286,1714
10000,50,8821.0,1167,105.03,1179,8821
20000,50,17707.0,1214,109.26,2293,17707
40000,50,35480.0,1297,116.73,4520,35480
60000,50,53279.0,1300,117.0,6721,53279
80000,50,71088.0,1308,117.72,8912,71088
100000,50,88944.0,1310,117.9,11056,88944
200000,50,177840.0,1334,120.06,22160,177840
400000,50,355923.0,1335,120.15,44077,355923
600000,50,534023.0,1339,120.51,65977,534023
800000,50,712015.0,1339,120.51,87985,712015
1000000,50,889939.0,1341,120.69,110061,889939
2,51,1.0,2,0.18,1,1
3,51,2.0,2,0.18,1,2
100,51,82.0,56,5.04,18,82
200,51,168.0,105,9.45,32,168
2000,51,1746.0,432,38.88,254,1746
10000,51,8858.0,1060,95.4,1142,8858
20000,51,17763.0,1272,114.48,2237,17763
40000,51,35519.0,1347,121.23,4481,35519
60000,51,53273.0,1423,128.07,6727,53273
80000,51,71007.0,1452,130.68,8993,71007
100000,51,88839.0,1483,133.47,11161,88839
200000,51,177916.0,1511,135.99,22084,177916
400000,51,355721.0,1526,137.34,44279,355721
600000,51,533700.0,1534,138.06,66300,533700
800000,51,711758.0,1534,138.06,88242,711758
1000000,51,889855.0,1537,138.33,110145,889855
2,52,2.0,2,0.18,0,2
3,52,3.0,2,0.18,0,3
100,52,79.0,81,7.29,21,79
200,52,174.0,128,11.52,26,174
2000,52,1738.0,555,49.95,262,1738
10000,52,8817.0,804,72.36,1183,8817
20000,52,17721.0,839,75.51,2279,17721
40000,52,35550.0,847,76.23,4450,35550
60000,52,53443.0,852,76.68,6557,53443
80000,52,71145.0,960,86.4,8855,71145
100000,52,88920.0,1007,90.63,11080,88920
200000,52,177836.0,1033,92.97,22164,177836
400000,52,355959.0,1054,94.86,44041,355959
600000,52,534033.0,1054,94.86,65967,534033
800000,52,711720.0,1056,95.04,88280,711720
1000000,52,889396.0,1066,95.94,110604,889396
2,53,2.0,2,0.18,0,2
3,53,3.0,2,0.18,0,3
100,53,86.0,78,7.02,14,86
200,53,172.0,127,11.43,28,172
2000,53,1719.0,571,51.39,281,1719
10000,53,8768.0,966,86.94,1232,8768
20000,53,17667.0,1047,94.23,2333,17667
40000,53,35441.0,1098,98.82,4559,35441
60000,53,53261.0,1155,103.95,6739,53261
80000,53,71003.0,1163,104.67,8997,71003
100000,53,88754.0,1186,106.74,11246,88754
200000,53,177903.0,1208,108.72,22097,177903
400000,53,355664.0,1278,115.02,44336,355664
600000,53,533570.0,1282,115.38,66430,533570
800000,53,711549.0,1282,115.38,88451,711549
1000000,53,889563.0,1282,115.38,110437,889563
2,54,1.0,2,0.18,1,1
3,54,2.0,2,0.18,1,2
100,54,89.0,69,6.21,11,89
200,54,175.0,116,10.44,25,175
2000,54,1759.0,500,45.0,241,1759
10000,54,8818.0,1302,117.18,1182,8818
20000,54,17733.0,1373,123.57,2267,17733
40000,54,35518.0,1426,128.34,4482,35518
60000,54,53284.0,1457,131.13,6716,53284
80000,54,71067.0,1463,131.67,8933,71067
100000,54,88796.0,1525,137.25,11204,88796
200000,54,177811.0,1530,137.7,22189,177811
400000,54,355803.0,1618,145.62,44197,355803
600000,54,533704.0,1629,146.61,66296,533704
800000,54,711840.0,1630,146.7,88160,711840
1000000,54,889783.0,1630,146.7,110217,889783
2,55,1.0,2,0.18,1,1
3,55,2.0,2,0.18,1,2
100,55,87.0,62,5.58,13,87
200,55,174.0,100,9.0,26,174
2000,55,1721.0,624,56.16,279,1721
10000,55,8863.0,801,72.09,1137,8863
20000,55,17772.0,875,78.75,2228,17772
40000,55,35635.0,883,79.47,4365,35635
60000,55,53450.0,924,83.16,6550,53450
80000,55,71239.0,1019,91.71,8761,71239
100000,55,89029.0,1047,94.23,10971,89029
200000,55,177944.0,1250,112.5,22056,177944
400000,55,356137.0,1275,114.75,43863,356137
600000,55,533959.0,1280,115.2,66041,533959
800000,55,711894.0,1285,115.65,88106,711894
1000000,55,889973.0,1289,116.01,110027,889973
2,56,2.0,2,0.18,0,2
3,56,3.0,2,0.18,0,3
100,56,89.0,54,4.86,11,89
200,56,174.0,90,8.1,26,174
2000,56,1760.0,405,36.45,240,1760
10000,56,8849.0,688,61.92,1151,8849
20000,56,17764.0,806,72.54,2236,17764
40000,56,35613.0,837,75.33,4387,35613
60000,56,53404.0,848,76.32,6596,53404
80000,56,71233.0,850,76.5,8767,71233
100000,56,89025.0,852,76.68,10975,89025
200000,56,177946.0,890,80.1,22054,177946
400000,56,355951.0,907,81.63,44049,355951
600000,56,533891.0,907,81.63,66109,533891
800000,56,711969.0,907,81.63,88031,711969
1000000,56,889764.0,919,82.71,110236,889764
2,57,2.0,2,0.18,0,2
3,57,3.0,2,0.18,0,3
100,57,80.0,65,5.85,20,80
200,57,160.0,111,9.99,40,160
2000,57,1742.0,350,31.5,258,1742
10000,57,8818.0,609,54.81,1182,8818
20000,57,17693.0,713,64.17,2307,17693
40000,57,35504.0,714,64.26,4496,35504
60000,57,53386.0,714,64.26,6614,53386
80000,57,71183.0,719,64.71,8817,71183
100000,57,88981.0,726,65.34,11019,88981
200000,57,177933.0,730,65.7,22067,177933
400000,57,355970.0,785,70.65,44030,355970
600000,57,533817.0,788,70.92,66183,533817
800000,57,711719.0,788,70.92,88281,711719
1000000,57,889976.0,788,70.92,110024,889976
2,58,2.0,2,0.18,0,2
3,58,2.0,2,0.18,1,2
100,58,85.0,53,4.77,15,85
200,58,166.0,90,8.1,34,166
2000,58,1720.0,516,46.44,280,1720
10000,58,8752.0,1044,93.96,1248,8752
20000,58,17603.0,1138,102.42,2397,17603
40000,58,35317.0,1190,107.1,4683,35317
60000,58,53104.0,1194,107.46,6896,53104
80000,58,70890.0,1237,111.33,9110,70890
100000,58,88741.0,1237,111.33,11259,88741
200000,58,177799.0,1247,112.23,22201,177799
400000,58,355882.0,1250,112.5,44118,355882
600000,58,533882.0,1253,112.77,66118,533882
800000,58,712035.0,1255,112.95,87965,712035
1000000,58,889954.0,1258,113.22,110046,889954
2,59,1.0,2,0.18,1,1
3,59,2.0,2,0.18,1,2
100,59,75.0,52,4.68,25,75
200,59,164.0,87,7.83,36,164
2000,59,1736.0,484,43.56,264,1736
10000,59,8841.0,713,64.17,1159,8841
20000,59,17698.0,786,70.74,2302,17698
40000,59,35518.0,916,82.44,4482,35518
60000,59,53379.0,916,82.44,6621,53379
80000,59,71190.0,934,84.06,8810,71190
100000,59,88969.0,967,87.03,11031,88969
200000,59,178010.0,998,89.82,21990,178010
400000,59,355985.0,1058,95.22,44015,355985
600000,59,534073.0,1068,96.12,65927,534073
800000,59,711871.0,1179,106.11,88129,711871
1000000,59,890017.0,1179,106.11,109983,890017
2,60,1.0,2,0.18,1,1
3,60,2.0,2,0.18,1,2
100,60,81.0,64,5.76,19,81
200,60,163.0,119,10.71,37,163
2000,60,1706.0,543,48.87,294,1706
10000,60,8754.0,872,78.48,1246,8754
20000,60,17674.0,886,79.74,2326,17674
40000,60,35393.0,1000,90.0,4607,35393
60000,60,53055.0,1056,95.04,6945,53055
80000,60,70850.0,1060,95.4,9150,70850
100000,60,88704.0,1060,95.4,11296,88704
200000,60,177563.0,1140,102.6,22437,177563
400000,60,355614.0,1142,102.78,44386,355614
600000,60,533467.0,1143,102.87,66533,533467
800000,60,711637.0,1143,102.87,88363,711637
1000000,60,889753.0,1143,102.87,110247,889753
2,61,2.0,2,0.18,0,2
3,61,3.0,2,0.18,0,3
100,61,91.0,48,4.32,9,91
200,61,181.0,90,8.1,19,181
2000,61,1737.0,518,46.62,263,1737
10000,61,8829.0,1022,91.98,1171,8829
20000,61,17792.0,1054,94.86,2208,17792
40000,61,35609.0,1117,100.53,4391,35609
60000,61,53509.0,1196,107.64,6491,53509
80000,61,71336.0,1311,117.99,8664,71336
100000,61,89162.0,1392,125.28,10838,89162
200000,61,178167.0,1451,130.59,21833,178167
400000,61,355898.0,1508,135.72,44102,355898
600000,61,533615.0,1539,138.51,66385,533615
800000,61,711669.0,1539,138.51,88331,711669
1000000,61,889515.0,1564,140.76,110485,889515
2,62,1.0,2,0.18,1,1
3,62,2.0,2,0.18,1,2
100,62,87.0,54,4.86,13,87
200,62,176.0,108,9.72,24,176
2000,62,1730.0,507,45.63,270,1730
10000,62,8824.0,730,65.7,1176,8824
20000,62,17665.0,835,75.15,2335,17665
40000,62,35361.0,882,79.38,4639,35361
60000,62,53125.0,889,80.01,6875,53125
80000,62,70948.0,894,80.46,9052,70948
100000,62,88758.0,894,80.46,11242,88758
200000,62,177549.0,902,81.18,22451,177549
400000,62,355719.0,902,81.18,44281,355719
600000,62,533389.0,920,82.8,66611,533389
800000,62,711717.0,920,82.8,88283,711717
1000000,62,889737.0,920,82.8,110263,889737
2,63,1.0,2,0.18,1,1
3,63,1.0,2,0.18,2,1
100,63,80.0,59,5.31,20,80
200,63,163.0,123,11.07,37,163
2000,63,1721.0,453,40.77,279,1721
10000,63,8866.0,587,52.83,1134,8866
20000,63,17710.0,658,59.22,2290,17710
40000,63,35466.0,691,62.19,4534,35466
60000,63,53231.0,725,65.25,6769,53231
80000,63,71071.0,725,65.25,8929,71071
100000,63,88878.0,727,65.43,11122,88878
200000,63,177923.0,733,65.97,22077,177923
400000,63,355803.0,779,70.11,44197,355803
600000,63,533812.0,821,73.89,66188,533812
800000,63,711852.0,826,74.34,88148,711852
1000000,63,889855.0,826,74.34,110145,889855
2,64,2.0,2,0.18,0,2
3,64,3.0,2,0.18,0,3
100,64,87.0,66,5.94,13,87
200,64,170.0,101,9.09,30,170
2000,64,1740.0,362,32.58,260,1740
10000,64,8816.0,805,72.45,1184,8816
20000,64,17715.0,1115,100.35,2285,17715
40000,64,35471.0,1196,107.64,4529,35471
60000,64,53243.0,1201,108.09,6757,53243
80000,64,71038.0,1208,108.72,8962,71038
100000,64,88777.0,1219,109.71,11223,88777
200000,64,177792.0,1224,110.16,22208,177792
400000,64,355975.0,1307,117.63,44025,355975
600000,64,533802.0,1363,122.67,66198,533802
800000,64,711874.0,1363,122.67,88126,711874
1000000,64,890100.0,1365,122.85,109900,890100
2,65,2.0,2,0.18,0,2
3,65,3.0,2,0.18,0,3
100,65,83.0,52,4.68,17,83
200,65,168.0,78,7.02,32,168
2000,65,1743.0,560,50.4,257,1743
10000,65,8843.0,915,82.35,1157,8843
20000,65,17699.0,1254,112.86,2301,17699
40000,65,35520.0,1411,126.99,4480,35520
60000,65,53321.0,1449,130.41,6679,53321
80000,65,71053.0,1468,132.12,8947,71053
100000,65,88837.0,1472,132.48,11163,88837
200000,65,177822.0,1517,136.53,22178,177822
400000,65,355839.0,1559,140.31,44161,355839
600000,65,533832.0,1564,140.76,66168,533832
800000,65,711699.0,1576,141.84,88301,711699
1000000,65,889649.0,1576,141.84,110351,889649
2,66,0.0,2,0.18,2,0
3,66,1.0,2,0.18,2,1
100,66,77.0,72,6.48,23,77
200,66,159.0,151,13.59,41,159
2000,66,1738.0,372,33.48,262,1738
10000,66,8833.0,544,48.96,1167,8833
20000,66,17726.0,602,54.18,2274,17726
40000,66,35551.0,604,54.36,4449,35551
60000,66,53360.0,606,54.54,6640,53360
80000,66,71153.0,610,54.9,8847,71153
100000,66,88866.0,620,55.8,11134,88866
200000,66,177778.0,625,56.25,22222,177778
400000,66,355871.0,628,56.52,44129,355871
600000,66,533921.0,628,56.52,66079,533921
800000,66,711904.0,631,56.79,88096,711904
1000000,66,890009.0,631,56.79,109991,890009
2,67,1.0,2,0.18,1,1
3,67,2.0,2,0.18,1,2
100,67,86.0,62,5.58,14,86
200,67,176.0,121,10.89,24,176
2000,67,1718.0,773,69.57,282,1718
10000,67,8761.0,1405,126.45,1239,8761
20000,67,17654.0,1430,128.7,2346,17654
40000,67,35529.0,1430,128.7,4471,35529
60000,67,53323.0,1478,133.02,6677,53323
80000,67,71197.0,1483,133.47,8803,71197
100000,67,88934.0,1490,134.1,11066,88934
200000,67,177762.0,1647,148.23,22238,177762
400000,67,355735.0,1653,148.77,44265,355735
600000,67,533854.0,1653,148.77,66146,533854
800000,67,711872.0,1654,148.86,88128,711872
1000000,67,889927.0,1654,148.86,110073,889927
2,68,2.0,2,0.18,0,2
3,68,3.0,2,0.18,0,3
100,68,80.0,55,4.95,20,80
200,68,167.0,110,9.9,33,167
2000,68,1737.0,397,35.73,263,1737
10000,68,8843.0,619,55.71,1157,8843
20000,68,17671.0,832,74.88,2329,17671
40000,68,35475.0,849,76.41,4525,35475
60000,68,53353.0,849,76.41,6647,53353
80000,68,71225.0,853,76.77,8775,71225
100000,68,89069.0,855,76.95,10931,89069
200000,68,178038.0,950,85.5,21962,178038
400000,68,355994.0,995,89.55,44006,355994
600000,68,533945.0,1016,91.44,66055,533945
800000,68,711837.0,1021,91.89,88163,711837
1000000,68,889659.0,1049,94.41,110341,889659
2,69,2.0,2,0.18,0,2
3,69,3.0,2,0.18,0,3
100,69,88.0,53,4.77,12,88
200,69,177.0,109,9.81,23,177
2000,69,1717.0,649,58.41,283,1717
10000,69,8819.0,1196,107.64,1181,8819
20000,69,17717.0,1237,111.33,2283,17717
40000,69,35474.0,1270,114.3,4526,35474
60000,69,53268.0,1292,116.28,6732,53268
80000,69,71088.0,1307,117.63,8912,71088
100000,69,88825.0,1316,118.44,11175,88825
200000,69,177917.0,1321,118.89,22083,177917
400000,69,356039.0,1324,119.16,43961,356039
600000,69,534006.0,1408,126.72,65994,534006
800000,69,711785.0,1409,126.81,88215,711785
1000000,69,889924.0,1410,126.9,110076,889924
2,70,1.0,2,0.18,1,1
3,70,2.0,2,0.18,1,2
100,70,84.0,48,4.32,16,84
200,70,157.0,90,8.1,43,157
2000,70,1733.0,323,29.07,267,1733
10000,70,8833.0,709,63.81,1167,8833
20000,70,17752.0,761,68.49,2248,17752
40000,70,35549.0,780,70.2,4451,35549
60000,70,53361.0,792,71.28,6639,53361
80000,70,71236.0,801,72.09,8764,71236
100000,70,89024.0,803,72.27,10976,89024
200000,70,177922.0,902,81.18,22078,177922
400000,70,355906.0,909,81.81,44094,355906
600000,70,533959.0,910,81.9,66041,533959
800000,70,711865.0,915,82.35,88135,711865
1000000,70,889811.0,915,82.35,110189,889811
2,71,2.0,2,0.18,0,2
3,71,3.0,2,0.18,0,3
100,71,84.0,57,5.13,16,84
200,71,170.0,126,11.34,30,170
2000,71,1721.0,498,44.82,279,1721
10000,71,8832.0,912,82.08,1168,8832
20000,71,17694.0,947,85.23,2306,17694
40000,71,35589.0,948,85.32,4411,35589
60000,71,53465.0,949,85.41,6535,53465
80000,71,71197.0,966,86.94,8803,71197
100000,71,89056.0,966,86.94,10944,89056
200000,71,178148.0,1340,120.6,21852,178148
400000,71,356437.0,1433,128.97,43563,356437
600000,71,534474.0,1452,130.68,65526,534474
800000,71,712301.0,1454,130.86,87699,712301
1000000,71,889905.0,1457,131.13,110095,889905
2,72,2.0,2,0.18,0,2
3,72,3.0,2,0.18,0,3
100,72,83.0,68,6.12,17,83
200,72,160.0,125,11.25,40,160
2000,72,1734.0,481,43.29,266,1734
10000,72,8791.0,716,64.44,1209,8791
20000,72,17647.0,748,67.32,2353,17647
40000,72,35361.0,758,68.22,4639,35361
60000,72,53144.0,763,68.67,6856,53144
80000,72,70913.0,784,70.56,9087,70913
100000,72,88757.0,784,70.56,11243,88757
200000,72,177672.0,785,70.65,22328,177672
400000,72,355650.0,786,70.74,44350,355650
600000,72,533548.0,786,70.74,66452,533548
800000,72,711373.0,790,71.1,88627,711373
1000000,72,889219.0,790,71.1,110781,889219
2,73,2.0,2,0.18,0,2
3,73,2.0,2,0.18,1,2
100,73,81.0,55,4.95,19,81
200,73,167.0,90,8.1,33,167
2000,73,1714.0,653,58.77,286,1714
10000,73,8775.0,1059,95.31,1225,8775
20000,73,17712.0,1101,99.09,2288,17712
40000,73,35517.0,1119,100.71,4483,35517
60000,73,53293.0,1177,105.93,6707,53293
80000,73,71026.0,1207,108.63,8974,71026
100000,73,88812.0,1209,108.81,11188,88812
200000,73,177840.0,1457,131.13,22160,177840
400000,73,355767.0,1470,132.3,44233,355767
600000,73,533600.0,1480,133.2,66400,533600
800000,73,711483.0,1484,133.56,88517,711483
1000000,73,889463.0,1484,133.56,110537,889463
2,74,2.0,2,0.18,0,2
3,74,3.0,2,0.18,0,3
100,74,89.0,54,4.86,11,89
200,74,170.0,105,9.45,30,170
2000,74,1750.0,491,44.19,250,1750
10000,74,8766.0,893,80.37,1234,8766
20000,74,17667.0,968,87.12,2333,17667
40000,74,35418.0,1048,94.32,4582,35418
60000,74,53241.0,1073,96.57,6759,53241
80000,74,71008.0,1086,97.74,8992,71008
100000,74,88745.0,1094,98.46,11255,88745
200000,74,177694.0,1137,102.33,22306,177694
400000,74,355679.0,1142,102.78,44321,355679
600000,74,533709.0,1145,103.05,66291,533709
800000,74,711682.0,1145,103.05,88318,711682
1000000,74,889834.0,1145,103.05,110166,889834
2,75,2.0,2,0.18,0,2
3,75,2.0,2,0.18,1,2
100,75,83.0,58,5.22,17,83
200,75,172.0,103,9.27,28,172
2000,75,1742.0,450,40.5,258,1742
10000,75,8789.0,833,74.97,1211,8789
20000,75,17664.0,904,81.36,2336,17664
40000,75,35427.0,920,82.8,4573,35427
60000,75,53145.0,926,83.34,6855,53145
80000,75,70964.0,926,83.34,9036,70964
100000,75,88750.0,929,83.61,11250,88750
200000,75,177677.0,957,86.13,22323,177677
400000,75,355729.0,968,87.12,44271,355729
600000,75,533548.0,972,87.48,66452,533548
800000,75,711636.0,972,87.48,88364,711636
1000000,75,889747.0,972,87.48,110253,889747
2,76,1.0,2,0.18,1,1
3,76,2.0,2,0.18,1,2
100,76,85.0,62,5.58,15,85
200,76,166.0,132,11.88,34,166
2000,76,1727.0,794,71.46,273,1727
10000,76,8777.0,1239,111.51,1223,8777
20000,76,17699.0,1299,116.91,2301,17699
40000,76,35517.0,1383,124.47,4483,35517
60000,76,53371.0,1419,127.71,6629,53371
80000,76,71118.0,1534,138.06,8882,71118
100000,76,88912.0,1545,139.05,11088,88912
200000,76,177992.0,1561,140.49,22008,177992
400000,76,355981.0,1638,147.42,44019,355981
600000,76,533962.0,1642,147.78,66038,533962
800000,76,711969.0,1653,148.77,88031,711969
1000000,76,890120.0,1653,148.77,109880,890120
2,77,2.0,2,0.18,0,2
3,77,3.0,2,0.18,0,3
100,77,83.0,50,4.5,17,83
200,77,170.0,87,7.83,30,170
2000,77,1750.0,581,52.29,250,1750
10000,77,8835.0,1103,99.27,1165,8835
20000,77,17696.0,1180,106.2,2304,17696
40000,77,35469.0,1195,107.55,4531,35469
60000,77,53330.0,1195,107.55,6670,53330
80000,77,71177.0,1211,108.99,8823,71177
100000,77,88939.0,1250,112.5,11061,88939
200000,77,177933.0,1283,115.47,22067,177933
400000,77,355922.0,1289,116.01,44078,355922
600000,77,533869.0,1292,116.28,66131,533869
800000,77,711779.0,1293,116.37,88221,711779
1000000,77,889906.0,1293,116.37,110094,889906
2,78,1.0,2,0.18,1,1
3,78,2.0,2,0.18,1,2
100,78,80.0,66,5.94,20,80
200,78,158.0,129,11.61,42,158
2000,78,1722.0,569,51.21,278,1722
10000,78,8866.0,758,68.22,1134,8866
20000,78,17825.0,938,84.42,2175,17825
40000,78,35703.0,1017,91.53,4297,35703
60000,78,53508.0,1038,93.42,6492,53508
80000,78,71318.0,1095,98.55,8682,71318
100000,78,89209.0,1113,100.17,10791,89209
200000,78,178238.0,1178,106.02,21762,178238
400000,78,356376.0,1185,106.65,43624,356376
600000,78,534033.0,1237,111.33,65967,534033
800000,78,712297.0,1237,111.33,87703,712297
1000000,78,890375.0,1247,112.23,109625,890375
2,79,2.0,2,0.18,0,2
3,79,3.0,2,0.18,0,3
100,79,79.0,56,5.04,21,79
200,79,161.0,88,7.92,39,161
2000,79,1737.0,383,34.47,263,1737
10000,79,8848.0,552,49.68,1152,8848
20000,79,17735.0,612,55.08,2265,17735
40000,79,35484.0,728,65.52,4516,35484
60000,79,53164.0,789,71.01,6836,53164
80000,79,71034.0,789,71.01,8966,71034
100000,79,88774.0,898,80.82,11226,88774
200000,79,177886.0,922,82.98,22114,177886
400000,79,355633.0,941,84.69,44367,355633
600000,79,533696.0,958,86.22,66304,533696
800000,79,711822.0,958,86.22,88178,711822
1000000,79,889917.0,960,86.4,110083,889917
2,80,1.0,2,0.18,1,1
3,80,2.0,2,0.18,1,2
100,80,85.0,58,5.22,15,85
200,80,173.0,129,11.61,27,173
2000,80,1748.0,499,44.91,252,1748
10000,80,8864.0,765,68.85,1136,8864
20000,80,17809.0,808,72.72,2191,17809
40000,80,35485.0,915,82.35,4515,35485
60000,80,53370.0,915,82.35,6630,53370
80000,80,71188.0,929,83.61,8812,71188
100000,80,88981.0,945,85.05,11019,88981
200000,80,177990.0,967,87.03,22010,177990
400000,80,356045.0,1028,92.52,43955,356045
600000,80,534171.0,1036,93.24,65829,534171
800000,80,712093.0,1073,96.57,87907,712093
1000000,80,890225.0,1074,96.66,109775,890225
2,81,2.0,2,0.18,0,2
3,81,3.0,2,0.18,0,3
100,81,82.0,45,4.05,18,82
200,81,168.0,65,5.85,32,168
2000,81,1741.0,470,42.3,259,1741
10000,81,8811.0,1097,98.73,1189,8811
20000,81,17686.0,1133,101.97,2314,17686
40000,81,35526.0,1412,127.08,4474,35526
60000,81,53262.0,1467,132.03,6738,53262
80000,81,71097.0,1480,133.2,8903,71097
100000,81,88887.0,1488,133.92,11113,88887
200000,81,177771.0,1533,137.97,22229,177771
400000,81,355722.0,1537,138.33,44278,355722
600000,81,533696.0,1538,138.42,66304,533696
800000,81,711610.0,1538,138.42,88390,711610
1000000,81,889398.0,1546,139.14,110602,889398
2,82,1.0,2,0.18,1,1
3,82,2.0,2,0.18,1,2
100,82,78.0,55,4.95,22,78
200,82,170.0,75,6.75,30,170
2000,82,1746.0,456,41.04,254,1746
10000,82,8834.0,580,52.2,1166,8834
20000,82,17666.0,924,83.16,2334,17666
40000,82,35549.0,924,83.16,4451,35549
60000,82,53343.0,958,86.22,6657,53343
80000,82,71196.0,965,86.85,8804,71196
100000,82,88985.0,974,87.66,11015,88985
200000,82,178091.0,1000,90.0,21909,178091
400000,82,355944.0,1014,91.26,44056,355944
600000,82,533949.0,1022,91.98,66051,533949
800000,82,712176.0,1022,91.98,87824,712176
1000000,82,890026.0,1022,91.98,109974,890026
2,83,2.0,2,0.18,0,2
3,83,3.0,2,0.18,0,3
100,83,85.0,71,6.39,15,85
200,83,171.0,125,11.25,29,171
2000,83,1719.0,554,49.86,281,1719
10000,83,8829.0,977,87.93,1171,8829
20000,83,17743.0,1027,92.43,2257,17743
40000,83,35534.0,1082,97.38,4466,35534
60000,83,53339.0,1107,99.63,6661,53339
80000,83,71135.0,1112,100.08,8865,71135
100000,83,88904.0,1121,100.89,11096,88904
200000,83,177756.0,1134,102.06,22244,177756
400000,83,355856.0,1140,102.6,44144,355856
600000,83,533946.0,1140,102.6,66054,533946
800000,83,712022.0,1151,103.59,87978,712022
1000000,83,890021.0,1161,104.49,109979,890021
2,84,2.0,2,0.18,0,2
3,84,3.0,2,0.18,0,3
100,84,90.0,57,5.13,10,90
200,84,172.0,119,10.71,28,172
2000,84,1699.0,544,48.96,301,1699
10000,84,8838.0,786,70.74,1162,8838
20000,84,17737.0,828,74.52,2263,17737
40000,84,35578.0,906,81.54,4422,35578
60000,84,53380.0,933,83.97,6620,53380
80000,84,71165.0,949,85.41,8835,71165
100000,84,88930.0,952,85.68,11070,88930
200000,84,177996.0,954,85.86,22004,177996
400000,84,356157.0,955,85.95,43843,356157
600000,84,534050.0,958,86.22,65950,534050
800000,84,711782.0,960,86.4,88218,711782
1000000,84,889843.0,960,86.4,110157,889843
2,85,2.0,2,0.18,0,2
3,85,3.0,2,0.18,0,3
100,85,85.0,57,5.13,15,85
200,85,172.0,106,9.54,28,172
2000,85,1727.0,339,30.51,273,1727
10000,85,8814.0,419,37.71,1186,8814
20000,85,17741.0,421,37.89,2259,17741
40000,85,35558.0,421,37.89,4442,35558
60000,85,53396.0,448,40.32,6604,53396
80000,85,71156.0,451,40.59,8844,71156
100000,85,88984.0,452,40.68,11016,88984
200000,85,178032.0,455,40.95,21968,178032
400000,85,355886.0,476,42.84,44114,355886
600000,85,533934.0,476,42.84,66066,533934
800000,85,712040.0,476,42.84,87960,712040
1000000,85,889945.0,476,42.84,110055,889945
2,86,2.0,2,0.18,0,2
3,86,3.0,2,0.18,0,3
100,86,85.0,51,4.59,15,85
200,86,172.0,79,7.11,28,172
2000,86,1725.0,596,53.64,275,1725
10000,86,8808.0,1032,92.88,1192,8808
20000,86,17700.0,1166,104.94,2300,17700
40000,86,35537.0,1176,105.84,4463,35537
60000,86,53315.0,1206,108.54,6685,53315
80000,86,71133.0,1238,111.42,8867,71133
100000,86,88927.0,1268,114.12,11073,88927
200000,86,177905.0,1322,118.98,22095,177905
400000,86,355689.0,1392,125.28,44311,355689
600000,86,533383.0,1397,125.73,66617,533383
800000,86,711500.0,1397,125.73,88500,711500
1000000,86,889538.0,1397,125.73,110462,889538
2,87,2.0,2,0.18,0,2
3,87,3.0,2,0.18,0,3
100,87,83.0,58,5.22,17,83
200,87,164.0,105,9.45,36,164
2000,87,1743.0,393,35.37,257,1743
10000,87,8851.0,544,48.96,1149,8851
20000,87,17776.0,693,62.37,2224,17776
40000,87,35560.0,724,65.16,4440,35560
60000,87,53321.0,904,81.36,6679,53321
80000,87,71089.0,908,81.72,8911,71089
100000,87,88899.0,932,83.88,11101,88899
200000,87,177800.0,952,85.68,22200,177800
400000,87,356037.0,952,85.68,43963,356037
600000,87,534053.0,1169,105.21,65947,534053
800000,87,711970.0,1171,105.39,88030,711970
1000000,87,890236.0,1171,105.39,109764,890236
2,88,1.0,2,0.18,1,1
3,88,2.0,2,0.18,1,2
100,88,87.0,65,5.85,13,87
200,88,169.0,100,9.0,31,169
2000,88,1759.0,348,31.32,241,1759
10000,88,8855.0,655,58.95,1145,8855
20000,88,17750.0,769,69.21,2250,17750
40000,88,35534.0,818,73.62,4466,35534
60000,88,53334.0,823,74.07,6666,53334
80000,88,71096.0,832,74.88,8904,71096
100000,88,88957.0,834,75.06,11043,88957
200000,88,177808.0,852,76.68,22192,177808
400000,88,355724.0,856,77.04,44276,355724
600000,88,533721.0,856,77.04,66279,533721
800000,88,711842.0,857,77.13,88158,711842
1000000,88,890021.0,857,77.13,109979,890021
2,89,2.0,2,0.18,0,2
3,89,3.0,2,0.18,0,3
100,89,79.0,63,5.67,21,79
200,89,162.0,116,10.44,38,162
2000,89,1728.0,585,52.65,272,1728
10000,89,8811.0,1014,91.26,1189,8811
20000,89,17696.0,1286,115.74,2304,17696
40000,89,35447.0,1338,120.42,4553,35447
60000,89,53275.0,1364,122.76,6725,53275
80000,89,71063.0,1367,123.03,8937,71063
100000,89,88832.0,1371,123.39,11168,88832
200000,89,177650.0,1383,124.47,22350,177650
400000,89,355684.0,1413,127.17,44316,355684
600000,89,533809.0,1417,127.53,66191,533809
800000,89,711906.0,1417,127.53,88094,711906
1000000,89,889726.0,1428,128.52,110274,889726
2,90,2.0,2,0.18,0,2
3,90,3.0,2,0.18,0,3
100,90,88.0,54,4.86,12,88
200,90,171.0,111,9.99,29,171
2000,90,1749.0,486,43.74,251,1749
10000,90,8815.0,922,82.98,1185,8815
20000,90,17710.0,985,88.65,2290,17710
40000,90,35500.0,1099,98.91,4500,35500
60000,90,53244.0,1152,103.68,6756,53244
80000,90,70911.0,1248,112.32,9089,70911
100000,90,88718.0,1248,112.32,11282,88718
200000,90,177932.0,1249,112.41,22068,177932
400000,90,355842.0,1253,112.77,44158,355842
600000,90,533700.0,1314,118.26,66300,533700
800000,90,711789.0,1319,118.71,88211,711789
1000000,90,889850.0,1481,133.29,110150,889850
2,91,1.0,2,0.18,1,1
3,91,2.0,2,0.18,1,2
100,91,79.0,70,6.3,21,79
200,91,166.0,107,9.63,34,166
2000,91,1749.0,428,38.52,251,1749
10000,91,8789.0,648,58.32,1211,8789
20000,91,17609.0,688,61.92,2391,17609
40000,91,35408.0,688,61.92,4592,35408
60000,91,53169.0,697,62.73,6831,53169
80000,91,71035.0,697,62.73,8965,71035
100000,91,88860.0,697,62.73,11140,88860
200000,91,178102.0,698,62.82,21898,178102
400000,91,355977.0,723,65.07,44023,355977
600000,91,534055.0,728,65.52,65945,534055
800000,91,712080.0,854,76.86,87920,712080
1000000,91,889997.0,854,76.86,110003,889997
2,92,2.0,2,0.18,0,2
3,92,3.0,2,0.18,0,3
100,92,83.0,60,5.4,17,83
200,92,175.0,121,10.89,25,175
2000,92,1734.0,629,56.61,266,1734
10000,92,8810.0,973,87.57,1190,8810
20000,92,17721.0,996,89.64,2279,17721
40000,92,35486.0,1123,101.07,4514,35486
60000,92,53343.0,1140,102.6,6657,53343
80000,92,71113.0,1236,111.24,8887,71113
100000,92,88804.0,1243,111.87,11196,88804
200000,92,177935.0,1247,112.23,22065,177935
400000,92,356112.0,1298,116.82,43888,356112
600000,92,534450.0,1298,116.82,65550,534450
800000,92,712601.0,1301,117.09,87399,712601
1000000,92,890661.0,1301,117.09,109339,890661
2,93,2.0,2,0.18,0,2
3,93,3.0,2,0.18,0,3
100,93,83.0,75,6.75,17,83
200,93,170.0,136,12.24,30,170
2000,93,1726.0,592,53.28,274,1726
10000,93,8816.0,832,74.88,1184,8816
20000,93,17743.0,875,78.75,2257,17743
40000,93,35621.0,886,79.74,4379,35621
60000,93,53422.0,911,81.99,6578,53422
80000,93,71231.0,963,86.67,8769,71231
100000,93,89008.0,1007,90.63,10992,89008
200000,93,178154.0,1026,92.34,21846,178154
400000,93,356300.0,1096,98.64,43700,356300
600000,93,534234.0,1111,99.99,65766,534234
800000,93,712209.0,1111,99.99,87791,712209
1000000,93,890036.0,1132,101.88,109964,890036
2,94,1.0,2,0.18,1,1
3,94,2.0,2,0.18,1,2
100,94,89.0,51,4.59,11,89
200,94,173.0,96,8.64,27,173
2000,94,1770.0,489,44.01,230,1770
10000,94,8886.0,802,72.18,1114,8886
20000,94,17740.0,1015,91.35,2260,17740
40000,94,35514.0,1053,94.77,4486,35514
60000,94,53273.0,1097,98.73,6727,53273
80000,94,71039.0,1105,99.45,8961,71039
100000,94,88775.0,1129,101.61,11225,88775
200000,94,177894.0,1140,102.6,22106,177894
400000,94,355797.0,1159,104.31,44203,355797
600000,94,533701.0,1177,105.93,66299,533701
800000,94,711942.0,1178,106.02,88058,711942
1000000,94,889897.0,1183,106.47,110103,889897
2,95,1.0,2,0.18,1,1
3,95,2.0,2,0.18,1,2
100,95,86.0,61,5.49,14,86
200,95,173.0,113,10.17,27,173
2000,95,1746.0,575,51.75,254,1746
10000,95,8837.0,1242,111.78,1163,8837
20000,95,17714.0,1382,124.38,2286,17714
40000,95,35458.0,1448,130.32,4542,35458
60000,95,53263.0,1564,140.76,6737,53263
80000,95,71092.0,1565,140.85,8908,71092
100000,95,88903.0,1621,145.89,11097,88903
200000,95,177996.0,1629,146.61,22004,177996
400000,95,355854.0,1656,149.04,44146,355854
600000,95,533943.0,1656,149.04,66057,533943
800000,95,711952.0,1742,156.78,88048,711952
1000000,95,889982.0,1742,156.78,110018,889982
2,96,2.0,2,0.18,0,2
3,96,3.0,2,0.18,0,3
100,96,84.0,62,5.58,16,84
200,96,166.0,120,10.8,34,166
2000,96,1763.0,390,35.1,237,1763
10000,96,8900.0,679,61.11,1100,8900
20000,96,17810.0,759,68.31,2190,17810
40000,96,35638.0,790,71.1,4362,35638
60000,96,53375.0,817,73.53,6625,53375
80000,96,71116.0,870,78.3,8884,71116
100000,96,88878.0,1185,106.65,11122,88878
200000,96,177739.0,1218,109.62,22261,177739
400000,96,355576.0,1235,111.15,44424,355576
600000,96,533527.0,1235,111.15,66473,533527
800000,96,711572.0,1235,111.15,88428,711572
1000000,96,889624.0,1235,111.15,110376,889624
2,97,2.0,2,0.18,0,2
3,97,3.0,2,0.18,0,3
100,97,74.0,68,6.12,26,74
200,97,159.0,91,8.19,41,159
2000,97,1719.0,520,46.8,281,1719
10000,97,8791.0,793,71.37,1209,8791
20000,97,17743.0,794,71.46,2257,17743
40000,97,35622.0,800,72.0,4378,35622
60000,97,53439.0,858,77.22,6561,53439
80000,97,71261.0,1119,100.71,8739,71261
100000,97,89033.0,1140,102.6,10967,89033
200000,97,177886.0,1229,110.61,22114,177886
400000,97,355894.0,1237,111.33,44106,355894
600000,97,533905.0,1243,111.87,66095,533905
800000,97,711973.0,1248,112.32,88027,711973
1000000,97,889925.0,1253,112.77,110075,889925
2,98,2.0,2,0.18,0,2
3,98,3.0,2,0.18,0,3
100,98,88.0,49,4.41,12,88
200,98,167.0,98,8.82,33,167
2000,98,1722.0,461,41.49,278,1722
10000,98,8825.0,889,80.01,1175,8825
20000,98,17686.0,949,85.41,2314,17686
40000,98,35534.0,1048,94.32,4466,35534
60000,98,53294.0,1138,102.42,6706,53294
80000,98,71150.0,1140,102.6,8850,71150
100000,98,88980.0,1140,102.6,11020,88980
200000,98,178010.0,1171,105.39,21990,178010
400000,98,356090.0,1189,107.01,43910,356090
600000,98,533985.0,1192,107.28,66015,533985
800000,98,712022.0,1306,117.54,87978,712022
1000000,98,890067.0,1314,118.26,109933,890067
2,99,2.0,2,0.18,0,2
3,99,3.0,2,0.18,0,3
100,99,86.0,63,5.67,14,86
200,99,167.0,106,9.54,33,167
2000,99,1724.0,379,34.11,276,1724
10000,99,8820.0,913,82.17,1180,8820
20000,99,17688.0,961,86.49,2312,17688
40000,99,35536.0,966,86.94,4464,35536
60000,99,53353.0,1316,118.44,6647,53353
80000,99,71170.0,1380,124.2,8830,71170
100000,99,88982.0,1383,124.47,11018,88982
200000,99,178028.0,1411,126.99,21972,178028
400000,99,356180.0,1605,144.45,43820,356180
600000,99,534117.0,1614,145.26,65883,534117
800000,99,712145.0,1617,145.53,87855,712145
1000000,99,889834.0,1642,147.78,110166,889834
2,100,1.0,2,0.18,1,1
3,100,2.0,2,0.18,1,2
100,100,82.0,63,5.67,18,82
200,100,169.0,101,9.09,31,169
2000,100,1731.0,459,41.31,269,1731
10000,100,8829.0,721,64.89,1171,8829
20000,100,17701.0,738,66.42,2299,17701
40000,100,35548.0,741,66.69,4452,35548
60000,100,53336.0,763,68.67,6664,53336
80000,100,71117.0,806,72.54,8883,71117
100000,100,88894.0,823,74.07,11106,88894
200000,100,177798.0,864,77.76,22202,177798
400000,100,355914.0,865,77.85,44086,355914
600000,100,533910.0,868,78.12,66090,533910
800000,100,711966.0,868,78.12,88034,711966
1000000,100,889845.0,939,84.51,110155,889845
