Timestep,Iteration,Total Reward,Suboptimal Arms,Total Regret,Zeros Count,Ones Count
2,1,2.0,1,0.01,0,2
3,1,3.0,2,0.02,0,3
100,1,86.0,66,0.5,14,86
200,1,178.0,133,1.0,22,178
2000,1,1788.0,278,2.13,212,1788
10000,1,9012.0,278,2.13,988,9012
20000,1,18075.0,278,2.13,1925,18075
40000,1,36128.0,278,2.13,3872,36128
60000,1,54170.0,278,2.13,5830,54170
80000,1,72121.0,278,2.13,7879,72121
100000,1,90139.0,278,2.13,9861,90139
200000,1,180151.0,278,2.13,19849,180151
400000,1,360245.0,278,2.13,39755,360245
600000,1,540376.0,278,2.13,59624,540376
800000,1,720155.0,278,2.13,79845,720155
1000000,1,900233.0,278,2.13,99767,900233
2,2,2.0,1,0.01,0,2
3,2,3.0,2,0.02,0,3
100,2,87.0,66,0.5,13,87
200,2,174.0,133,1.0,26,174
2000,2,1758.0,1899,18.42,242,1758
10000,2,8881.0,9899,98.41,1119,8881
20000,2,17753.0,19899,198.41,2247,17753
40000,2,35585.0,39899,398.41,4415,35585
60000,2,53414.0,59899,598.41,6586,53414
80000,2,71190.0,79899,798.41,8810,71190
100000,2,89020.0,99899,998.41,10980,89020
200000,2,178072.0,199899,1998.41,21928,178072
400000,2,356192.0,399899,3998.41,43808,356192
600000,2,534173.0,599899,5998.41,65827,534173
800000,2,712281.0,799899,7998.41,87719,712281
1000000,2,890223.0,999899,9998.41,109777,890223
2,3,1.0,1,0.01,1,1
3,3,2.0,2,0.02,1,2
100,3,81.0,66,0.5,19,81
200,3,169.0,133,1.0,31,169
2000,3,1804.0,200,1.5,196,1804
10000,3,9017.0,200,1.5,983,9017
20000,3,18031.0,200,1.5,1969,18031
40000,3,36098.0,200,1.5,3902,36098
60000,3,54169.0,200,1.5,5831,54169
80000,3,72255.0,200,1.5,7745,72255
100000,3,90216.0,200,1.5,9784,90216
200000,3,180106.0,200,1.5,19894,180106
400000,3,360337.0,200,1.5,39663,360337
600000,3,540282.0,200,1.5,59718,540282
800000,3,720229.0,200,1.5,79771,720229
1000000,3,900492.0,200,1.5,99508,900492
2,4,2.0,1,0.01,0,2
3,4,3.0,2,0.02,0,3
100,4,90.0,66,0.5,10,90
200,4,182.0,133,1.0,18,182
2000,4,1807.0,298,2.48,193,1807
10000,4,9007.0,298,2.48,993,9007
20000,4,18025.0,298,2.48,1975,18025
40000,4,36076.0,298,2.48,3924,36076
60000,4,54059.0,298,2.48,5941,54059
80000,4,71966.0,298,2.48,8034,71966
100000,4,89999.0,298,2.48,10001,89999
200000,4,179921.0,298,2.48,20079,179921
400000,4,360002.0,298,2.48,39998,360002
600000,4,539761.0,298,2.48,60239,539761
800000,4,719797.0,298,2.48,80203,719797
1000000,4,899740.0,298,2.48,100260,899740
2,5,2.0,1,0.01,0,2
3,5,3.0,2,0.02,0,3
100,5,90.0,66,0.5,10,90
200,5,184.0,133,1.0,16,184
2000,5,1794.0,272,2.22,206,1794
10000,5,9040.0,272,2.22,960,9040
20000,5,18080.0,272,2.22,1920,18080
40000,5,36019.0,272,2.22,3981,36019
60000,5,53964.0,272,2.22,6036,53964
80000,5,72019.0,272,2.22,7981,72019
100000,5,90030.0,272,2.22,9970,90030
200000,5,180078.0,272,2.22,19922,180078
400000,5,359989.0,272,2.22,40011,359989
600000,5,540023.0,272,2.22,59977,540023
800000,5,719751.0,272,2.22,80249,719751
1000000,5,899747.0,272,2.22,100253,899747
2,6,2.0,1,0.01,0,2
3,6,3.0,2,0.02,0,3
100,6,91.0,66,0.5,9,91
200,6,179.0,133,1.0,21,179
2000,6,1768.0,1900,17.83,232,1768
10000,6,8906.0,9900,97.83,1094,8906
20000,6,17785.0,19900,197.83,2215,17785
40000,6,35533.0,39900,397.83,4467,35533
60000,6,53364.0,59900,597.83,6636,53364
80000,6,71254.0,79900,797.83,8746,71254
100000,6,89083.0,99900,997.83,10917,89083
200000,6,178182.0,199900,1997.83,21818,178182
400000,6,356231.0,399900,3997.83,43769,356231
600000,6,534277.0,599900,5997.83,65723,534277
800000,6,712030.0,799900,7997.83,87970,712030
1000000,6,889982.0,999900,9997.83,110018,889982
2,7,1.0,1,0.01,1,1
3,7,2.0,2,0.02,1,2
100,7,84.0,66,0.5,16,84
200,7,166.0,133,1.0,34,166
2000,7,1771.0,210,1.6,229,1771
10000,7,8988.0,210,1.6,1012,8988
20000,7,18062.0,210,1.6,1938,18062
40000,7,36030.0,210,1.6,3970,36030
60000,7,54105.0,210,1.6,5895,54105
80000,7,72035.0,210,1.6,7965,72035
100000,7,90076.0,210,1.6,9924,90076
200000,7,180271.0,210,1.6,19729,180271
400000,7,360433.0,210,1.6,39567,360433
600000,7,540348.0,210,1.6,59652,540348
800000,7,720321.0,210,1.6,79679,720321
1000000,7,900289.0,210,1.6,99711,900289
2,8,2.0,1,0.01,0,2
3,8,3.0,2,0.02,0,3
100,8,92.0,66,0.5,8,92
200,8,180.0,133,1.0,20,180
2000,8,1785.0,1873,10.06,215,1785
10000,8,8934.0,9873,50.06,1066,8934
20000,8,17861.0,19873,100.05,2139,17861
40000,8,35774.0,39873,200.05,4226,35774
60000,8,53717.0,59873,300.05,6283,53717
80000,8,71599.0,79873,400.05,8401,71599
100000,8,89537.0,99873,500.05,10463,89537
200000,8,179107.0,199873,1000.05,20893,179107
400000,8,358214.0,399873,2000.06,41786,358214
600000,8,537189.0,599873,3000.06,62811,537189
800000,8,716090.0,799873,4000.06,83910,716090
1000000,8,895105.0,999873,5000.06,104895,895105
2,9,2.0,1,0.01,0,2
3,9,3.0,2,0.02,0,3
100,9,90.0,66,0.5,10,90
200,9,181.0,133,1.0,19,181
2000,9,1787.0,1790,17.29,213,1787
10000,9,8906.0,9790,97.29,1094,8906
20000,9,17844.0,19790,197.29,2156,17844
40000,9,35686.0,39790,397.29,4314,35686
60000,9,53492.0,59790,597.29,6508,53492
80000,9,71236.0,79790,797.29,8764,71236
100000,9,89070.0,99790,997.29,10930,89070
200000,9,178075.0,199790,1997.29,21925,178075
400000,9,356359.0,399790,3997.29,43641,356359
600000,9,534104.0,599790,5997.29,65896,534104
800000,9,712343.0,799790,7997.29,87657,712343
1000000,9,890619.0,999790,9997.29,109381,890619
2,10,1.0,1,0.01,1,1
3,10,1.0,2,0.02,2,1
100,10,88.0,66,0.5,12,88
200,10,173.0,133,1.0,27,173
2000,10,1786.0,200,1.5,214,1786
10000,10,8929.0,200,1.5,1071,8929
20000,10,17908.0,200,1.5,2092,17908
40000,10,35964.0,200,1.5,4036,35964
60000,10,53935.0,200,1.5,6065,53935
80000,10,71897.0,200,1.5,8103,71897
100000,10,89908.0,200,1.5,10092,89908
200000,10,179879.0,200,1.5,20121,179879
400000,10,359782.0,200,1.5,40218,359782
600000,10,540001.0,200,1.5,59999,540001
800000,10,720130.0,200,1.5,79870,720130
1000000,10,900092.0,200,1.5,99908,900092
2,11,2.0,1,0.01,0,2
3,11,3.0,2,0.02,0,3
100,11,87.0,66,0.5,13,87
200,11,176.0,133,1.0,24,176
2000,11,1770.0,1855,18.05,230,1770
10000,11,8904.0,2959,29.09,1096,8904
20000,11,17885.0,2959,29.09,2115,17885
40000,11,35903.0,2959,29.09,4097,35903
60000,11,53901.0,2959,29.09,6099,53901
80000,11,71970.0,2959,29.09,8030,71970
100000,11,89975.0,2959,29.09,10025,89975
200000,11,179878.0,2959,29.09,20122,179878
400000,11,360091.0,2959,29.09,39909,360091
600000,11,540219.0,2959,29.09,59781,540219
800000,11,720158.0,2959,29.09,79842,720158
1000000,11,900025.0,2959,29.09,99975,900025
2,12,2.0,1,0.01,0,2
3,12,3.0,2,0.02,0,3
100,12,84.0,66,0.5,16,84
200,12,175.0,133,1.0,25,175
2000,12,1766.0,200,1.5,234,1766
10000,12,8935.0,200,1.5,1065,8935
20000,12,17934.0,200,1.5,2066,17934
40000,12,35948.0,200,1.5,4052,35948
60000,12,53932.0,200,1.5,6068,53932
80000,12,71960.0,200,1.5,8040,71960
100000,12,89966.0,200,1.5,10034,89966
200000,12,180103.0,200,1.5,19897,180103
400000,12,360091.0,200,1.5,39909,360091
600000,12,540050.0,200,1.5,59950,540050
800000,12,720306.0,200,1.5,79694,720306
1000000,12,900219.0,200,1.5,99781,900219
2,13,2.0,1,0.01,0,2
3,13,3.0,2,0.02,0,3
100,13,92.0,66,0.5,8,92
200,13,178.0,133,1.0,22,178
2000,13,1766.0,1900,10.0,234,1766
10000,13,8893.0,9900,50.0,1107,8893
20000,13,17856.0,19900,100.0,2144,17856
40000,13,35872.0,39900,200.0,4128,35872
60000,13,53747.0,59900,300.0,6253,53747
80000,13,71559.0,79900,400.0,8441,71559
100000,13,89447.0,99900,500.0,10553,89447
200000,13,178921.0,199900,1000.0,21079,178921
400000,13,357959.0,399900,2000.0,42041,357959
600000,13,536946.0,599900,3000.0,63054,536946
800000,13,715825.0,799900,4000.0,84175,715825
1000000,13,895018.0,999900,5000.0,104982,895018
2,14,1.0,1,0.01,1,1
3,14,1.0,2,0.02,2,1
100,14,85.0,66,0.5,15,85
200,14,173.0,133,1.0,27,173
2000,14,1766.0,1845,9.73,234,1766
10000,14,8969.0,9845,49.73,1031,8969
20000,14,18000.0,19845,99.72,2000,18000
40000,14,35907.0,39845,199.72,4093,35907
60000,14,53793.0,59845,299.72,6207,53793
80000,14,71718.0,79845,399.72,8282,71718
100000,14,89565.0,99845,499.72,10435,89565
200000,14,179077.0,199845,999.72,20923,179077
400000,14,358211.0,399845,1999.73,41789,358211
600000,14,537300.0,599845,2999.73,62700,537300
800000,14,716385.0,799845,3999.73,83615,716385
1000000,14,895481.0,999845,4999.73,104519,895481
2,15,2.0,1,0.01,0,2
3,15,3.0,2,0.02,0,3
100,15,92.0,66,0.5,8,92
200,15,183.0,133,1.0,17,183
2000,15,1786.0,1789,9.45,214,1786
10000,15,9047.0,9789,49.45,953,9047
20000,15,18007.0,19789,99.44,1993,18007
40000,15,35894.0,39789,199.44,4106,35894
60000,15,53711.0,59789,299.44,6289,53711
80000,15,71601.0,79789,399.44,8399,71601
100000,15,89483.0,99789,499.44,10517,89483
200000,15,178902.0,199789,999.44,21098,178902
400000,15,358005.0,399789,1999.45,41995,358005
600000,15,537256.0,599789,2999.45,62744,537256
800000,15,716255.0,799789,3999.45,83745,716255
1000000,15,894997.0,999789,4999.45,105003,894997
2,16,0.0,1,0.01,2,0
3,16,1.0,2,0.02,2,1
100,16,91.0,66,0.5,9,91
200,16,180.0,133,1.0,20,180
2000,16,1787.0,1900,10.0,213,1787
10000,16,8972.0,9900,50.0,1028,8972
20000,16,17949.0,19900,100.0,2051,17949
40000,16,35904.0,39900,200.0,4096,35904
60000,16,53827.0,59900,300.0,6173,53827
80000,16,71715.0,79900,400.0,8285,71715
100000,16,89575.0,99900,500.0,10425,89575
200000,16,179114.0,199900,1000.0,20886,179114
400000,16,358012.0,399900,2000.0,41988,358012
600000,16,537208.0,599900,3000.0,62792,537208
800000,16,715976.0,799900,4000.0,84024,715976
1000000,16,895019.0,999900,5000.0,104981,895019
2,17,2.0,1,0.01,0,2
3,17,3.0,2,0.02,0,3
100,17,90.0,66,0.5,10,90
200,17,180.0,133,1.0,20,180
2000,17,1780.0,936,8.86,220,1780
10000,17,8967.0,936,8.86,1033,8967
20000,17,17976.0,936,8.86,2024,17976
40000,17,36008.0,936,8.86,3992,36008
60000,17,53997.0,936,8.86,6003,53997
80000,17,71989.0,936,8.86,8011,71989
100000,17,90044.0,936,8.86,9956,90044
200000,17,179864.0,936,8.86,20136,179864
400000,17,359636.0,936,8.86,40364,359636
600000,17,539533.0,936,8.86,60467,539533
800000,17,719392.0,936,8.86,80608,719392
1000000,17,899335.0,936,8.86,100665,899335
2,18,2.0,1,0.01,0,2
3,18,3.0,2,0.02,0,3
100,18,89.0,66,0.5,11,89
200,18,177.0,133,1.0,23,177
2000,18,1776.0,270,2.2,224,1776
10000,18,9006.0,270,2.2,994,9006
20000,18,18014.0,270,2.2,1986,18014
40000,18,36026.0,270,2.2,3974,36026
60000,18,54068.0,270,2.2,5932,54068
80000,18,72017.0,270,2.2,7983,72017
100000,18,90059.0,270,2.2,9941,90059
200000,18,179943.0,270,2.2,20057,179943
400000,18,359993.0,270,2.2,40007,359993
600000,18,540104.0,270,2.2,59896,540104
800000,18,719963.0,270,2.2,80037,719963
1000000,18,900024.0,270,2.2,99976,900024
2,19,2.0,1,0.01,0,2
3,19,3.0,2,0.02,0,3
100,19,91.0,66,0.5,9,91
200,19,185.0,133,1.0,15,185
2000,19,1808.0,1842,9.75,192,1808
10000,19,8954.0,9834,49.76,1046,8954
20000,19,17847.0,19834,99.75,2153,17847
40000,19,35780.0,39834,199.75,4220,35780
60000,19,53743.0,59834,299.75,6257,53743
80000,19,71744.0,79834,399.75,8256,71744
100000,19,89670.0,99834,499.75,10330,89670
200000,19,179170.0,199834,999.75,20830,179170
400000,19,358210.0,399834,1999.76,41790,358210
600000,19,537394.0,599834,2999.76,62606,537394
800000,19,716401.0,799834,3999.76,83599,716401
1000000,19,895654.0,999834,4999.76,104346,895654
2,20,2.0,1,0.01,0,2
3,20,3.0,2,0.02,0,3
100,20,88.0,66,0.5,12,88
200,20,177.0,133,1.0,23,177
2000,20,1775.0,1870,9.87,225,1775
10000,20,8924.0,9870,49.87,1076,8924
20000,20,17905.0,19870,99.87,2095,17905
40000,20,35810.0,39870,199.87,4190,35810
60000,20,53693.0,59870,299.87,6307,53693
80000,20,71647.0,79870,399.87,8353,71647
100000,20,89513.0,99870,499.87,10487,89513
200000,20,179047.0,199870,999.87,20953,179047
400000,20,357974.0,399870,1999.87,42026,357974
600000,20,536921.0,599870,2999.87,63079,536921
800000,20,716049.0,799870,3999.87,83951,716049
1000000,20,895026.0,999870,4999.87,104974,895026
2,21,2.0,1,0.01,0,2
3,21,3.0,2,0.02,0,3
100,21,92.0,66,0.5,8,92
200,21,178.0,133,1.0,22,178
2000,21,1785.0,210,1.6,215,1785
10000,21,9001.0,210,1.6,999,9001
20000,21,18004.0,210,1.6,1996,18004
40000,21,35947.0,210,1.6,4053,35947
60000,21,53963.0,210,1.6,6037,53963
80000,21,71946.0,210,1.6,8054,71946
100000,21,89994.0,210,1.6,10006,89994
200000,21,179948.0,210,1.6,20052,179948
400000,21,359926.0,210,1.6,40074,359926
600000,21,539998.0,210,1.6,60002,539998
800000,21,719913.0,210,1.6,80087,719913
1000000,21,899865.0,210,1.6,100135,899865
2,22,2.0,1,0.01,0,2
3,22,3.0,2,0.02,0,3
100,22,92.0,66,0.5,8,92
200,22,182.0,133,1.0,18,182
2000,22,1778.0,1523,13.62,222,1778
10000,22,8930.0,5107,49.46,1070,8930
20000,22,17923.0,5107,49.46,2077,17923
40000,22,35960.0,5107,49.46,4040,35960
60000,22,53976.0,5107,49.46,6024,53976
80000,22,72009.0,5107,49.46,7991,72009
100000,22,89976.0,5107,49.46,10024,89976
200000,22,180001.0,5107,49.46,19999,180001
400000,22,359894.0,5107,49.46,40106,359894
600000,22,539979.0,5107,49.46,60021,539979
800000,22,720004.0,5107,49.46,79996,720004
1000000,22,899856.0,5107,49.46,100144,899856
2,23,2.0,1,0.01,0,2
3,23,3.0,2,0.02,0,3
100,23,90.0,66,0.5,10,90
200,23,180.0,133,1.0,20,180
2000,23,1806.0,301,2.48,194,1806
10000,23,8997.0,301,2.48,1003,8997
20000,23,18057.0,301,2.48,1943,18057
40000,23,36086.0,301,2.48,3914,36086
60000,23,54088.0,301,2.48,5912,54088
80000,23,72084.0,301,2.48,7916,72084
100000,23,90197.0,301,2.48,9803,90197
200000,23,180112.0,301,2.48,19888,180112
400000,23,360041.0,301,2.48,39959,360041
600000,23,540084.0,301,2.48,59916,540084
800000,23,720018.0,301,2.48,79982,720018
1000000,23,900066.0,301,2.48,99934,900066
2,24,2.0,1,0.01,0,2
3,24,3.0,2,0.02,0,3
100,24,92.0,66,0.5,8,92
200,24,184.0,133,1.0,16,184
2000,24,1793.0,1510,14.6,207,1793
10000,24,8971.0,2419,23.69,1029,8971
20000,24,17993.0,2419,23.69,2007,17993
40000,24,35893.0,2419,23.69,4107,35893
60000,24,53905.0,2419,23.69,6095,53905
80000,24,71857.0,2419,23.69,8143,71857
100000,24,89821.0,2419,23.69,10179,89821
200000,24,179840.0,2419,23.69,20160,179840
400000,24,359934.0,2419,23.69,40066,359934
600000,24,539743.0,2419,23.69,60257,539743
800000,24,720055.0,2419,23.69,79945,720055
1000000,24,900129.0,2419,23.69,99871,900129
2,25,2.0,1,0.01,0,2
3,25,2.0,2,0.02,1,2
100,25,88.0,66,0.5,12,88
200,25,180.0,133,1.0,20,180
2000,25,1796.0,1815,9.58,204,1796
10000,25,8933.0,9815,49.58,1067,8933
20000,25,17879.0,19815,99.57,2121,17879
40000,25,35711.0,39815,199.57,4289,35711
60000,25,53537.0,59815,299.57,6463,53537
80000,25,71410.0,79815,399.57,8590,71410
100000,25,89230.0,99815,499.57,10770,89230
200000,25,178631.0,199815,999.57,21369,178631
400000,25,357826.0,399815,1999.58,42174,357826
600000,25,536759.0,599815,2999.58,63241,536759
800000,25,715585.0,799815,3999.58,84415,715585
1000000,25,894439.0,999815,4999.58,105561,894439
2,26,2.0,1,0.01,0,2
3,26,2.0,2,0.02,1,2
100,26,92.0,66,0.5,8,92
200,26,179.0,133,1.0,21,179
2000,26,1779.0,319,2.34,221,1779
10000,26,9020.0,319,2.34,980,9020
20000,26,17998.0,319,2.34,2002,17998
40000,26,36031.0,319,2.34,3969,36031
60000,26,53981.0,319,2.34,6019,53981
80000,26,71943.0,319,2.34,8057,71943
100000,26,89871.0,319,2.34,10129,89871
200000,26,179904.0,319,2.34,20096,179904
400000,26,359787.0,319,2.34,40213,359787
600000,26,539940.0,319,2.34,60060,539940
800000,26,719861.0,319,2.34,80139,719861
1000000,26,899954.0,319,2.34,100046,899954
2,27,2.0,1,0.01,0,2
3,27,3.0,2,0.02,0,3
100,27,90.0,66,0.5,10,90
200,27,174.0,133,1.0,26,174
2000,27,1799.0,200,1.5,201,1799
10000,27,8947.0,1994,10.47,1053,8947
20000,27,17954.0,1994,10.47,2046,17954
40000,27,35964.0,1994,10.47,4036,35964
60000,27,53939.0,1994,10.47,6061,53939
80000,27,71874.0,1994,10.47,8126,71874
100000,27,89838.0,1994,10.47,10162,89838
200000,27,179848.0,1994,10.47,20152,179848
400000,27,359699.0,1994,10.47,40301,359699
600000,27,539817.0,1994,10.47,60183,539817
800000,27,719913.0,1994,10.47,80087,719913
1000000,27,899776.0,1994,10.47,100224,899776
2,28,2.0,1,0.01,0,2
3,28,3.0,2,0.02,0,3
100,28,93.0,66,0.5,7,93
200,28,181.0,133,1.0,19,181
2000,28,1787.0,1900,10.65,213,1787
10000,28,8957.0,9900,51.65,1043,8957
20000,28,17894.0,19900,101.65,2106,17894
40000,28,35823.0,39900,201.65,4177,35823
60000,28,53747.0,59900,301.65,6253,53747
80000,28,71652.0,79900,401.65,8348,71652
100000,28,89551.0,99900,501.65,10449,89551
200000,28,179228.0,199900,1001.65,20772,179228
400000,28,358133.0,399900,2001.65,41867,358133
600000,28,537227.0,599900,3001.65,62773,537227
800000,28,716326.0,799900,4001.65,83674,716326
1000000,28,895297.0,999900,5001.65,104703,895297
2,29,2.0,1,0.01,0,2
3,29,3.0,2,0.02,0,3
100,29,94.0,66,0.5,6,94
200,29,182.0,133,1.0,18,182
2000,29,1794.0,1900,14.6,206,1794
10000,29,8976.0,9900,63.0,1024,8976
20000,29,17946.0,19900,112.99,2054,17946
40000,29,35815.0,39900,212.99,4185,35815
60000,29,53748.0,59900,312.99,6252,53748
80000,29,71712.0,79900,412.99,8288,71712
100000,29,89568.0,99900,512.99,10432,89568
200000,29,179048.0,199900,1012.99,20952,179048
400000,29,357937.0,399900,2013.0,42063,357937
600000,29,536913.0,599900,3013.0,63087,536913
800000,29,715917.0,799900,4013.0,84083,715917
1000000,29,894950.0,999900,5013.0,105050,894950
2,30,0.0,1,0.01,2,0
3,30,1.0,2,0.02,2,1
100,30,86.0,66,0.5,14,86
200,30,175.0,133,1.0,25,175
2000,30,1786.0,1887,18.37,214,1786
10000,30,8919.0,9887,98.37,1081,8919
20000,30,17801.0,19887,198.37,2199,17801
40000,30,35597.0,39887,398.37,4403,35597
60000,30,53436.0,59887,598.37,6564,53436
80000,30,71171.0,79887,798.37,8829,71171
100000,30,88890.0,99887,998.37,11110,88890
200000,30,177783.0,199887,1998.37,22217,177783
400000,30,355595.0,399887,3998.37,44405,355595
600000,30,533898.0,599887,5998.37,66102,533898
800000,30,711761.0,799887,7998.37,88239,711761
1000000,30,889675.0,999887,9998.37,110325,889675
2,31,2.0,1,0.01,0,2
3,31,3.0,2,0.02,0,3
100,31,89.0,66,0.5,11,89
200,31,177.0,133,1.0,23,177
2000,31,1798.0,206,1.56,202,1798
10000,31,9030.0,206,1.56,970,9030
20000,31,18083.0,206,1.56,1917,18083
40000,31,35991.0,206,1.56,4009,35991
60000,31,53947.0,206,1.56,6053,53947
80000,31,71979.0,206,1.56,8021,71979
100000,31,90017.0,206,1.56,9983,90017
200000,31,179933.0,206,1.56,20067,179933
400000,31,359807.0,206,1.56,40193,359807
600000,31,539894.0,206,1.56,60106,539894
800000,31,719949.0,206,1.56,80051,719949
1000000,31,899861.0,206,1.56,100139,899861
2,32,2.0,1,0.01,0,2
3,32,3.0,2,0.02,0,3
100,32,92.0,66,0.5,8,92
200,32,179.0,133,1.0,21,179
2000,32,1763.0,1734,16.26,237,1763
10000,32,8858.0,9734,96.26,1142,8858
20000,32,17775.0,19734,196.26,2225,17775
40000,32,35589.0,39734,396.26,4411,35589
60000,32,53422.0,59734,596.26,6578,53422
80000,32,71165.0,79734,796.26,8835,71165
100000,32,88949.0,99734,996.26,11051,88949
200000,32,177988.0,199734,1996.26,22012,177988
400000,32,355922.0,399734,3996.26,44078,355922
600000,32,534105.0,599734,5996.26,65895,534105
800000,32,712130.0,799734,7996.26,87870,712130
1000000,32,890028.0,999734,9996.26,109972,890028
2,33,2.0,1,0.01,0,2
3,33,3.0,2,0.02,0,3
100,33,92.0,66,0.5,8,92
200,33,180.0,133,1.0,20,180
2000,33,1813.0,214,1.64,187,1813
10000,33,8998.0,220,1.7,1002,8998
20000,33,17993.0,221,1.71,2007,17993
40000,33,35947.0,221,1.71,4053,35947
60000,33,53922.0,221,1.71,6078,53922
80000,33,71924.0,221,1.71,8076,71924
100000,33,89912.0,221,1.71,10088,89912
200000,33,180028.0,221,1.71,19972,180028
400000,33,360158.0,221,1.71,39842,360158
600000,33,540121.0,221,1.71,59879,540121
800000,33,719843.0,221,1.71,80157,719843
1000000,33,899717.0,221,1.71,100283,899717
2,34,2.0,1,0.01,0,2
3,34,3.0,2,0.02,0,3
100,34,94.0,66,0.5,6,94
200,34,176.0,133,1.0,24,176
2000,34,1780.0,1899,10.3,220,1780
10000,34,8948.0,9899,50.3,1052,8948
20000,34,17904.0,19899,100.3,2096,17904
40000,34,35857.0,39899,200.3,4143,35857
60000,34,53805.0,59899,300.3,6195,53805
80000,34,71670.0,79899,400.3,8330,71670
100000,34,89580.0,99899,500.3,10420,89580
200000,34,179207.0,199899,1000.3,20793,179207
400000,34,358103.0,399899,2000.3,41897,358103
600000,34,537055.0,599899,3000.3,62945,537055
800000,34,716236.0,799899,4000.3,83764,716236
1000000,34,895159.0,999899,5000.3,104841,895159
2,35,2.0,1,0.01,0,2
3,35,2.0,2,0.02,1,2
100,35,88.0,66,0.5,12,88
200,35,174.0,133,1.0,26,174
2000,35,1802.0,1900,10.0,198,1802
10000,35,8943.0,9900,50.0,1057,8943
20000,35,17835.0,19900,100.0,2165,17835
40000,35,35765.0,39900,200.0,4235,35765
60000,35,53696.0,59900,300.0,6304,53696
80000,35,71610.0,79900,400.0,8390,71610
100000,35,89469.0,99900,500.0,10531,89469
200000,35,178989.0,199900,1000.0,21011,178989
400000,35,358092.0,399900,2000.0,41908,358092
600000,35,536968.0,599900,3000.0,63032,536968
800000,35,715876.0,799900,4000.0,84124,715876
1000000,35,894984.0,999900,5000.0,105016,894984
2,36,2.0,1,0.01,0,2
3,36,3.0,2,0.02,0,3
100,36,93.0,66,0.5,7,93
200,36,177.0,133,1.0,23,177
2000,36,1787.0,1878,18.28,213,1787
10000,36,8952.0,9878,98.28,1048,8952
20000,36,17862.0,19878,198.28,2138,17862
40000,36,35677.0,39878,398.28,4323,35677
60000,36,53521.0,59878,598.28,6479,53521
80000,36,71330.0,79878,798.28,8670,71330
100000,36,89147.0,99878,998.28,10853,89147
200000,36,178268.0,199878,1998.28,21732,178268
400000,36,356062.0,399878,3998.28,43938,356062
600000,36,533725.0,599878,5998.28,66275,533725
800000,36,711535.0,799878,7998.28,88465,711535
1000000,36,889447.0,999878,9998.28,110553,889447
2,37,1.0,1,0.01,1,1
3,37,2.0,2,0.02,1,2
100,37,90.0,66,0.5,10,90
200,37,179.0,133,1.0,21,179
2000,37,1798.0,1202,6.51,202,1798
10000,37,9002.0,9202,46.51,998,9002
20000,37,17930.0,19051,95.75,2070,17930
40000,37,35812.0,37801,189.5,4188,35812
60000,37,53890.0,37801,189.5,6110,53890
80000,37,71912.0,37801,189.5,8088,71912
100000,37,89908.0,37801,189.5,10092,89908
200000,37,179892.0,37801,189.5,20108,179892
400000,37,359894.0,37801,189.5,40106,359894
600000,37,539640.0,37801,189.5,60360,539640
800000,37,719736.0,37801,189.5,80264,719736
1000000,37,899633.0,37801,189.5,100367,899633
2,38,2.0,1,0.01,0,2
3,38,3.0,2,0.02,0,3
100,38,90.0,66,0.5,10,90
200,38,180.0,133,1.0,20,180
2000,38,1772.0,425,3.75,228,1772
10000,38,8966.0,425,3.75,1034,8966
20000,38,17971.0,425,3.75,2029,17971
40000,38,36051.0,425,3.75,3949,36051
60000,38,54036.0,425,3.75,5964,54036
80000,38,72054.0,425,3.75,7946,72054
100000,38,90114.0,425,3.75,9886,90114
200000,38,180159.0,425,3.75,19841,180159
400000,38,360148.0,425,3.75,39852,360148
600000,38,539883.0,425,3.75,60117,539883
800000,38,719810.0,425,3.75,80190,719810
1000000,38,899753.0,425,3.75,100247,899753
2,39,2.0,1,0.01,0,2
3,39,3.0,2,0.02,0,3
100,39,86.0,66,0.5,14,86
200,39,175.0,133,1.0,25,175
2000,39,1786.0,1900,10.0,214,1786
10000,39,8938.0,9900,50.0,1062,8938
20000,39,17814.0,19900,100.0,2186,17814
40000,39,35660.0,39900,200.0,4340,35660
60000,39,53558.0,59900,300.0,6442,53558
80000,39,71468.0,79900,400.0,8532,71468
100000,39,89365.0,99900,500.0,10635,89365
200000,39,178819.0,199900,1000.0,21181,178819
400000,39,357734.0,399900,2000.0,42266,357734
600000,39,536697.0,599900,3000.0,63303,536697
800000,39,715582.0,799900,4000.0,84418,715582
1000000,39,894651.0,999900,5000.0,105349,894651
2,40,2.0,1,0.01,0,2
3,40,3.0,2,0.02,0,3
100,40,91.0,66,0.5,9,91
200,40,180.0,133,1.0,20,180
2000,40,1786.0,1900,10.55,214,1786
10000,40,8934.0,9900,50.55,1066,8934
20000,40,17867.0,19900,100.54,2133,17867
40000,40,35803.0,39900,200.54,4197,35803
60000,40,53744.0,59900,300.54,6256,53744
80000,40,71703.0,79900,400.54,8297,71703
100000,40,89612.0,99900,500.54,10388,89612
200000,40,179093.0,199900,1000.54,20907,179093
400000,40,358011.0,399900,2000.55,41989,358011
600000,40,537002.0,599900,3000.55,62998,537002
800000,40,715822.0,799900,4000.55,84178,715822
1000000,40,894704.0,999900,5000.55,105296,894704
2,41,2.0,1,0.01,0,2
3,41,2.0,2,0.02,1,2
100,41,90.0,66,0.5,10,90
200,41,177.0,133,1.0,23,177
2000,41,1790.0,1900,10.0,210,1790
10000,41,8987.0,9900,50.0,1013,8987
20000,41,17926.0,19900,100.0,2074,17926
40000,41,35894.0,39900,200.0,4106,35894
60000,41,53829.0,59900,300.0,6171,53829
80000,41,71613.0,79900,400.0,8387,71613
100000,41,89513.0,99900,500.0,10487,89513
200000,41,178912.0,199900,1000.0,21088,178912
400000,41,358116.0,399900,2000.0,41884,358116
600000,41,537161.0,599900,3000.0,62839,537161
800000,41,715996.0,799900,4000.0,84004,715996
1000000,41,895107.0,999900,5000.0,104893,895107
2,42,2.0,1,0.01,0,2
3,42,3.0,2,0.02,0,3
100,42,95.0,66,0.5,5,95
200,42,183.0,133,1.0,17,183
2000,42,1807.0,235,1.68,193,1807
10000,42,8992.0,235,1.68,1008,8992
20000,42,18004.0,235,1.68,1996,18004
40000,42,35997.0,235,1.68,4003,35997
60000,42,53992.0,235,1.68,6008,53992
80000,42,71954.0,235,1.68,8046,71954
100000,42,89916.0,235,1.68,10084,89916
200000,42,179831.0,235,1.68,20169,179831
400000,42,359826.0,235,1.68,40174,359826
600000,42,539889.0,235,1.68,60111,539889
800000,42,719717.0,235,1.68,80283,719717
1000000,42,899673.0,235,1.68,100327,899673
2,43,1.0,1,0.01,1,1
3,43,2.0,2,0.02,1,2
100,43,91.0,66,0.5,9,91
200,43,178.0,133,1.0,22,178
2000,43,1781.0,1898,9.99,219,1781
10000,43,8924.0,9898,49.99,1076,8924
20000,43,17876.0,19898,99.99,2124,17876
40000,43,35793.0,39898,199.99,4207,35793
60000,43,53689.0,59898,299.99,6311,53689
80000,43,71534.0,79898,399.99,8466,71534
100000,43,89387.0,99898,499.99,10613,89387
200000,43,178861.0,199898,999.99,21139,178861
400000,43,357729.0,399898,1999.99,42271,357729
600000,43,536578.0,599898,2999.99,63422,536578
800000,43,715507.0,799898,3999.99,84493,715507
1000000,43,894688.0,999898,4999.99,105312,894688
2,44,1.0,1,0.01,1,1
3,44,2.0,2,0.02,1,2
100,44,92.0,66,0.5,8,92
200,44,182.0,133,1.0,18,182
2000,44,1801.0,1900,10.09,199,1801
10000,44,8982.0,3516,18.18,1018,8982
20000,44,17929.0,3516,18.18,2071,17929
40000,44,35985.0,3516,18.18,4015,35985
60000,44,54013.0,3516,18.18,5987,54013
80000,44,72091.0,3516,18.18,7909,72091
100000,44,90117.0,3516,18.18,9883,90117
200000,44,180250.0,3516,18.18,19750,180250
400000,44,360392.0,3516,18.18,39608,360392
600000,44,540262.0,3516,18.18,59738,540262
800000,44,720139.0,3516,18.18,79861,720139
1000000,44,899878.0,3516,18.18,100122,899878
2,45,2.0,1,0.01,0,2
3,45,3.0,2,0.02,0,3
100,45,88.0,66,0.5,12,88
200,45,174.0,133,1.0,26,174
2000,45,1778.0,1016,9.47,222,1778
10000,45,8966.0,1080,10.11,1034,8966
20000,45,18007.0,1080,10.11,1993,18007
40000,45,36026.0,1080,10.11,3974,36026
60000,45,54040.0,1080,10.11,5960,54040
80000,45,71997.0,1080,10.11,8003,71997
100000,45,90014.0,1080,10.11,9986,90014
200000,45,180024.0,1080,10.11,19976,180024
400000,45,359825.0,1080,10.11,40175,359825
600000,45,539999.0,1080,10.11,60001,539999
800000,45,719990.0,1080,10.11,80010,719990
1000000,45,900027.0,1080,10.11,99973,900027
2,46,2.0,1,0.01,0,2
3,46,3.0,2,0.02,0,3
100,46,94.0,66,0.5,6,94
200,46,182.0,133,1.0,18,182
2000,46,1798.0,1361,7.3,202,1798
10000,46,8964.0,9361,47.31,1036,8964
20000,46,17939.0,19361,97.3,2061,17939
40000,46,35890.0,39361,197.3,4110,35890
60000,46,53817.0,59361,297.3,6183,53817
80000,46,71662.0,79361,397.3,8338,71662
100000,46,89582.0,99361,497.3,10418,89582
200000,46,179053.0,199361,997.3,20947,179053
400000,46,357923.0,399361,1997.31,42077,357923
600000,46,536678.0,599361,2997.31,63322,536678
800000,46,715751.0,799361,3997.31,84249,715751
1000000,46,894720.0,999361,4997.31,105280,894720
2,47,2.0,1,0.01,0,2
3,47,3.0,2,0.02,0,3
100,47,92.0,66,0.5,8,92
200,47,179.0,133,1.0,21,179
2000,47,1806.0,1900,10.0,194,1806
10000,47,9029.0,9900,50.0,971,9029
20000,47,18000.0,19900,100.0,2000,18000
40000,47,35847.0,39900,200.0,4153,35847
60000,47,53760.0,59900,300.0,6240,53760
80000,47,71664.0,79900,400.0,8336,71664
100000,47,89670.0,99900,500.0,10330,89670
200000,47,179137.0,199900,1000.0,20863,179137
400000,47,358022.0,399900,2000.0,41978,358022
600000,47,537172.0,599900,3000.0,62828,537172
800000,47,715983.0,799900,4000.0,84017,715983
1000000,47,895048.0,999900,5000.0,104952,895048
2,48,2.0,1,0.01,0,2
3,48,3.0,2,0.02,0,3
100,48,90.0,66,0.5,10,90
200,48,178.0,133,1.0,22,178
2000,48,1758.0,1227,6.63,242,1758
10000,48,8913.0,9227,46.64,1087,8913
20000,48,17902.0,19227,96.63,2098,17902
40000,48,35883.0,39227,196.63,4117,35883
60000,48,53784.0,59227,296.63,6216,53784
80000,48,71702.0,79227,396.63,8298,71702
100000,48,89627.0,99227,496.63,10373,89627
200000,48,179101.0,199227,996.63,20899,179101
400000,48,358168.0,399227,1996.64,41832,358168
600000,48,537355.0,599227,2996.64,62645,537355
800000,48,716251.0,799227,3996.64,83749,716251
1000000,48,895081.0,999227,4996.64,104919,895081
2,49,2.0,1,0.01,0,2
3,49,3.0,2,0.02,0,3
100,49,89.0,66,0.5,11,89
200,49,175.0,133,1.0,25,175
2000,49,1762.0,1900,11.15,238,1762
10000,49,8963.0,9900,51.15,1037,8963
20000,49,17879.0,19900,101.15,2121,17879
40000,49,35783.0,39900,201.15,4217,35783
60000,49,53792.0,59900,301.15,6208,53792
80000,49,71731.0,79900,401.15,8269,71731
100000,49,89658.0,99900,501.15,10342,89658
200000,49,179043.0,199900,1001.15,20957,179043
400000,49,358022.0,399900,2001.15,41978,358022
600000,49,537118.0,599900,3001.15,62882,537118
800000,49,715925.0,799900,4001.15,84075,715925
1000000,49,895044.0,999900,5001.15,104956,895044
2,50,2.0,1,0.01,0,2
3,50,3.0,2,0.02,0,3
100,50,88.0,66,0.5,12,88
200,50,175.0,133,1.0,25,175
2000,50,1747.0,1851,17.09,253,1747
10000,50,8888.0,9851,97.09,1112,8888
20000,50,17749.0,19851,197.09,2251,17749
40000,50,35552.0,39851,397.09,4448,35552
60000,50,53326.0,59851,597.09,6674,53326
80000,50,71131.0,79851,797.09,8869,71131
100000,50,88910.0,99851,997.09,11090,88910
200000,50,178028.0,199851,1997.09,21972,178028
400000,50,355893.0,399851,3997.09,44107,355893
600000,50,533946.0,599851,5997.09,66054,533946
800000,50,711568.0,799851,7997.09,88432,711568
1000000,50,889740.0,999851,9997.09,110260,889740
2,51,2.0,1,0.01,0,2
3,51,3.0,2,0.02,0,3
100,51,86.0,66,0.5,14,86
200,51,179.0,133,1.0,21,179
2000,51,1770.0,1900,10.09,230,1770
10000,51,8889.0,9900,50.09,1111,8889
20000,51,17897.0,19900,100.09,2103,17897
40000,51,35720.0,39900,200.09,4280,35720
60000,51,53673.0,59900,300.09,6327,53673
80000,51,71572.0,79900,400.09,8428,71572
100000,51,89458.0,99900,500.09,10542,89458
200000,51,178912.0,199900,1000.09,21088,178912
400000,51,357720.0,399900,2000.09,42280,357720
600000,51,536655.0,599900,3000.09,63345,536655
800000,51,715626.0,799900,4000.09,84374,715626
1000000,51,894583.0,999900,5000.09,105417,894583
2,52,2.0,1,0.01,0,2
3,52,3.0,2,0.02,0,3
100,52,90.0,66,0.5,10,90
200,52,178.0,133,1.0,22,178
2000,52,1796.0,1900,10.0,204,1796
10000,52,9001.0,9900,50.0,999,9001
20000,52,17927.0,19900,100.0,2073,17927
40000,52,35821.0,39900,200.0,4179,35821
60000,52,53775.0,59900,300.0,6225,53775
80000,52,71710.0,79900,400.0,8290,71710
100000,52,89599.0,99900,500.0,10401,89599
200000,52,179083.0,199900,1000.0,20917,179083
400000,52,358026.0,399900,2000.0,41974,358026
600000,52,537061.0,599900,3000.0,62939,537061
800000,52,716108.0,799900,4000.0,83892,716108
1000000,52,895202.0,999900,5000.0,104798,895202
2,53,1.0,1,0.01,1,1
3,53,1.0,2,0.02,2,1
100,53,90.0,66,0.5,10,90
200,53,178.0,133,1.0,22,178
2000,53,1784.0,1859,9.8,216,1784
10000,53,8940.0,9859,49.8,1060,8940
20000,53,17925.0,19859,99.79,2075,17925
40000,53,35814.0,39859,199.79,4186,35814
60000,53,53683.0,59859,299.79,6317,53683
80000,53,71635.0,79859,399.79,8365,71635
100000,53,89528.0,99859,499.79,10472,89528
200000,53,179217.0,199859,999.79,20783,179217
400000,53,358154.0,399859,1999.8,41846,358154
600000,53,537034.0,599859,2999.8,62966,537034
800000,53,715802.0,799859,3999.8,84198,715802
1000000,53,894791.0,999859,4999.8,105209,894791
2,54,2.0,1,0.01,0,2
3,54,3.0,2,0.02,0,3
100,54,92.0,66,0.5,8,92
200,54,185.0,133,1.0,15,185
2000,54,1841.0,200,1.5,159,1841
10000,54,9007.0,205,1.53,993,9007
20000,54,18016.0,205,1.53,1984,18016
40000,54,36054.0,205,1.53,3946,36054
60000,54,54008.0,205,1.53,5992,54008
80000,54,72029.0,205,1.53,7971,72029
100000,54,90067.0,205,1.53,9933,90067
200000,54,180023.0,205,1.53,19977,180023
400000,54,360014.0,205,1.53,39986,360014
600000,54,539944.0,205,1.53,60056,539944
800000,54,719745.0,205,1.53,80255,719745
1000000,54,899466.0,205,1.53,100534,899466
2,55,1.0,1,0.01,1,1
3,55,2.0,2,0.02,1,2
100,55,88.0,66,0.5,12,88
200,55,177.0,133,1.0,23,177
2000,55,1796.0,294,1.97,204,1796
10000,55,8949.0,294,1.97,1051,8949
20000,55,17905.0,294,1.97,2095,17905
40000,55,35878.0,294,1.97,4122,35878
60000,55,53833.0,294,1.97,6167,53833
80000,55,71826.0,294,1.97,8174,71826
100000,55,89848.0,294,1.97,10152,89848
200000,55,179852.0,294,1.97,20148,179852
400000,55,359848.0,294,1.97,40152,359848
600000,55,539819.0,294,1.97,60181,539819
800000,55,719428.0,294,1.97,80572,719428
1000000,55,899295.0,294,1.97,100705,899295
2,56,2.0,1,0.01,0,2
3,56,3.0,2,0.02,0,3
100,56,90.0,66,0.5,10,90
200,56,180.0,133,1.0,20,180
2000,56,1791.0,1842,11.49,209,1791
10000,56,8948.0,9842,51.49,1052,8948
20000,56,17946.0,19842,101.49,2054,17946
40000,56,35776.0,39842,201.49,4224,35776
60000,56,53706.0,59842,301.49,6294,53706
80000,56,71611.0,79842,401.49,8389,71611
100000,56,89562.0,99842,501.49,10438,89562
200000,56,178976.0,199842,1001.49,21024,178976
400000,56,358099.0,399842,2001.49,41901,358099
600000,56,537067.0,599842,3001.49,62933,537067
800000,56,716213.0,799842,4001.49,83787,716213
1000000,56,895103.0,999842,5001.49,104897,895103
2,57,2.0,1,0.01,0,2
3,57,3.0,2,0.02,0,3
100,57,89.0,66,0.5,11,89
200,57,178.0,133,1.0,22,178
2000,57,1789.0,1897,9.99,211,1789
10000,57,9005.0,9897,49.99,995,9005
20000,57,17990.0,19897,99.98,2010,17990
40000,57,35884.0,39897,199.98,4116,35884
60000,57,53802.0,59897,299.98,6198,53802
80000,57,71688.0,79897,399.98,8312,71688
100000,57,89653.0,99897,499.98,10347,89653
200000,57,179227.0,199897,999.98,20773,179227
400000,57,358209.0,399897,1999.99,41791,358209
600000,57,537150.0,599897,2999.99,62850,537150
800000,57,716003.0,799897,3999.99,83997,716003
1000000,57,894972.0,999897,4999.99,105028,894972
2,58,2.0,1,0.01,0,2
3,58,2.0,2,0.02,1,2
100,58,83.0,66,0.5,17,83
200,58,169.0,133,1.0,31,169
2000,58,1780.0,1900,10.0,220,1780
10000,58,8982.0,9900,50.0,1018,8982
20000,58,17865.0,19900,100.0,2135,17865
40000,58,35790.0,39900,200.0,4210,35790
60000,58,53717.0,59900,300.0,6283,53717
80000,58,71604.0,79900,400.0,8396,71604
100000,58,89482.0,99900,500.0,10518,89482
200000,58,178979.0,199900,1000.0,21021,178979
400000,58,357994.0,399900,2000.0,42006,357994
600000,58,536947.0,599900,3000.0,63053,536947
800000,58,716255.0,799900,4000.0,83745,716255
1000000,58,895262.0,999900,5000.0,104738,895262
2,59,2.0,1,0.01,0,2
3,59,3.0,2,0.02,0,3
100,59,94.0,66,0.5,6,94
200,59,179.0,133,1.0,21,179
2000,59,1810.0,327,2.16,190,1810
10000,59,9025.0,327,2.16,975,9025
20000,59,18049.0,327,2.16,1951,18049
40000,59,36007.0,327,2.16,3993,36007
60000,59,53964.0,327,2.16,6036,53964
80000,59,71913.0,327,2.16,8087,71913
100000,59,89919.0,327,2.16,10081,89919
200000,59,179795.0,327,2.16,20205,179795
400000,59,359881.0,327,2.16,40119,359881
600000,59,540104.0,327,2.16,59896,540104
800000,59,720111.0,327,2.16,79889,720111
1000000,59,900482.0,327,2.16,99518,900482
2,60,2.0,1,0.01,0,2
3,60,3.0,2,0.02,0,3
100,60,92.0,66,0.5,8,92
200,60,183.0,133,1.0,17,183
2000,60,1792.0,1800,17.5,208,1792
10000,60,8897.0,9796,97.46,1103,8897
20000,60,17763.0,19796,197.46,2237,17763
40000,60,35553.0,39796,397.46,4447,35553
60000,60,53241.0,59796,597.46,6759,53241
80000,60,70979.0,79796,797.46,9021,70979
100000,60,88629.0,99796,997.46,11371,88629
200000,60,177754.0,199796,1997.46,22246,177754
400000,60,355628.0,399796,3997.46,44372,355628
600000,60,533477.0,599796,5997.46,66523,533477
800000,60,711452.0,799796,7997.46,88548,711452
1000000,60,889404.0,999796,9997.46,110596,889404
2,61,2.0,1,0.01,0,2
3,61,2.0,2,0.02,1,2
100,61,91.0,66,0.5,9,91
200,61,170.0,133,1.0,30,170
2000,61,1791.0,1900,10.0,209,1791
10000,61,8941.0,9900,50.0,1059,8941
20000,61,17877.0,19900,100.0,2123,17877
40000,61,35740.0,39900,200.0,4260,35740
60000,61,53657.0,59900,300.0,6343,53657
80000,61,71543.0,79900,400.0,8457,71543
100000,61,89373.0,99900,500.0,10627,89373
200000,61,178827.0,199900,1000.0,21173,178827
400000,61,357681.0,399900,2000.0,42319,357681
600000,61,536699.0,599900,3000.0,63301,536699
800000,61,715573.0,799900,4000.0,84427,715573
1000000,61,894235.0,999900,5000.0,105765,894235
2,62,2.0,1,0.01,0,2
3,62,3.0,2,0.02,0,3
100,62,87.0,66,0.5,13,87
200,62,179.0,133,1.0,21,179
2000,62,1810.0,205,1.55,190,1810
10000,62,9048.0,205,1.55,952,9048
20000,62,18034.0,205,1.55,1966,18034
40000,62,35999.0,205,1.55,4001,35999
60000,62,53941.0,205,1.55,6059,53941
80000,62,71888.0,205,1.55,8112,71888
100000,62,90000.0,205,1.55,10000,90000
200000,62,179846.0,205,1.55,20154,179846
400000,62,359685.0,205,1.55,40315,359685
600000,62,539817.0,205,1.55,60183,539817
800000,62,719610.0,205,1.55,80390,719610
1000000,62,899523.0,205,1.55,100477,899523
2,63,2.0,1,0.01,0,2
3,63,2.0,2,0.02,1,2
100,63,88.0,66,0.5,12,88
200,63,179.0,133,1.0,21,179
2000,63,1799.0,200,1.5,201,1799
10000,63,8975.0,200,1.5,1025,8975
20000,63,17979.0,200,1.5,2021,17979
40000,63,36010.0,200,1.5,3990,36010
60000,63,53961.0,200,1.5,6039,53961
80000,63,71955.0,200,1.5,8045,71955
100000,63,90025.0,200,1.5,9975,90025
200000,63,179855.0,200,1.5,20145,179855
400000,63,359986.0,200,1.5,40014,359986
600000,63,539879.0,200,1.5,60121,539879
800000,63,719980.0,200,1.5,80020,719980
1000000,63,899913.0,200,1.5,100087,899913
2,64,2.0,1,0.01,0,2
3,64,3.0,2,0.02,0,3
100,64,91.0,66,0.5,9,91
200,64,182.0,133,1.0,18,182
2000,64,1804.0,309,2.04,196,1804
10000,64,8992.0,309,2.04,1008,8992
20000,64,18019.0,309,2.04,1981,18019
40000,64,35980.0,309,2.04,4020,35980
60000,64,53912.0,309,2.04,6088,53912
80000,64,71906.0,309,2.04,8094,71906
100000,64,89871.0,309,2.04,10129,89871
200000,64,180029.0,309,2.04,19971,180029
400000,64,359979.0,309,2.04,40021,359979
600000,64,540068.0,309,2.04,59932,540068
800000,64,719904.0,309,2.04,80096,719904
1000000,64,899796.0,309,2.04,100204,899796
2,65,2.0,1,0.01,0,2
3,65,3.0,2,0.02,0,3
100,65,94.0,66,0.5,6,94
200,65,182.0,133,1.0,18,182
2000,65,1795.0,1894,18.44,205,1795
10000,65,8963.0,9893,98.43,1037,8963
20000,65,17903.0,19893,198.43,2097,17903
40000,65,35674.0,39893,398.43,4326,35674
60000,65,53461.0,59893,598.43,6539,53461
80000,65,71268.0,79893,798.43,8732,71268
100000,65,89002.0,99893,998.43,10998,89002
200000,65,178061.0,199893,1998.43,21939,178061
400000,65,356046.0,399893,3998.43,43954,356046
600000,65,533897.0,599893,5998.43,66103,533897
800000,65,712010.0,799893,7998.43,87990,712010
1000000,65,889965.0,999893,9998.43,110035,889965
2,66,0.0,1,0.01,2,0
3,66,1.0,2,0.02,2,1
100,66,87.0,66,0.5,13,87
200,66,175.0,133,1.0,25,175
2000,66,1780.0,200,1.5,220,1780
10000,66,8988.0,200,1.5,1012,8988
20000,66,18053.0,200,1.5,1947,18053
40000,66,36080.0,200,1.5,3920,36080
60000,66,54029.0,200,1.5,5971,54029
80000,66,72035.0,200,1.5,7965,72035
100000,66,90076.0,200,1.5,9924,90076
200000,66,180073.0,200,1.5,19927,180073
400000,66,360070.0,200,1.5,39930,360070
600000,66,540301.0,200,1.5,59699,540301
800000,66,720341.0,200,1.5,79659,720341
1000000,66,900112.0,200,1.5,99888,900112
2,67,2.0,1,0.01,0,2
3,67,2.0,2,0.02,1,2
100,67,88.0,66,0.5,12,88
200,67,173.0,133,1.0,27,173
2000,67,1810.0,1900,10.0,190,1810
10000,67,8942.0,9900,50.0,1058,8942
20000,67,17925.0,19900,100.0,2075,17925
40000,67,35748.0,39900,200.0,4252,35748
60000,67,53703.0,59900,300.0,6297,53703
80000,67,71581.0,79900,400.0,8419,71581
100000,67,89536.0,99900,500.0,10464,89536
200000,67,179002.0,199900,1000.0,20998,179002
400000,67,358076.0,399900,2000.0,41924,358076
600000,67,536949.0,599900,3000.0,63051,536949
800000,67,715817.0,799900,4000.0,84183,715817
1000000,67,894954.0,999900,5000.0,105046,894954
2,68,2.0,1,0.01,0,2
3,68,2.0,2,0.02,1,2
100,68,85.0,66,0.5,15,85
200,68,179.0,133,1.0,21,179
2000,68,1785.0,382,2.55,215,1785
10000,68,9037.0,382,2.55,963,9037
20000,68,18033.0,382,2.55,1967,18033
40000,68,35984.0,382,2.55,4016,35984
60000,68,53969.0,382,2.55,6031,53969
80000,68,71943.0,382,2.55,8057,71943
100000,68,89926.0,382,2.55,10074,89926
200000,68,179691.0,382,2.55,20309,179691
400000,68,359877.0,382,2.55,40123,359877
600000,68,539919.0,382,2.55,60081,539919
800000,68,720183.0,382,2.55,79817,720183
1000000,68,900069.0,382,2.55,99931,900069
2,69,1.0,1,0.01,1,1
3,69,2.0,2,0.02,1,2
100,69,89.0,66,0.5,11,89
200,69,179.0,133,1.0,21,179
2000,69,1800.0,200,1.5,200,1800
10000,69,9010.0,200,1.5,990,9010
20000,69,17978.0,200,1.5,2022,17978
40000,69,35941.0,200,1.5,4059,35941
60000,69,53941.0,200,1.5,6059,53941
80000,69,71912.0,200,1.5,8088,71912
100000,69,89928.0,200,1.5,10072,89928
200000,69,179925.0,200,1.5,20075,179925
400000,69,359850.0,200,1.5,40150,359850
600000,69,539844.0,200,1.5,60156,539844
800000,69,719835.0,200,1.5,80165,719835
1000000,69,900033.0,200,1.5,99967,900033
2,70,2.0,1,0.01,0,2
3,70,3.0,2,0.02,0,3
100,70,90.0,66,0.5,10,90
200,70,180.0,133,1.0,20,180
2000,70,1796.0,1883,9.95,204,1796
10000,70,8925.0,9883,49.95,1075,8925
20000,70,17836.0,19883,99.95,2164,17836
40000,70,35763.0,39883,199.95,4237,35763
60000,70,53530.0,59883,299.95,6470,53530
80000,70,71439.0,79883,399.95,8561,71439
100000,70,89276.0,99883,499.95,10724,89276
200000,70,178711.0,199883,999.95,21289,178711
400000,70,357661.0,399883,1999.95,42339,357661
600000,70,536769.0,599883,2999.95,63231,536769
800000,70,715898.0,799883,3999.95,84102,715898
1000000,70,895159.0,999883,4999.95,104841,895159
2,71,2.0,1,0.01,0,2
3,71,3.0,2,0.02,0,3
100,71,92.0,66,0.5,8,92
200,71,182.0,133,1.0,18,182
2000,71,1798.0,1736,9.18,202,1798
10000,71,8943.0,9731,49.16,1057,8943
20000,71,17918.0,19731,99.15,2082,17918
40000,71,35773.0,39731,199.15,4227,35773
60000,71,53681.0,59731,299.15,6319,53681
80000,71,71673.0,79731,399.15,8327,71673
100000,71,89613.0,99731,499.15,10387,89613
200000,71,179140.0,199731,999.15,20860,179140
400000,71,358188.0,399731,1999.16,41812,358188
600000,71,537052.0,599731,2999.16,62948,537052
800000,71,716170.0,799731,3999.16,83830,716170
1000000,71,895371.0,999731,4999.16,104629,895371
2,72,2.0,1,0.01,0,2
3,72,3.0,2,0.02,0,3
100,72,92.0,66,0.5,8,92
200,72,183.0,133,1.0,17,183
2000,72,1808.0,200,1.5,192,1808
10000,72,9023.0,200,1.5,977,9023
20000,72,18005.0,200,1.5,1995,18005
40000,72,36039.0,200,1.5,3961,36039
60000,72,54008.0,200,1.5,5992,54008
80000,72,72021.0,200,1.5,7979,72021
100000,72,90047.0,200,1.5,9953,90047
200000,72,179993.0,200,1.5,20007,179993
400000,72,359935.0,200,1.5,40065,359935
600000,72,539898.0,200,1.5,60102,539898
800000,72,719835.0,200,1.5,80165,719835
1000000,72,899837.0,200,1.5,100163,899837
2,73,2.0,1,0.01,0,2
3,73,3.0,2,0.02,0,3
100,73,93.0,66,0.5,7,93
200,73,181.0,133,1.0,19,181
2000,73,1791.0,1421,7.6,209,1791
10000,73,8955.0,4042,20.71,1045,8955
20000,73,17977.0,4042,20.71,2023,17977
40000,73,35938.0,4042,20.71,4062,35938
60000,73,53934.0,4042,20.71,6066,53934
80000,73,71945.0,4042,20.71,8055,71945
100000,73,89962.0,4042,20.71,10038,89962
200000,73,179919.0,4042,20.71,20081,179919
400000,73,360000.0,4042,20.71,40000,360000
600000,73,539899.0,4042,20.71,60101,539899
800000,73,719792.0,4042,20.71,80208,719792
1000000,73,899633.0,4042,20.71,100367,899633
2,74,2.0,1,0.01,0,2
3,74,3.0,2,0.02,0,3
100,74,96.0,66,0.5,4,96
200,74,179.0,133,1.0,21,179
2000,74,1799.0,1767,9.87,201,1799
10000,74,8988.0,9767,49.87,1012,8988
20000,74,17943.0,19767,99.86,2057,17943
40000,74,35833.0,39767,199.86,4167,35833
60000,74,53676.0,59767,299.86,6324,53676
80000,74,71629.0,79767,399.86,8371,71629
100000,74,89525.0,99767,499.86,10475,89525
200000,74,178954.0,199767,999.86,21046,178954
400000,74,357793.0,399767,1999.87,42207,357793
600000,74,536822.0,599767,2999.87,63178,536822
800000,74,715459.0,799767,3999.87,84541,715459
1000000,74,894700.0,999767,4999.87,105300,894700
2,75,2.0,1,0.01,0,2
3,75,3.0,2,0.02,0,3
100,75,88.0,66,0.5,12,88
200,75,176.0,133,1.0,24,176
2000,75,1773.0,1885,9.93,227,1773
10000,75,8846.0,9885,49.93,1154,8846
20000,75,17795.0,19885,99.92,2205,17795
40000,75,35621.0,39885,199.92,4379,35621
60000,75,53566.0,59885,299.92,6434,53566
80000,75,71431.0,79885,399.92,8569,71431
100000,75,89305.0,99885,499.92,10695,89305
200000,75,178683.0,199885,999.92,21317,178683
400000,75,357647.0,399885,1999.93,42353,357647
600000,75,536373.0,599885,2999.93,63627,536373
800000,75,715405.0,799885,3999.93,84595,715405
1000000,75,894467.0,999885,4999.93,105533,894467
2,76,2.0,1,0.01,0,2
3,76,3.0,2,0.02,0,3
100,76,90.0,66,0.5,10,90
200,76,185.0,133,1.0,15,185
2000,76,1792.0,1839,11.17,208,1792
10000,76,8939.0,9839,51.17,1061,8939
20000,76,17866.0,19839,101.17,2134,17866
40000,76,35756.0,39839,201.17,4244,35756
60000,76,53659.0,59839,301.17,6341,53659
80000,76,71584.0,79839,401.17,8416,71584
100000,76,89483.0,99839,501.17,10517,89483
200000,76,178998.0,199839,1001.17,21002,178998
400000,76,357936.0,399839,2001.17,42064,357936
600000,76,536842.0,599839,3001.17,63158,536842
800000,76,715745.0,799839,4001.17,84255,715745
1000000,76,894785.0,999839,5001.17,105215,894785
2,77,2.0,1,0.01,0,2
3,77,3.0,2,0.02,0,3
100,77,92.0,66,0.5,8,92
200,77,187.0,133,1.0,13,187
2000,77,1808.0,200,1.5,192,1808
10000,77,8993.0,200,1.5,1007,8993
20000,77,17985.0,200,1.5,2015,17985
40000,77,35976.0,200,1.5,4024,35976
60000,77,53990.0,200,1.5,6010,53990
80000,77,71979.0,200,1.5,8021,71979
100000,77,90024.0,200,1.5,9976,90024
200000,77,180095.0,200,1.5,19905,180095
400000,77,359994.0,200,1.5,40006,359994
600000,77,539932.0,200,1.5,60068,539932
800000,77,719721.0,200,1.5,80279,719721
1000000,77,899891.0,200,1.5,100109,899891
2,78,2.0,1,0.01,0,2
3,78,3.0,2,0.02,0,3
100,78,91.0,66,0.5,9,91
200,78,175.0,133,1.0,25,175
2000,78,1789.0,1900,10.0,211,1789
10000,78,8943.0,9900,50.0,1057,8943
20000,78,17940.0,19900,100.0,2060,17940
40000,78,35830.0,39900,200.0,4170,35830
60000,78,53754.0,59900,300.0,6246,53754
80000,78,71721.0,79900,400.0,8279,71721
100000,78,89607.0,99900,500.0,10393,89607
200000,78,179093.0,199900,1000.0,20907,179093
400000,78,358186.0,399900,2000.0,41814,358186
600000,78,537263.0,599900,3000.0,62737,537263
800000,78,716383.0,799900,4000.0,83617,716383
1000000,78,895387.0,999900,5000.0,104613,895387
2,79,1.0,1,0.01,1,1
3,79,2.0,2,0.02,1,2
100,79,92.0,66,0.5,8,92
200,79,182.0,133,1.0,18,182
2000,79,1760.0,242,1.74,240,1760
10000,79,8935.0,242,1.74,1065,8935
20000,79,17947.0,242,1.74,2053,17947
40000,79,35947.0,242,1.74,4053,35947
60000,79,53895.0,242,1.74,6105,53895
80000,79,71869.0,242,1.74,8131,71869
100000,79,89917.0,242,1.74,10083,89917
200000,79,179828.0,242,1.74,20172,179828
400000,79,359810.0,242,1.74,40190,359810
600000,79,539927.0,242,1.74,60073,539927
800000,79,719813.0,242,1.74,80187,719813
1000000,79,899892.0,242,1.74,100108,899892
2,80,0.0,1,0.01,2,0
3,80,0.0,2,0.02,3,0
100,80,87.0,66,0.5,13,87
200,80,177.0,133,1.0,23,177
2000,80,1771.0,1900,18.49,229,1771
10000,80,8892.0,9900,98.49,1108,8892
20000,80,17784.0,19900,198.48,2216,17784
40000,80,35588.0,39900,398.48,4412,35588
60000,80,53297.0,59900,598.48,6703,53297
80000,80,71101.0,79900,798.48,8899,71101
100000,80,88860.0,99900,998.48,11140,88860
200000,80,177876.0,199900,1998.48,22124,177876
400000,80,355979.0,399900,3998.49,44021,355979
600000,80,533812.0,599900,5998.49,66188,533812
800000,80,711776.0,799900,7998.49,88224,711776
1000000,80,889718.0,999900,9998.49,110282,889718
2,81,1.0,1,0.01,1,1
3,81,2.0,2,0.02,1,2
100,81,88.0,66,0.5,12,88
200,81,178.0,133,1.0,22,178
2000,81,1808.0,1900,18.5,192,1808
10000,81,8897.0,9900,98.24,1103,8897
20000,81,17852.0,19900,198.24,2148,17852
40000,81,35663.0,39900,398.24,4337,35663
60000,81,53464.0,59900,598.24,6536,53464
80000,81,71317.0,79900,798.24,8683,71317
100000,81,89058.0,99900,998.24,10942,89058
200000,81,177927.0,199900,1998.24,22073,177927
400000,81,355979.0,399900,3998.24,44021,355979
600000,81,533993.0,599900,5998.24,66007,533993
800000,81,712100.0,799900,7998.24,87900,712100
1000000,81,890110.0,999900,9998.24,109890,890110
2,82,2.0,1,0.01,0,2
3,82,3.0,2,0.02,0,3
100,82,91.0,66,0.5,9,91
200,82,182.0,133,1.0,18,182
2000,82,1809.0,1900,11.1,191,1809
10000,82,8997.0,9900,66.91,1003,8997
20000,82,17882.0,19900,129.92,2118,17882
40000,82,35813.0,39900,230.07,4187,35813
60000,82,53699.0,59900,330.07,6301,53699
80000,82,71640.0,79900,430.07,8360,71640
100000,82,89559.0,99900,530.07,10441,89559
200000,82,179066.0,199900,1030.07,20934,179066
400000,82,357985.0,399900,2030.07,42015,357985
600000,82,537065.0,599900,3030.07,62935,537065
800000,82,716150.0,799900,4030.07,83850,716150
1000000,82,895286.0,999900,5030.07,104714,895286
2,83,2.0,1,0.01,0,2
3,83,3.0,2,0.02,0,3
100,83,87.0,66,0.5,13,87
200,83,174.0,133,1.0,26,174
2000,83,1804.0,200,1.5,196,1804
10000,83,9000.0,827,4.63,1000,9000
20000,83,17948.0,827,4.63,2052,17948
40000,83,35872.0,935,5.17,4128,35872
60000,83,53891.0,935,5.17,6109,53891
80000,83,71895.0,935,5.17,8105,71895
100000,83,89931.0,935,5.17,10069,89931
200000,83,179992.0,935,5.17,20008,179992
400000,83,360105.0,935,5.17,39895,360105
600000,83,540191.0,935,5.17,59809,540191
800000,83,720214.0,935,5.17,79786,720214
1000000,83,900177.0,935,5.17,99823,900177
2,84,1.0,1,0.01,1,1
3,84,1.0,2,0.02,2,1
100,84,90.0,66,0.5,10,90
200,84,175.0,133,1.0,25,175
2000,84,1784.0,200,1.5,216,1784
10000,84,8997.0,200,1.5,1003,8997
20000,84,17994.0,200,1.5,2006,17994
40000,84,36046.0,200,1.5,3954,36046
60000,84,54017.0,200,1.5,5983,54017
80000,84,72041.0,200,1.5,7959,72041
100000,84,90076.0,200,1.5,9924,90076
200000,84,180115.0,200,1.5,19885,180115
400000,84,360301.0,200,1.5,39699,360301
600000,84,540399.0,200,1.5,59601,540399
800000,84,720555.0,200,1.5,79445,720555
1000000,84,900605.0,200,1.5,99395,900605
2,85,2.0,1,0.01,0,2
3,85,2.0,2,0.02,1,2
100,85,89.0,66,0.5,11,89
200,85,178.0,133,1.0,22,178
2000,85,1789.0,200,1.5,211,1789
10000,85,8999.0,200,1.5,1001,8999
20000,85,17924.0,200,1.5,2076,17924
40000,85,35956.0,200,1.5,4044,35956
60000,85,53960.0,200,1.5,6040,53960
80000,85,71990.0,200,1.5,8010,71990
100000,85,90005.0,200,1.5,9995,90005
200000,85,179979.0,200,1.5,20021,179979
400000,85,360063.0,200,1.5,39937,360063
600000,85,540072.0,200,1.5,59928,540072
800000,85,720115.0,200,1.5,79885,720115
1000000,85,900150.0,200,1.5,99850,900150
2,86,1.0,1,0.01,1,1
3,86,2.0,2,0.02,1,2
100,86,88.0,66,0.5,12,88
200,86,176.0,133,1.0,24,176
2000,86,1795.0,1900,18.5,205,1795
10000,86,8935.0,9900,98.5,1065,8935
20000,86,17787.0,19900,198.39,2213,17787
40000,86,35627.0,39900,398.39,4373,35627
60000,86,53389.0,59900,598.39,6611,53389
80000,86,71221.0,79900,798.39,8779,71221
100000,86,89039.0,99900,998.39,10961,89039
200000,86,177968.0,199900,1998.39,22032,177968
400000,86,356070.0,399900,3998.39,43930,356070
600000,86,534123.0,599900,5998.39,65877,534123
800000,86,711772.0,799900,7998.39,88228,711772
1000000,86,889969.0,999900,9998.39,110031,889969
2,87,1.0,1,0.01,1,1
3,87,1.0,2,0.02,2,1
100,87,84.0,66,0.5,16,84
200,87,174.0,133,1.0,26,174
2000,87,1784.0,1861,18.03,216,1784
10000,87,8927.0,9861,98.03,1073,8927
20000,87,17868.0,19861,198.03,2132,17868
40000,87,35595.0,39861,398.03,4405,35595
60000,87,53321.0,59861,598.03,6679,53321
80000,87,71074.0,79861,798.03,8926,71074
100000,87,88821.0,99861,998.03,11179,88821
200000,87,177801.0,199861,1998.03,22199,177801
400000,87,355847.0,399861,3998.03,44153,355847
600000,87,533857.0,599861,5998.03,66143,533857
800000,87,711779.0,799861,7998.03,88221,711779
1000000,87,889730.0,999861,9998.03,110270,889730
2,88,1.0,1,0.01,1,1
3,88,2.0,2,0.02,1,2
100,88,88.0,66,0.5,12,88
200,88,175.0,133,1.0,25,175
2000,88,1797.0,212,1.59,203,1797
10000,88,8968.0,212,1.59,1032,8968
20000,88,17940.0,212,1.59,2060,17940
40000,88,35950.0,212,1.59,4050,35950
60000,88,53956.0,212,1.59,6044,53956
80000,88,71973.0,212,1.59,8027,71973
100000,88,89938.0,212,1.59,10062,89938
200000,88,180043.0,212,1.59,19957,180043
400000,88,359864.0,212,1.59,40136,359864
600000,88,539893.0,212,1.59,60107,539893
800000,88,719812.0,212,1.59,80188,719812
1000000,88,899903.0,212,1.59,100097,899903
2,89,1.0,1,0.01,1,1
3,89,2.0,2,0.02,1,2
100,89,87.0,66,0.5,13,87
200,89,174.0,133,1.0,26,174
2000,89,1765.0,1900,16.88,235,1765
10000,89,8914.0,9900,96.88,1086,8914
20000,89,17780.0,19900,196.88,2220,17780
40000,89,35583.0,39900,396.88,4417,35583
60000,89,53451.0,59900,596.88,6549,53451
80000,89,71230.0,79900,796.88,8770,71230
100000,89,89111.0,99900,996.88,10889,89111
200000,89,178183.0,199900,1996.88,21817,178183
400000,89,356310.0,399900,3996.88,43690,356310
600000,89,534222.0,599900,5996.88,65778,534222
800000,89,712302.0,799900,7996.88,87698,712302
1000000,89,890360.0,999900,9996.88,109640,890360
2,90,1.0,1,0.01,1,1
3,90,2.0,2,0.02,1,2
100,90,89.0,66,0.5,11,89
200,90,178.0,133,1.0,22,178
2000,90,1807.0,1900,10.3,193,1807
10000,90,9014.0,9900,50.3,986,9014
20000,90,17906.0,19900,100.29,2094,17906
40000,90,35873.0,39900,200.29,4127,35873
60000,90,53788.0,59900,300.29,6212,53788
80000,90,71604.0,79900,400.29,8396,71604
100000,90,89512.0,99900,500.29,10488,89512
200000,90,179110.0,199900,1000.29,20890,179110
400000,90,358103.0,399900,2000.3,41897,358103
600000,90,537079.0,599900,3000.3,62921,537079
800000,90,716140.0,799900,4000.3,83860,716140
1000000,90,895024.0,999900,5000.3,104976,895024
2,91,2.0,1,0.01,0,2
3,91,3.0,2,0.02,0,3
100,91,94.0,66,0.5,6,94
200,91,186.0,133,1.0,14,186
2000,91,1800.0,1900,18.5,200,1800
10000,91,8902.0,9900,98.49,1098,8902
20000,91,17879.0,19900,198.48,2121,17879
40000,91,35693.0,39900,398.48,4307,35693
60000,91,53525.0,59900,598.48,6475,53525
80000,91,71283.0,79900,798.48,8717,71283
100000,91,89142.0,99900,998.48,10858,89142
200000,91,177958.0,199900,1998.48,22042,177958
400000,91,356126.0,399900,3998.49,43874,356126
600000,91,534356.0,599900,5998.49,65644,534356
800000,91,712245.0,799900,7998.49,87755,712245
1000000,91,890442.0,999900,9998.49,109558,890442
2,92,2.0,1,0.01,0,2
3,92,3.0,2,0.02,0,3
100,92,90.0,66,0.5,10,90
200,92,177.0,133,1.0,23,177
2000,92,1798.0,1900,10.0,202,1798
10000,92,8930.0,9900,50.0,1070,8930
20000,92,17857.0,19900,100.0,2143,17857
40000,92,35824.0,39900,200.0,4176,35824
60000,92,53713.0,59900,300.0,6287,53713
80000,92,71627.0,79900,400.0,8373,71627
100000,92,89557.0,99900,500.0,10443,89557
200000,92,178967.0,199900,1000.0,21033,178967
400000,92,357750.0,399900,2000.0,42250,357750
600000,92,536729.0,599900,3000.0,63271,536729
800000,92,715766.0,799900,4000.0,84234,715766
1000000,92,894842.0,999900,5000.0,105158,894842
2,93,2.0,1,0.01,0,2
3,93,3.0,2,0.02,0,3
100,93,90.0,66,0.5,10,90
200,93,184.0,133,1.0,16,184
2000,93,1780.0,1670,16.2,220,1780
10000,93,8891.0,9670,96.2,1109,8891
20000,93,17810.0,19670,196.2,2190,17810
40000,93,35628.0,39670,396.2,4372,35628
60000,93,53445.0,59670,596.2,6555,53445
80000,93,71334.0,79670,796.2,8666,71334
100000,93,89112.0,99670,996.2,10888,89112
200000,93,178235.0,199670,1996.2,21765,178235
400000,93,356219.0,399670,3996.2,43781,356219
600000,93,534178.0,599670,5996.2,65822,534178
800000,93,712058.0,799670,7996.2,87942,712058
1000000,93,890382.0,999670,9996.2,109618,890382
2,94,2.0,1,0.01,0,2
3,94,3.0,2,0.02,0,3
100,94,85.0,66,0.5,15,85
200,94,175.0,133,1.0,25,175
2000,94,1778.0,1900,12.42,222,1778
10000,94,8970.0,9900,52.42,1030,8970
20000,94,17943.0,19900,102.41,2057,17943
40000,94,35857.0,39900,202.41,4143,35857
60000,94,53714.0,59900,302.41,6286,53714
80000,94,71648.0,79900,402.41,8352,71648
100000,94,89623.0,99900,502.41,10377,89623
200000,94,179066.0,199900,1002.41,20934,179066
400000,94,358094.0,399900,2002.42,41906,358094
600000,94,537077.0,599900,3002.42,62923,537077
800000,94,715852.0,799900,4002.42,84148,715852
1000000,94,894823.0,999900,5002.42,105177,894823
2,95,1.0,1,0.01,1,1
3,95,2.0,2,0.02,1,2
100,95,93.0,66,0.5,7,93
200,95,185.0,133,1.0,15,185
2000,95,1806.0,452,4.02,194,1806
10000,95,9003.0,454,4.04,997,9003
20000,95,18017.0,454,4.04,1983,18017
40000,95,36022.0,454,4.04,3978,36022
60000,95,54007.0,454,4.04,5993,54007
80000,95,72027.0,454,4.04,7973,72027
100000,95,90010.0,454,4.04,9990,90010
200000,95,180150.0,454,4.04,19850,180150
400000,95,360039.0,454,4.04,39961,360039
600000,95,540233.0,454,4.04,59767,540233
800000,95,720331.0,454,4.04,79669,720331
1000000,95,900264.0,454,4.04,99736,900264
2,96,2.0,1,0.01,0,2
3,96,2.0,2,0.02,1,2
100,96,88.0,66,0.5,12,88
200,96,170.0,133,1.0,30,170
2000,96,1802.0,200,1.5,198,1802
10000,96,8978.0,200,1.5,1022,8978
20000,96,17998.0,200,1.5,2002,17998
40000,96,35967.0,200,1.5,4033,35967
60000,96,53982.0,200,1.5,6018,53982
80000,96,71984.0,200,1.5,8016,71984
100000,96,89980.0,200,1.5,10020,89980
200000,96,180118.0,200,1.5,19882,180118
400000,96,360060.0,200,1.5,39940,360060
600000,96,540090.0,200,1.5,59910,540090
800000,96,720098.0,200,1.5,79902,720098
1000000,96,900254.0,200,1.5,99746,900254
2,97,1.0,1,0.01,1,1
3,97,2.0,2,0.02,1,2
100,97,91.0,66,0.5,9,91
200,97,187.0,133,1.0,13,187
2000,97,1813.0,289,2.39,187,1813
10000,97,8985.0,289,2.39,1015,8985
20000,97,17981.0,289,2.39,2019,17981
40000,97,36035.0,289,2.39,3965,36035
60000,97,54068.0,289,2.39,5932,54068
80000,97,72054.0,289,2.39,7946,72054
100000,97,90058.0,289,2.39,9942,90058
200000,97,180019.0,289,2.39,19981,180019
400000,97,360060.0,289,2.39,39940,360060
600000,97,540217.0,289,2.39,59783,540217
800000,97,720122.0,289,2.39,79878,720122
1000000,97,900234.0,289,2.39,99766,900234
2,98,2.0,1,0.01,0,2
3,98,3.0,2,0.02,0,3
100,98,90.0,66,0.5,10,90
200,98,179.0,133,1.0,21,179
2000,98,1775.0,1760,16.83,225,1775
10000,98,8910.0,9760,96.84,1090,8910
20000,98,17820.0,19760,196.83,2180,17820
40000,98,35656.0,39760,396.83,4344,35656
60000,98,53519.0,59760,596.83,6481,53519
80000,98,71402.0,79760,796.83,8598,71402
100000,98,89256.0,99760,996.83,10744,89256
200000,98,178424.0,199760,1996.83,21576,178424
400000,98,356563.0,399760,3996.84,43437,356563
600000,98,534522.0,599760,5996.84,65478,534522
800000,98,712541.0,799760,7996.84,87459,712541
1000000,98,890731.0,999760,9996.84,109269,890731
2,99,2.0,1,0.01,0,2
3,99,3.0,2,0.02,0,3
100,99,89.0,66,0.5,11,89
200,99,181.0,133,1.0,19,181
2000,99,1812.0,1900,10.72,188,1812
10000,99,8986.0,9900,50.72,1014,8986
20000,99,17964.0,19900,100.71,2036,17964
40000,99,35890.0,39900,200.71,4110,35890
60000,99,53749.0,59900,300.72,6251,53749
80000,99,71700.0,79900,400.72,8300,71700
100000,99,89601.0,99900,500.72,10399,89601
200000,99,179173.0,199900,1000.72,20827,179173
400000,99,358154.0,399900,2000.73,41846,358154
600000,99,537258.0,599900,3000.73,62742,537258
800000,99,716358.0,799900,4000.73,83642,716358
1000000,99,895334.0,999900,5000.73,104666,895334
2,100,2.0,1,0.01,0,2
3,100,3.0,2,0.02,0,3
100,100,91.0,66,0.5,9,91
200,100,177.0,133,1.0,23,177
2000,100,1819.0,377,2.38,181,1819
10000,100,8985.0,403,2.51,1015,8985
20000,100,17988.0,403,2.51,2012,17988
40000,100,35977.0,403,2.51,4023,35977
60000,100,53964.0,403,2.51,6036,53964
80000,100,71963.0,403,2.51,8037,71963
100000,100,89987.0,403,2.51,10013,89987
200000,100,179981.0,403,2.51,20019,179981
400000,100,359905.0,403,2.51,40095,359905
600000,100,540011.0,403,2.51,59989,540011
800000,100,720107.0,403,2.51,79893,720107
1000000,100,899915.0,403,2.51,100085,899915
