Timestep,Iteration,Total Reward,Suboptimal Arms,Total Regret,Zeros Count,Ones Count
2,1,1.0,2,0.08,1,1
3,1,2.0,2,0.08,1,2
100,1,86.0,52,2.08,14,86
200,1,178.0,82,3.28,22,178
2000,1,1763.0,702,28.08,237,1763
10000,1,8762.0,3362,134.48,1238,8762
20000,1,17502.0,6715,268.6,2498,17502
40000,1,35044.0,13454,538.16,4956,35044
60000,1,52561.0,20097,803.88,7439,52561
80000,1,70105.0,26849,1073.96,9895,70105
100000,1,87627.0,33557,1342.28,12373,87627
200000,1,175307.0,67051,2682.04,24693,175307
400000,1,350434.0,133756,5350.24,49566,350434
600000,1,525800.0,200326,8013.04,74200,525800
800000,1,701252.0,267249,10689.96,98748,701252
1000000,1,876576.0,333783,13351.32,123424,876576
2,2,2.0,2,0.08,0,2
3,2,3.0,3,0.12,0,3
100,2,82.0,46,1.84,18,82
200,2,172.0,82,3.28,28,172
2000,2,1760.0,745,29.8,240,1760
10000,2,8715.0,3423,136.92,1285,8715
20000,2,17498.0,6778,271.12,2502,17498
40000,2,34994.0,13491,539.64,5006,34994
60000,2,52513.0,20243,809.72,7487,52513
80000,2,70004.0,26892,1075.68,9996,70004
100000,2,87532.0,33565,1342.6,12468,87532
200000,2,175228.0,66819,2672.76,24772,175228
400000,2,350618.0,133645,5345.8,49382,350618
600000,2,525888.0,200193,8007.72,74112,525888
800000,2,701191.0,267011,10680.44,98809,701191
1000000,2,876651.0,333613,13344.52,123349,876651
2,3,2.0,2,0.08,0,2
3,3,3.0,3,0.12,0,3
100,3,93.0,43,1.72,7,93
200,3,184.0,80,3.2,16,184
2000,3,1763.0,743,29.72,237,1763
10000,3,8785.0,3386,135.44,1215,8785
20000,3,17569.0,6722,268.88,2431,17569
40000,3,35140.0,13345,533.8,4860,35140
60000,3,52712.0,20020,800.8,7288,52712
80000,3,70114.0,26717,1068.68,9886,70114
100000,3,87689.0,33408,1336.32,12311,87689
200000,3,175246.0,66576,2663.04,24754,175246
400000,3,350623.0,133354,5334.16,49377,350623
600000,3,525677.0,200094,8003.76,74323,525677
800000,3,701027.0,266845,10673.8,98973,701027
1000000,3,876243.0,333602,13344.08,123757,876243
2,4,2.0,2,0.08,0,2
3,4,3.0,3,0.12,0,3
100,4,85.0,84,3.36,15,85
200,4,173.0,168,6.72,27,173
2000,4,1752.0,773,30.92,248,1752
10000,4,8784.0,3483,139.32,1216,8784
20000,4,17534.0,6840,273.6,2466,17534
40000,4,35024.0,13583,543.32,4976,35024
60000,4,52462.0,20267,810.68,7538,52462
80000,4,69974.0,26916,1076.64,10026,69974
100000,4,87473.0,33582,1343.28,12527,87473
200000,4,175045.0,66881,2675.24,24955,175045
400000,4,350299.0,133712,5348.48,49701,350299
600000,4,525755.0,200273,8010.92,74245,525755
800000,4,700952.0,266846,10673.84,99048,700952
1000000,4,876210.0,333694,13347.76,123790,876210
2,5,2.0,2,0.08,0,2
3,5,3.0,3,0.12,0,3
100,5,85.0,82,3.28,15,85
200,5,173.0,158,6.32,27,173
2000,5,1740.0,1110,44.4,260,1740
10000,5,8766.0,3832,153.28,1234,8766
20000,5,17539.0,7157,286.28,2461,17539
40000,5,35079.0,13701,548.04,4921,35079
60000,5,52595.0,20412,816.48,7405,52595
80000,5,70100.0,27112,1084.48,9900,70100
100000,5,87735.0,33641,1345.64,12265,87735
200000,5,175237.0,67013,2680.52,24763,175237
400000,5,350491.0,133304,5332.16,49509,350491
600000,5,525825.0,199890,7995.6,74175,525825
800000,5,701307.0,266398,10655.92,98693,701307
1000000,5,876752.0,333094,13323.76,123248,876752
2,6,2.0,2,0.08,0,2
3,6,3.0,3,0.12,0,3
100,6,83.0,46,1.84,17,83
200,6,173.0,88,3.52,27,173
2000,6,1759.0,753,30.12,241,1759
10000,6,8792.0,3361,134.44,1208,8792
20000,6,17508.0,6639,265.56,2492,17508
40000,6,34992.0,13391,535.64,5008,34992
60000,6,52368.0,20120,804.8,7632,52368
80000,6,69915.0,26762,1070.48,10085,69915
100000,6,87524.0,33393,1335.72,12476,87524
200000,6,175186.0,66819,2672.76,24814,175186
400000,6,350378.0,133844,5353.76,49622,350378
600000,6,525831.0,200391,8015.64,74169,525831
800000,6,701083.0,267187,10687.48,98917,701083
1000000,6,876444.0,334022,13360.88,123556,876444
2,7,1.0,1,0.04,1,1
3,7,2.0,2,0.08,1,2
100,7,86.0,36,1.44,14,86
200,7,176.0,115,4.6,24,176
2000,7,1754.0,858,34.32,246,1754
10000,7,8786.0,3405,136.2,1214,8786
20000,7,17513.0,6773,270.92,2487,17513
40000,7,35046.0,13349,533.96,4954,35046
60000,7,52533.0,20109,804.36,7467,52533
80000,7,70044.0,26746,1069.84,9956,70044
100000,7,87665.0,33466,1338.64,12335,87665
200000,7,175394.0,66624,2664.96,24606,175394
400000,7,350749.0,133187,5327.48,49251,350749
600000,7,526095.0,199904,7996.16,73905,526095
800000,7,701604.0,266550,10662.0,98396,701604
1000000,7,876804.0,333111,13324.44,123196,876804
2,8,2.0,1,0.04,0,2
3,8,3.0,2,0.08,0,3
100,8,80.0,81,3.24,20,80
200,8,165.0,152,6.08,35,165
2000,8,1731.0,850,34.0,269,1731
10000,8,8751.0,3482,139.28,1249,8751
20000,8,17499.0,6791,271.64,2501,17499
40000,8,35095.0,13418,536.72,4905,35095
60000,8,52589.0,20051,802.04,7411,52589
80000,8,70146.0,26694,1067.76,9854,70146
100000,8,87711.0,33350,1334.0,12289,87711
200000,8,175426.0,66666,2666.64,24574,175426
400000,8,350814.0,133649,5345.96,49186,350814
600000,8,526200.0,200609,8024.36,73800,526200
800000,8,701438.0,267051,10682.04,98562,701438
1000000,8,876817.0,333537,13341.48,123183,876817
2,9,2.0,2,0.08,0,2
3,9,3.0,3,0.12,0,3
100,9,92.0,47,1.88,8,92
200,9,178.0,76,3.04,22,178
2000,9,1758.0,685,27.4,242,1758
10000,9,8737.0,3349,133.96,1263,8737
20000,9,17512.0,6692,267.68,2488,17512
40000,9,35025.0,13425,537.0,4975,35025
60000,9,52472.0,20147,805.88,7528,52472
80000,9,70019.0,26805,1072.2,9981,70019
100000,9,87581.0,33467,1338.68,12419,87581
200000,9,175148.0,66874,2674.96,24852,175148
400000,9,350329.0,133652,5346.08,49671,350329
600000,9,525639.0,200118,8004.72,74361,525639
800000,9,701109.0,266561,10662.44,98891,701109
1000000,9,876467.0,333258,13330.32,123533,876467
2,10,2.0,0,0.0,0,2
3,10,3.0,0,0.0,0,3
100,10,80.0,39,1.56,20,80
200,10,170.0,64,2.56,30,170
2000,10,1745.0,779,31.16,255,1745
10000,10,8733.0,3476,139.04,1267,8733
20000,10,17474.0,6791,271.64,2526,17474
40000,10,34968.0,13379,535.16,5032,34968
60000,10,52550.0,20028,801.12,7450,52550
80000,10,70098.0,26763,1070.52,9902,70098
100000,10,87640.0,33437,1337.48,12360,87640
200000,10,175477.0,66620,2664.8,24523,175477
400000,10,350818.0,133425,5337.0,49182,350818
600000,10,526092.0,200118,8004.72,73908,526092
800000,10,701470.0,266774,10670.96,98530,701470
1000000,10,876969.0,333078,13323.12,123031,876969
2,11,2.0,2,0.08,0,2
3,11,3.0,3,0.12,0,3
100,11,93.0,42,1.68,7,93
200,11,174.0,76,3.04,26,174
2000,11,1747.0,711,28.44,253,1747
10000,11,8767.0,3353,134.12,1233,8767
20000,11,17557.0,6749,269.96,2443,17557
40000,11,35117.0,13419,536.76,4883,35117
60000,11,52663.0,20047,801.88,7337,52663
80000,11,70141.0,26607,1064.28,9859,70141
100000,11,87650.0,33271,1330.84,12350,87650
200000,11,175472.0,66517,2660.68,24528,175472
400000,11,351109.0,132995,5319.8,48891,351109
600000,11,526612.0,199447,7977.88,73388,526612
800000,11,702019.0,266151,10646.04,97981,702019
1000000,11,877401.0,332973,13318.92,122599,877401
2,12,2.0,0,0.0,0,2
3,12,3.0,0,0.0,0,3
100,12,86.0,51,2.04,14,86
200,12,175.0,134,5.36,25,175
2000,12,1754.0,959,38.36,246,1754
10000,12,8745.0,3634,145.36,1255,8745
20000,12,17469.0,6973,278.92,2531,17469
40000,12,34938.0,13626,545.04,5062,34938
60000,12,52493.0,20219,808.76,7507,52493
80000,12,69953.0,26876,1075.04,10047,69953
100000,12,87596.0,33483,1339.32,12404,87596
200000,12,175425.0,66443,2657.72,24575,175425
400000,12,350862.0,132991,5319.64,49138,350862
600000,12,526277.0,199617,7984.68,73723,526277
800000,12,701570.0,266072,10642.88,98430,701570
1000000,12,876757.0,332960,13318.4,123243,876757
2,13,2.0,2,0.08,0,2
3,13,3.0,3,0.12,0,3
100,13,80.0,74,2.96,20,80
200,13,167.0,155,6.2,33,167
2000,13,1739.0,849,33.96,261,1739
10000,13,8764.0,3537,141.48,1236,8764
20000,13,17506.0,6784,271.36,2494,17506
40000,13,35022.0,13399,535.96,4978,35022
60000,13,52509.0,19956,798.24,7491,52509
80000,13,70053.0,26543,1061.72,9947,70053
100000,13,87636.0,33179,1327.16,12364,87636
200000,13,175287.0,66357,2654.28,24713,175287
400000,13,350290.0,133440,5337.6,49710,350290
600000,13,525675.0,199742,7989.68,74325,525675
800000,13,701094.0,266396,10655.84,98906,701094
1000000,13,876455.0,333227,13329.08,123545,876455
2,14,2.0,2,0.08,0,2
3,14,3.0,3,0.12,0,3
100,14,90.0,30,1.2,10,90
200,14,175.0,73,2.92,25,175
2000,14,1755.0,673,26.92,245,1755
10000,14,8758.0,3349,133.96,1242,8758
20000,14,17531.0,6637,265.48,2469,17531
40000,14,35131.0,13200,528.0,4869,35131
60000,14,52632.0,19830,793.2,7368,52632
80000,14,70174.0,26507,1060.28,9826,70174
100000,14,87713.0,33182,1327.28,12287,87713
200000,14,175334.0,66710,2668.4,24666,175334
400000,14,350464.0,133471,5338.84,49536,350464
600000,14,525619.0,199928,7997.12,74381,525619
800000,14,700802.0,266705,10668.2,99198,700802
1000000,14,876010.0,333461,13338.44,123990,876010
2,15,2.0,0,0.0,0,2
3,15,3.0,0,0.0,0,3
100,15,83.0,77,3.08,17,83
200,15,169.0,123,4.92,31,169
2000,15,1739.0,736,29.44,261,1739
10000,15,8724.0,3423,136.92,1276,8724
20000,15,17498.0,6690,267.6,2502,17498
40000,15,35116.0,13410,536.4,4884,35116
60000,15,52630.0,20035,801.4,7370,52630
80000,15,70113.0,26732,1069.28,9887,70113
100000,15,87618.0,33280,1331.2,12382,87618
200000,15,175271.0,66470,2658.8,24729,175271
400000,15,350470.0,132918,5316.72,49530,350470
600000,15,525783.0,199286,7971.44,74217,525783
800000,15,701321.0,265986,10639.44,98679,701321
1000000,15,876470.0,332803,13312.12,123530,876470
2,16,2.0,2,0.08,0,2
3,16,3.0,3,0.12,0,3
100,16,91.0,90,3.6,9,91
200,16,173.0,174,6.96,27,173
2000,16,1730.0,1384,55.36,270,1730
10000,16,8752.0,4053,162.12,1248,8752
20000,16,17476.0,7498,299.92,2524,17476
40000,16,34992.0,14148,565.92,5008,34992
60000,16,52465.0,20859,834.36,7535,52465
80000,16,69965.0,27548,1101.92,10035,69965
100000,16,87465.0,34220,1368.8,12535,87465
200000,16,175112.0,67357,2694.28,24888,175112
400000,16,350470.0,134119,5364.76,49530,350470
600000,16,525550.0,200876,8035.04,74450,525550
800000,16,700782.0,267553,10702.12,99218,700782
1000000,16,876069.0,333893,13355.72,123931,876069
2,17,1.0,2,0.08,1,1
3,17,2.0,3,0.12,1,2
100,17,91.0,47,1.88,9,91
200,17,174.0,83,3.32,26,174
2000,17,1764.0,716,28.64,236,1764
10000,17,8787.0,3354,134.16,1213,8787
20000,17,17528.0,6679,267.16,2472,17528
40000,17,34990.0,13339,533.56,5010,34990
60000,17,52572.0,19938,797.52,7428,52572
80000,17,70140.0,26503,1060.12,9860,70140
100000,17,87649.0,33307,1332.28,12351,87649
200000,17,175275.0,66435,2657.4,24725,175275
400000,17,350673.0,133165,5326.6,49327,350673
600000,17,526085.0,199925,7997.0,73915,526085
800000,17,701461.0,266810,10672.4,98539,701461
1000000,17,876559.0,333073,13322.92,123441,876559
2,18,2.0,2,0.08,0,2
3,18,2.0,3,0.12,1,2
100,18,90.0,50,2.0,10,90
200,18,176.0,81,3.24,24,176
2000,18,1738.0,684,27.36,262,1738
10000,18,8772.0,3312,132.48,1228,8772
20000,18,17513.0,6637,265.48,2487,17513
40000,18,34991.0,13272,530.88,5009,34991
60000,18,52515.0,19929,797.16,7485,52515
80000,18,70002.0,26641,1065.64,9998,70002
100000,18,87546.0,33233,1329.32,12454,87546
200000,18,175093.0,66548,2661.92,24907,175093
400000,18,350516.0,132741,5309.64,49484,350516
600000,18,526084.0,199158,7966.32,73916,526084
800000,18,701574.0,265688,10627.52,98426,701574
1000000,18,876787.0,332533,13301.32,123213,876787
2,19,1.0,2,0.08,1,1
3,19,2.0,3,0.12,1,2
100,19,90.0,42,1.68,10,90
200,19,177.0,98,3.92,23,177
2000,19,1758.0,709,28.36,242,1758
10000,19,8780.0,3312,132.48,1220,8780
20000,19,17587.0,6650,266.0,2413,17587
40000,19,35081.0,13319,532.76,4919,35081
60000,19,52581.0,19899,795.96,7419,52581
80000,19,70079.0,26455,1058.2,9921,70079
100000,19,87655.0,33122,1324.88,12345,87655
200000,19,175569.0,66556,2662.24,24431,175569
400000,19,350868.0,133030,5321.2,49132,350868
600000,19,526052.0,199750,7990.0,73948,526052
800000,19,701308.0,266622,10664.88,98692,701308
1000000,19,876778.0,333515,13340.6,123222,876778
2,20,1.0,2,0.08,1,1
3,20,2.0,3,0.12,1,2
100,20,91.0,41,1.64,9,91
200,20,175.0,73,2.92,25,175
2000,20,1736.0,700,28.0,264,1736
10000,20,8736.0,3354,134.16,1264,8736
20000,20,17500.0,6647,265.88,2500,17500
40000,20,34936.0,13372,534.88,5064,34936
60000,20,52476.0,20019,800.76,7524,52476
80000,20,69986.0,26635,1065.4,10014,69986
100000,20,87524.0,33182,1327.28,12476,87524
200000,20,175084.0,66680,2667.2,24916,175084
400000,20,350563.0,133345,5333.8,49437,350563
600000,20,525900.0,199934,7997.36,74100,525900
800000,20,701145.0,266535,10661.4,98855,701145
1000000,20,876264.0,333157,13326.28,123736,876264
2,21,2.0,2,0.08,0,2
3,21,3.0,3,0.12,0,3
100,21,92.0,46,1.84,8,92
200,21,180.0,110,4.4,20,180
2000,21,1746.0,796,31.84,254,1746
10000,21,8765.0,3422,136.88,1235,8765
20000,21,17534.0,6743,269.72,2466,17534
40000,21,35111.0,13332,533.28,4889,35111
60000,21,52624.0,20042,801.68,7376,52624
80000,21,70113.0,26648,1065.92,9887,70113
100000,21,87586.0,33357,1334.28,12414,87586
200000,21,175275.0,66804,2672.16,24725,175275
400000,21,350751.0,133125,5325.0,49249,350751
600000,21,526100.0,199906,7996.24,73900,526100
800000,21,701594.0,266552,10662.08,98406,701594
1000000,21,876874.0,333385,13335.4,123126,876874
2,22,1.0,2,0.08,1,1
3,22,2.0,3,0.12,1,2
100,22,83.0,88,3.52,17,83
200,22,166.0,169,6.76,34,166
2000,22,1733.0,806,32.24,267,1733
10000,22,8778.0,3457,138.28,1222,8778
20000,22,17567.0,6776,271.04,2433,17567
40000,22,35007.0,13598,543.92,4993,35007
60000,22,52594.0,20170,806.8,7406,52594
80000,22,70178.0,26812,1072.48,9822,70178
100000,22,87722.0,33480,1339.2,12278,87722
200000,22,175506.0,66842,2673.68,24494,175506
400000,22,350685.0,133766,5350.64,49315,350685
600000,22,525766.0,200575,8023.0,74234,525766
800000,22,701227.0,267425,10697.0,98773,701227
1000000,22,876590.0,334412,13376.48,123410,876590
2,23,2.0,2,0.08,0,2
3,23,2.0,3,0.12,1,2
100,23,90.0,69,2.76,10,90
200,23,181.0,104,4.16,19,181
2000,23,1757.0,691,27.64,243,1757
10000,23,8781.0,3307,132.28,1219,8781
20000,23,17525.0,6586,263.44,2475,17525
40000,23,35001.0,13238,529.52,4999,35001
60000,23,52594.0,19927,797.08,7406,52594
80000,23,70086.0,26660,1066.4,9914,70086
100000,23,87642.0,33265,1330.6,12358,87642
200000,23,175194.0,66443,2657.72,24806,175194
400000,23,350444.0,133281,5331.24,49556,350444
600000,23,525748.0,199902,7996.08,74252,525748
800000,23,701263.0,266454,10658.16,98737,701263
1000000,23,876740.0,332998,13319.92,123260,876740
2,24,2.0,2,0.08,0,2
3,24,3.0,3,0.12,0,3
100,24,88.0,55,2.2,12,88
200,24,180.0,134,5.36,20,180
2000,24,1742.0,943,37.72,258,1742
10000,24,8768.0,3674,146.96,1232,8768
20000,24,17554.0,6954,278.16,2446,17554
40000,24,35161.0,13648,545.92,4839,35161
60000,24,52653.0,20316,812.64,7347,52653
80000,24,70186.0,26965,1078.6,9814,70186
100000,24,87723.0,33678,1347.12,12277,87723
200000,24,175197.0,66998,2679.92,24803,175197
400000,24,350449.0,133580,5343.2,49551,350449
600000,24,525665.0,200104,8004.16,74335,525665
800000,24,701070.0,266596,10663.84,98930,701070
1000000,24,876325.0,333202,13328.08,123675,876325
2,25,1.0,2,0.08,1,1
3,25,1.0,3,0.12,2,1
100,25,89.0,84,3.36,11,89
200,25,176.0,165,6.6,24,176
2000,25,1737.0,817,32.68,263,1737
10000,25,8818.0,3518,140.72,1182,8818
20000,25,17611.0,6972,278.88,2389,17611
40000,25,35168.0,13602,544.08,4832,35168
60000,25,52646.0,20304,812.16,7354,52646
80000,25,70214.0,27053,1082.12,9786,70214
100000,25,87852.0,33640,1345.6,12148,87852
200000,25,175330.0,67208,2688.32,24670,175330
400000,25,350735.0,134055,5362.2,49265,350735
600000,25,526237.0,200382,8015.28,73763,526237
800000,25,701540.0,266742,10669.68,98460,701540
1000000,25,876829.0,333309,13332.36,123171,876829
2,26,2.0,2,0.08,0,2
3,26,3.0,3,0.12,0,3
100,26,91.0,81,3.24,9,91
200,26,169.0,144,5.76,31,169
2000,26,1727.0,769,30.76,273,1727
10000,26,8720.0,3409,136.36,1280,8720
20000,26,17486.0,6806,272.24,2514,17486
40000,26,35069.0,13433,537.32,4931,35069
60000,26,52609.0,20111,804.44,7391,52609
80000,26,70198.0,26855,1074.2,9802,70198
100000,26,87753.0,33498,1339.92,12247,87753
200000,26,175337.0,66707,2668.28,24663,175337
400000,26,350285.0,133321,5332.84,49715,350285
600000,26,525860.0,199936,7997.44,74140,525860
800000,26,701134.0,266732,10669.28,98866,701134
1000000,26,876215.0,333466,13338.64,123785,876215
2,27,2.0,1,0.04,0,2
3,27,3.0,2,0.08,0,3
100,27,89.0,79,3.16,11,89
200,27,177.0,159,6.36,23,177
2000,27,1732.0,830,33.2,268,1732
10000,27,8759.0,3543,141.72,1241,8759
20000,27,17508.0,6925,277.0,2492,17508
40000,27,35024.0,13654,546.16,4976,35024
60000,27,52557.0,20205,808.2,7443,52557
80000,27,70075.0,26890,1075.6,9925,70075
100000,27,87648.0,33633,1345.32,12352,87648
200000,27,175221.0,66921,2676.84,24779,175221
400000,27,350457.0,133504,5340.16,49543,350457
600000,27,525840.0,200383,8015.32,74160,525840
800000,27,701185.0,266915,10676.6,98815,701185
1000000,27,876555.0,333526,13341.04,123445,876555
2,28,2.0,0,0.0,0,2
3,28,3.0,1,0.04,0,3
100,28,82.0,81,3.24,18,82
200,28,172.0,169,6.76,28,172
2000,28,1737.0,902,36.08,263,1737
10000,28,8753.0,3631,145.24,1247,8753
20000,28,17473.0,6838,273.52,2527,17473
40000,28,35016.0,13454,538.16,4984,35016
60000,28,52543.0,20079,803.16,7457,52543
80000,28,70008.0,26744,1069.76,9992,70008
100000,28,87523.0,33349,1333.96,12477,87523
200000,28,175214.0,66852,2674.08,24786,175214
400000,28,350349.0,133500,5340.0,49651,350349
600000,28,525802.0,200049,8001.96,74198,525802
800000,28,700952.0,266778,10671.12,99048,700952
1000000,28,876090.0,333532,13341.28,123910,876090
2,29,2.0,2,0.08,0,2
3,29,3.0,3,0.12,0,3
100,29,86.0,76,3.04,14,86
200,29,173.0,151,6.04,27,173
2000,29,1740.0,784,31.36,260,1740
10000,29,8783.0,3532,141.28,1217,8783
20000,29,17538.0,6871,274.84,2462,17538
40000,29,35070.0,13637,545.48,4930,35070
60000,29,52601.0,20378,815.12,7399,52601
80000,29,70130.0,26828,1073.12,9870,70130
100000,29,87638.0,33518,1340.72,12362,87638
200000,29,175333.0,66864,2674.56,24667,175333
400000,29,350655.0,133806,5352.24,49345,350655
600000,29,525608.0,200472,8018.88,74392,525608
800000,29,700908.0,267209,10688.36,99092,700908
1000000,29,876482.0,333793,13351.72,123518,876482
2,30,1.0,2,0.08,1,1
3,30,2.0,3,0.12,1,2
100,30,85.0,64,2.56,15,85
200,30,171.0,99,3.96,29,171
2000,30,1749.0,682,27.28,251,1749
10000,30,8786.0,3389,135.56,1214,8786
20000,30,17502.0,6636,265.44,2498,17502
40000,30,35100.0,13192,527.68,4900,35100
60000,30,52654.0,19855,794.2,7346,52654
80000,30,70190.0,26547,1061.88,9810,70190
100000,30,87718.0,33152,1326.08,12282,87718
200000,30,175411.0,66550,2662.0,24589,175411
400000,30,350661.0,132956,5318.24,49339,350661
600000,30,526102.0,199522,7980.88,73898,526102
800000,30,701725.0,266499,10659.96,98275,701725
1000000,30,877004.0,332795,13311.8,122996,877004
2,31,1.0,1,0.04,1,1
3,31,2.0,2,0.08,1,2
100,31,81.0,85,3.4,19,81
200,31,169.0,120,4.8,31,169
2000,31,1741.0,751,30.04,259,1741
10000,31,8735.0,3439,137.56,1265,8735
20000,31,17526.0,6752,270.08,2474,17526
40000,31,35041.0,13532,541.28,4959,35041
60000,31,52633.0,20108,804.32,7367,52633
80000,31,70256.0,26814,1072.56,9744,70256
100000,31,87882.0,33461,1338.44,12118,87882
200000,31,175612.0,66831,2673.24,24388,175612
400000,31,351126.0,133484,5339.36,48874,351126
600000,31,526341.0,200167,8006.68,73659,526341
800000,31,701769.0,266788,10671.52,98231,701769
1000000,31,877134.0,333747,13349.88,122866,877134
2,32,2.0,2,0.08,0,2
3,32,3.0,3,0.12,0,3
100,32,85.0,53,2.12,15,85
200,32,172.0,108,4.32,28,172
2000,32,1716.0,1186,47.44,284,1716
10000,32,8736.0,3815,152.6,1264,8736
20000,32,17508.0,7166,286.64,2492,17508
40000,32,35032.0,13833,553.32,4968,35032
60000,32,52544.0,20511,820.44,7456,52544
80000,32,70012.0,27227,1089.08,9988,70012
100000,32,87510.0,33899,1355.96,12490,87510
200000,32,175132.0,67083,2683.32,24868,175132
400000,32,350547.0,133581,5343.24,49453,350547
600000,32,525870.0,200420,8016.8,74130,525870
800000,32,701186.0,266963,10678.52,98814,701186
1000000,32,876622.0,333822,13352.88,123378,876622
2,33,1.0,2,0.08,1,1
3,33,1.0,3,0.12,2,1
100,33,85.0,76,3.04,15,85
200,33,174.0,104,4.16,26,174
2000,33,1749.0,676,27.04,251,1749
10000,33,8755.0,3343,133.72,1245,8755
20000,33,17522.0,6684,267.36,2478,17522
40000,33,35027.0,13355,534.2,4973,35027
60000,33,52537.0,20003,800.12,7463,52537
80000,33,69950.0,26725,1069.0,10050,69950
100000,33,87420.0,33477,1339.08,12580,87420
200000,33,175059.0,66732,2669.28,24941,175059
400000,33,350345.0,133702,5348.08,49655,350345
600000,33,525799.0,200680,8027.2,74201,525799
800000,33,701379.0,267342,10693.68,98621,701379
1000000,33,876431.0,334055,13362.2,123569,876431
2,34,2.0,1,0.04,0,2
3,34,3.0,2,0.08,0,3
100,34,88.0,38,1.52,12,88
200,34,172.0,87,3.48,28,172
2000,34,1755.0,695,27.8,245,1755
10000,34,8777.0,3338,133.52,1223,8777
20000,34,17511.0,6718,268.72,2489,17511
40000,34,35000.0,13505,540.2,5000,35000
60000,34,52574.0,20167,806.68,7426,52574
80000,34,70076.0,26790,1071.6,9924,70076
100000,34,87596.0,33546,1341.84,12404,87596
200000,34,175209.0,67055,2682.2,24791,175209
400000,34,350741.0,133891,5355.64,49259,350741
600000,34,526062.0,200716,8028.64,73938,526062
800000,34,701406.0,267281,10691.24,98594,701406
1000000,34,876648.0,334053,13362.12,123352,876648
2,35,2.0,2,0.08,0,2
3,35,3.0,3,0.12,0,3
100,35,86.0,82,3.28,14,86
200,35,180.0,160,6.4,20,180
2000,35,1742.0,852,34.08,258,1742
10000,35,8771.0,3507,140.28,1229,8771
20000,35,17506.0,6866,274.64,2494,17506
40000,35,34991.0,13660,546.4,5009,34991
60000,35,52555.0,20340,813.6,7445,52555
80000,35,70165.0,26934,1077.36,9835,70165
100000,35,87621.0,33671,1346.84,12379,87621
200000,35,175300.0,67098,2683.92,24700,175300
400000,35,350920.0,133855,5354.2,49080,350920
600000,35,526184.0,200773,8030.92,73816,526184
800000,35,701672.0,267640,10705.6,98328,701672
1000000,35,876909.0,333939,13357.56,123091,876909
2,36,2.0,0,0.0,0,2
3,36,3.0,0,0.0,0,3
100,36,85.0,79,3.16,15,85
200,36,172.0,149,5.96,28,172
2000,36,1741.0,1080,43.2,259,1741
10000,36,8766.0,3684,147.36,1234,8766
20000,36,17505.0,6927,277.08,2495,17505
40000,36,35060.0,13599,543.96,4940,35060
60000,36,52569.0,20271,810.84,7431,52569
80000,36,70055.0,26944,1077.76,9945,70055
100000,36,87591.0,33532,1341.28,12409,87591
200000,36,175141.0,66779,2671.16,24859,175141
400000,36,350314.0,133751,5350.04,49686,350314
600000,36,525607.0,200428,8017.12,74393,525607
800000,36,700919.0,267285,10691.4,99081,700919
1000000,36,876182.0,334013,13360.52,123818,876182
2,37,2.0,1,0.04,0,2
3,37,3.0,2,0.08,0,3
100,37,89.0,78,3.12,11,89
200,37,177.0,103,4.12,23,177
2000,37,1753.0,777,31.08,247,1753
10000,37,8759.0,3481,139.24,1241,8759
20000,37,17499.0,6893,275.72,2501,17499
40000,37,35031.0,13585,543.4,4969,35031
60000,37,52565.0,20247,809.88,7435,52565
80000,37,70119.0,26908,1076.32,9881,70119
100000,37,87683.0,33591,1343.64,12317,87683
200000,37,175310.0,66889,2675.56,24690,175310
400000,37,350806.0,133400,5336.0,49194,350806
600000,37,526147.0,200035,8001.4,73853,526147
800000,37,701632.0,266734,10669.36,98368,701632
1000000,37,877069.0,333236,13329.44,122931,877069
2,38,2.0,2,0.08,0,2
3,38,3.0,2,0.08,0,3
100,38,88.0,37,1.48,12,88
200,38,177.0,68,2.72,23,177
2000,38,1753.0,638,25.52,247,1753
10000,38,8794.0,3312,132.48,1206,8794
20000,38,17567.0,6745,269.8,2433,17567
40000,38,35134.0,13465,538.6,4866,35134
60000,38,52651.0,20170,806.8,7349,52651
80000,38,70123.0,26853,1074.12,9877,70123
100000,38,87754.0,33481,1339.24,12246,87754
200000,38,175424.0,66734,2669.36,24576,175424
400000,38,350758.0,133330,5333.2,49242,350758
600000,38,526030.0,199510,7980.4,73970,526030
800000,38,701204.0,266026,10641.04,98796,701204
1000000,38,876532.0,332913,13316.52,123468,876532
2,39,2.0,2,0.08,0,2
3,39,3.0,3,0.12,0,3
100,39,87.0,69,2.76,13,87
200,39,171.0,131,5.24,29,171
2000,39,1744.0,745,29.8,256,1744
10000,39,8749.0,3445,137.8,1251,8749
20000,39,17472.0,6730,269.2,2528,17472
40000,39,34982.0,13368,534.72,5018,34982
60000,39,52541.0,20079,803.16,7459,52541
80000,39,70183.0,26664,1066.56,9817,70183
100000,39,87620.0,33221,1328.84,12380,87620
200000,39,175338.0,66588,2663.52,24662,175338
400000,39,350745.0,133409,5336.36,49255,350745
600000,39,525963.0,200009,8000.36,74037,525963
800000,39,701340.0,266734,10669.36,98660,701340
1000000,39,876799.0,332961,13318.44,123201,876799
2,40,2.0,0,0.0,0,2
3,40,3.0,0,0.0,0,3
100,40,88.0,34,1.36,12,88
200,40,179.0,75,3.0,21,179
2000,40,1750.0,712,28.48,250,1750
10000,40,8775.0,3411,136.44,1225,8775
20000,40,17531.0,6784,271.36,2469,17531
40000,40,35061.0,13525,541.0,4939,35061
60000,40,52602.0,20321,812.84,7398,52602
80000,40,70091.0,26994,1079.76,9909,70091
100000,40,87625.0,33630,1345.2,12375,87625
200000,40,175385.0,66958,2678.32,24615,175385
400000,40,350708.0,133397,5335.88,49292,350708
600000,40,526298.0,200205,8008.2,73702,526298
800000,40,701846.0,267127,10685.08,98154,701846
1000000,40,877639.0,333658,13346.32,122361,877639
2,41,2.0,2,0.08,0,2
3,41,2.0,3,0.12,1,2
100,41,89.0,39,1.56,11,89
200,41,177.0,94,3.76,23,177
2000,41,1748.0,780,31.2,252,1748
10000,41,8750.0,3416,136.64,1250,8750
20000,41,17502.0,6773,270.92,2498,17502
40000,41,35063.0,13419,536.76,4937,35063
60000,41,52601.0,20071,802.84,7399,52601
80000,41,70174.0,26685,1067.4,9826,70174
100000,41,87737.0,33399,1335.96,12263,87737
200000,41,175478.0,66820,2672.8,24522,175478
400000,41,350905.0,133773,5350.92,49095,350905
600000,41,526129.0,200458,8018.32,73871,526129
800000,41,701483.0,266846,10673.84,98517,701483
1000000,41,876628.0,333454,13338.16,123372,876628
2,42,2.0,1,0.04,0,2
3,42,3.0,2,0.08,0,3
100,42,84.0,69,2.76,16,84
200,42,169.0,157,6.28,31,169
2000,42,1721.0,1372,54.88,279,1721
10000,42,8731.0,4100,164.0,1269,8731
20000,42,17515.0,7507,300.28,2485,17515
40000,42,35080.0,14213,568.52,4920,35080
60000,42,52636.0,20815,832.6,7364,52636
80000,42,70131.0,27450,1098.0,9869,70131
100000,42,87536.0,34061,1362.44,12464,87536
200000,42,175109.0,67446,2697.84,24891,175109
400000,42,350341.0,133849,5353.96,49659,350341
600000,42,525806.0,200454,8018.16,74194,525806
800000,42,701111.0,266682,10667.28,98889,701111
1000000,42,876681.0,333018,13320.72,123319,876681
2,43,2.0,2,0.08,0,2
3,43,3.0,3,0.12,0,3
100,43,91.0,60,2.4,9,91
200,43,178.0,89,3.56,22,178
2000,43,1737.0,910,36.4,263,1737
10000,43,8791.0,3794,151.76,1209,8791
20000,43,17541.0,7026,281.04,2459,17541
40000,43,35119.0,13694,547.76,4881,35119
60000,43,52667.0,20273,810.92,7333,52667
80000,43,70242.0,27048,1081.92,9758,70242
100000,43,87873.0,33720,1348.8,12127,87873
200000,43,175417.0,67072,2682.88,24583,175417
400000,43,350482.0,133594,5343.76,49518,350482
600000,43,525812.0,200406,8016.24,74188,525812
800000,43,700998.0,266983,10679.32,99002,700998
1000000,43,876304.0,333852,13354.08,123696,876304
2,44,2.0,2,0.08,0,2
3,44,3.0,3,0.12,0,3
100,44,78.0,58,2.32,22,78
200,44,166.0,143,5.72,34,166
2000,44,1700.0,1653,66.12,300,1700
10000,44,8640.0,4643,185.72,1360,8640
20000,44,17390.0,8012,320.48,2610,17390
40000,44,34933.0,14711,588.44,5067,34933
60000,44,52485.0,21421,856.84,7515,52485
80000,44,69987.0,28062,1122.48,10013,69987
100000,44,87620.0,34649,1385.96,12380,87620
200000,44,175450.0,68083,2723.32,24550,175450
400000,44,350585.0,134853,5394.12,49415,350585
600000,44,526012.0,201750,8070.0,73988,526012
800000,44,701368.0,267741,10709.64,98632,701368
1000000,44,876645.0,334467,13378.68,123355,876645
2,45,1.0,2,0.08,1,1
3,45,2.0,3,0.12,1,2
100,45,87.0,64,2.56,13,87
200,45,173.0,112,4.48,27,173
2000,45,1740.0,714,28.56,260,1740
10000,45,8736.0,3406,136.24,1264,8736
20000,45,17536.0,6733,269.32,2464,17536
40000,45,35074.0,13418,536.72,4926,35074
60000,45,52571.0,20057,802.28,7429,52571
80000,45,70146.0,26768,1070.72,9854,70146
100000,45,87726.0,33424,1336.96,12274,87726
200000,45,175261.0,66592,2663.68,24739,175261
400000,45,350853.0,133115,5324.6,49147,350853
600000,45,526283.0,199674,7986.96,73717,526283
800000,45,701512.0,266244,10649.76,98488,701512
1000000,45,876533.0,333101,13324.04,123467,876533
2,46,0.0,2,0.08,2,0
3,46,1.0,3,0.12,2,1
100,46,88.0,37,1.48,12,88
200,46,178.0,73,2.92,22,178
2000,46,1761.0,695,27.8,239,1761
10000,46,8768.0,3399,135.96,1232,8768
20000,46,17534.0,6717,268.68,2466,17534
40000,46,35081.0,13404,536.16,4919,35081
60000,46,52642.0,20199,807.96,7358,52642
80000,46,70124.0,26928,1077.12,9876,70124
100000,46,87627.0,33567,1342.68,12373,87627
200000,46,175295.0,67015,2680.6,24705,175295
400000,46,350696.0,133841,5353.64,49304,350696
600000,46,525901.0,200609,8024.36,74099,525901
800000,46,701243.0,267242,10689.68,98757,701243
1000000,46,876536.0,333967,13358.68,123464,876536
2,47,1.0,1,0.04,1,1
3,47,1.0,2,0.08,2,1
100,47,83.0,42,1.68,17,83
200,47,173.0,73,2.92,27,173
2000,47,1744.0,717,28.68,256,1744
10000,47,8781.0,3405,136.2,1219,8781
20000,47,17534.0,6752,270.08,2466,17534
40000,47,35052.0,13475,539.0,4948,35052
60000,47,52561.0,20051,802.04,7439,52561
80000,47,70073.0,26777,1071.08,9927,70073
100000,47,87568.0,33463,1338.52,12432,87568
200000,47,175126.0,66702,2668.08,24874,175126
400000,47,350789.0,133375,5335.0,49211,350789
600000,47,525987.0,200368,8014.72,74013,525987
800000,47,701504.0,267204,10688.16,98496,701504
1000000,47,876802.0,333527,13341.08,123198,876802
2,48,2.0,2,0.08,0,2
3,48,3.0,3,0.12,0,3
100,48,89.0,44,1.76,11,89
200,48,170.0,126,5.04,30,170
2000,48,1744.0,705,28.2,256,1744
10000,48,8747.0,3332,133.28,1253,8747
20000,48,17535.0,6677,267.08,2465,17535
40000,48,34933.0,13349,533.96,5067,34933
60000,48,52410.0,20116,804.64,7590,52410
80000,48,69924.0,26877,1075.08,10076,69924
100000,48,87431.0,33558,1342.32,12569,87431
200000,48,175020.0,66900,2676.0,24980,175020
400000,48,350338.0,133373,5334.92,49662,350338
600000,48,525775.0,200142,8005.68,74225,525775
800000,48,701019.0,267152,10686.08,98981,701019
1000000,48,876261.0,334080,13363.2,123739,876261
2,49,2.0,2,0.08,0,2
3,49,3.0,3,0.12,0,3
100,49,87.0,83,3.32,13,87
200,49,170.0,165,6.6,30,170
2000,49,1733.0,854,34.16,267,1733
10000,49,8772.0,3512,140.48,1228,8772
20000,49,17486.0,6983,279.32,2514,17486
40000,49,35048.0,13530,541.2,4952,35048
60000,49,52575.0,20193,807.72,7425,52575
80000,49,70070.0,26796,1071.84,9930,70070
100000,49,87579.0,33401,1336.04,12421,87579
200000,49,175397.0,66766,2670.64,24603,175397
400000,49,350621.0,133244,5329.76,49379,350621
600000,49,526012.0,199621,7984.84,73988,526012
800000,49,701255.0,266349,10653.96,98745,701255
1000000,49,876704.0,332964,13318.56,123296,876704
2,50,2.0,0,0.0,0,2
3,50,3.0,1,0.04,0,3
100,50,92.0,78,3.12,8,92
200,50,183.0,162,6.48,17,183
2000,50,1748.0,969,38.76,252,1748
10000,50,8746.0,3533,141.32,1254,8746
20000,50,17512.0,6762,270.48,2488,17512
40000,50,35036.0,13504,540.16,4964,35036
60000,50,52571.0,20299,811.96,7429,52571
80000,50,70122.0,26961,1078.44,9878,70122
100000,50,87582.0,33698,1347.92,12418,87582
200000,50,175245.0,67022,2680.88,24755,175245
400000,50,350542.0,134050,5362.0,49458,350542
600000,50,525717.0,200896,8035.84,74283,525717
800000,50,701501.0,267385,10695.4,98499,701501
1000000,50,876927.0,333895,13355.8,123073,876927
2,51,2.0,0,0.0,0,2
3,51,3.0,1,0.04,0,3
100,51,84.0,58,2.32,16,84
200,51,173.0,136,5.44,27,173
2000,51,1741.0,1037,41.48,259,1741
10000,51,8728.0,3697,147.88,1272,8728
20000,51,17539.0,7102,284.08,2461,17539
40000,51,35086.0,13766,550.64,4914,35086
60000,51,52607.0,20444,817.76,7393,52607
80000,51,70199.0,27121,1084.84,9801,70199
100000,51,87797.0,33724,1348.96,12203,87797
200000,51,175420.0,67065,2682.6,24580,175420
400000,51,350364.0,133942,5357.68,49636,350364
600000,51,525848.0,200694,8027.76,74152,525848
800000,51,701208.0,267381,10695.24,98792,701208
1000000,51,876454.0,333853,13354.12,123546,876454
2,52,0.0,2,0.08,2,0
3,52,1.0,3,0.12,2,1
100,52,84.0,73,2.92,16,84
200,52,176.0,136,5.44,24,176
2000,52,1748.0,873,34.92,252,1748
10000,52,8728.0,3545,141.8,1272,8728
20000,52,17497.0,6983,279.32,2503,17497
40000,52,35010.0,13777,551.08,4990,35010
60000,52,52572.0,20403,816.12,7428,52572
80000,52,70031.0,27062,1082.48,9969,70031
100000,52,87570.0,33720,1348.8,12430,87570
200000,52,175352.0,66840,2673.6,24648,175352
400000,52,350693.0,133416,5336.64,49307,350693
600000,52,525842.0,200104,8004.16,74158,525842
800000,52,701245.0,267274,10690.96,98755,701245
1000000,52,876586.0,333567,13342.68,123414,876586
2,53,1.0,1,0.04,1,1
3,53,2.0,1,0.04,1,2
100,53,92.0,29,1.16,8,92
200,53,174.0,73,2.92,26,174
2000,53,1763.0,781,31.24,237,1763
10000,53,8732.0,3519,140.76,1268,8732
20000,53,17510.0,6801,272.04,2490,17510
40000,53,35056.0,13638,545.52,4944,35056
60000,53,52659.0,20249,809.96,7341,52659
80000,53,70174.0,26956,1078.24,9826,70174
100000,53,87639.0,33683,1347.32,12361,87639
200000,53,175256.0,66852,2674.08,24744,175256
400000,53,350649.0,133438,5337.52,49351,350649
600000,53,526120.0,200017,8000.68,73880,526120
800000,53,701277.0,267000,10680.0,98723,701277
1000000,53,876714.0,333657,13346.28,123286,876714
2,54,2.0,2,0.08,0,2
3,54,3.0,3,0.12,0,3
100,54,88.0,76,3.04,12,88
200,54,172.0,161,6.44,28,172
2000,54,1735.0,1288,51.52,265,1735
10000,54,8724.0,3988,159.52,1276,8724
20000,54,17475.0,7372,294.88,2525,17475
40000,54,34969.0,14090,563.6,5031,34969
60000,54,52567.0,20714,828.56,7433,52567
80000,54,70171.0,27304,1092.16,9829,70171
100000,54,87617.0,33986,1359.44,12383,87617
200000,54,175409.0,67483,2699.32,24591,175409
400000,54,350599.0,134161,5366.44,49401,350599
600000,54,525872.0,200892,8035.68,74128,525872
800000,54,701385.0,267243,10689.72,98615,701385
1000000,54,876551.0,333793,13351.72,123449,876551
2,55,2.0,2,0.08,0,2
3,55,3.0,2,0.08,0,3
100,55,89.0,81,3.24,11,89
200,55,176.0,164,6.56,24,176
2000,55,1739.0,1149,45.96,261,1739
10000,55,8761.0,3793,151.72,1239,8761
20000,55,17528.0,7134,285.36,2472,17528
40000,55,34997.0,13688,547.52,5003,34997
60000,55,52522.0,20241,809.64,7478,52522
80000,55,70030.0,26763,1070.52,9970,70030
100000,55,87573.0,33398,1335.92,12427,87573
200000,55,175239.0,66775,2671.0,24761,175239
400000,55,350426.0,132817,5312.68,49574,350426
600000,55,525716.0,199722,7988.88,74284,525716
800000,55,701503.0,266312,10652.48,98497,701503
1000000,55,876814.0,332862,13314.48,123186,876814
2,56,2.0,2,0.08,0,2
3,56,3.0,3,0.12,0,3
100,56,88.0,62,2.48,12,88
200,56,172.0,103,4.12,28,172
2000,56,1742.0,707,28.28,258,1742
10000,56,8742.0,3393,135.72,1258,8742
20000,56,17519.0,6748,269.92,2481,17519
40000,56,35098.0,13275,531.0,4902,35098
60000,56,52581.0,19879,795.16,7419,52581
80000,56,70125.0,26547,1061.88,9875,70125
100000,56,87687.0,33142,1325.68,12313,87687
200000,56,175347.0,66426,2657.04,24653,175347
400000,56,350634.0,133162,5326.48,49366,350634
600000,56,526249.0,199481,7979.24,73751,526249
800000,56,701371.0,266246,10649.84,98629,701371
1000000,56,876575.0,332831,13313.24,123425,876575
2,57,2.0,1,0.04,0,2
3,57,3.0,2,0.08,0,3
100,57,89.0,52,2.08,11,89
200,57,174.0,97,3.88,26,174
2000,57,1742.0,745,29.8,258,1742
10000,57,8764.0,3423,136.92,1236,8764
20000,57,17511.0,6734,269.36,2489,17511
40000,57,35034.0,13444,537.76,4966,35034
60000,57,52554.0,20055,802.2,7446,52554
80000,57,70059.0,26858,1074.32,9941,70059
100000,57,87681.0,33522,1340.88,12319,87681
200000,57,175395.0,66874,2674.96,24605,175395
400000,57,350886.0,133741,5349.64,49114,350886
600000,57,526085.0,200109,8004.36,73915,526085
800000,57,701452.0,266581,10663.24,98548,701452
1000000,57,876706.0,333174,13326.96,123294,876706
2,58,2.0,0,0.0,0,2
3,58,3.0,0,0.0,0,3
100,58,87.0,40,1.6,13,87
200,58,178.0,67,2.68,22,178
2000,58,1760.0,628,25.12,240,1760
10000,58,8771.0,3267,130.68,1229,8771
20000,58,17541.0,6545,261.8,2459,17541
40000,58,35122.0,13250,530.0,4878,35122
60000,58,52658.0,19972,798.88,7342,52658
80000,58,70185.0,26649,1065.96,9815,70185
100000,58,87736.0,33331,1333.24,12264,87736
200000,58,175302.0,66738,2669.52,24698,175302
400000,58,350278.0,133554,5342.16,49722,350278
600000,58,525449.0,200283,8011.32,74551,525449
800000,58,700585.0,267364,10694.56,99415,700585
1000000,58,875756.0,334321,13372.84,124244,875756
2,59,2.0,2,0.08,0,2
3,59,2.0,3,0.12,1,2
100,59,85.0,64,2.56,15,85
200,59,170.0,140,5.6,30,170
2000,59,1736.0,795,31.8,264,1736
10000,59,8745.0,3537,141.48,1255,8745
20000,59,17523.0,6856,274.24,2477,17523
40000,59,35059.0,13686,547.44,4941,35059
60000,59,52615.0,20363,814.52,7385,52615
80000,59,70158.0,26968,1078.72,9842,70158
100000,59,87747.0,33601,1344.04,12253,87747
200000,59,175355.0,67140,2685.6,24645,175355
400000,59,350691.0,134307,5372.28,49309,350691
600000,59,526102.0,201289,8051.56,73898,526102
800000,59,701529.0,268014,10720.56,98471,701529
1000000,59,876756.0,334634,13385.36,123244,876756
2,60,2.0,0,0.0,0,2
3,60,3.0,1,0.04,0,3
100,60,87.0,43,1.72,13,87
200,60,171.0,77,3.08,29,171
2000,60,1749.0,655,26.2,251,1749
10000,60,8770.0,3310,132.4,1230,8770
20000,60,17531.0,6642,265.68,2469,17531
40000,60,34996.0,13296,531.84,5004,34996
60000,60,52403.0,19890,795.6,7597,52403
80000,60,69862.0,26621,1064.84,10138,69862
100000,60,87417.0,33225,1329.0,12583,87417
200000,60,175072.0,66368,2654.72,24928,175072
400000,60,350446.0,132963,5318.52,49554,350446
600000,60,526044.0,199761,7990.44,73956,526044
800000,60,701418.0,266636,10665.44,98582,701418
1000000,60,876728.0,333085,13323.4,123272,876728
2,61,2.0,1,0.04,0,2
3,61,3.0,1,0.04,0,3
100,61,86.0,51,2.04,14,86
200,61,165.0,82,3.28,35,165
2000,61,1733.0,708,28.32,267,1733
10000,61,8775.0,3406,136.24,1225,8775
20000,61,17536.0,6727,269.08,2464,17536
40000,61,35092.0,13486,539.44,4908,35092
60000,61,52621.0,20204,808.16,7379,52621
80000,61,70080.0,26896,1075.84,9920,70080
100000,61,87609.0,33485,1339.4,12391,87609
200000,61,175230.0,66789,2671.56,24770,175230
400000,61,350552.0,133544,5341.76,49448,350552
600000,61,525771.0,199821,7992.84,74229,525771
800000,61,701330.0,266385,10655.4,98670,701330
1000000,61,876597.0,332593,13303.72,123403,876597
2,62,2.0,2,0.08,0,2
3,62,3.0,2,0.08,0,3
100,62,90.0,72,2.88,10,90
200,62,176.0,151,6.04,24,176
2000,62,1739.0,950,38.0,261,1739
10000,62,8757.0,3612,144.48,1243,8757
20000,62,17483.0,6921,276.84,2517,17483
40000,62,35060.0,13463,538.52,4940,35060
60000,62,52537.0,20194,807.76,7463,52537
80000,62,70085.0,26880,1075.2,9915,70085
100000,62,87641.0,33630,1345.2,12359,87641
200000,62,175383.0,67275,2691.0,24617,175383
400000,62,350575.0,133805,5352.2,49425,350575
600000,62,525930.0,200571,8022.84,74070,525930
800000,62,701105.0,267172,10686.88,98895,701105
1000000,62,876612.0,333847,13353.88,123388,876612
2,63,1.0,1,0.04,1,1
3,63,2.0,1,0.04,1,2
100,63,87.0,48,1.92,13,87
200,63,174.0,100,4.0,26,174
2000,63,1740.0,712,28.48,260,1740
10000,63,8805.0,3397,135.88,1195,8805
20000,63,17533.0,6753,270.12,2467,17533
40000,63,35080.0,13373,534.92,4920,35080
60000,63,52694.0,20066,802.64,7306,52694
80000,63,70176.0,26704,1068.16,9824,70176
100000,63,87698.0,33280,1331.2,12302,87698
200000,63,175393.0,66570,2662.8,24607,175393
400000,63,350724.0,133234,5329.36,49276,350724
600000,63,526144.0,199935,7997.4,73856,526144
800000,63,701359.0,266548,10661.92,98641,701359
1000000,63,876708.0,333068,13322.72,123292,876708
2,64,2.0,1,0.04,0,2
3,64,3.0,2,0.08,0,3
100,64,88.0,75,3.0,12,88
200,64,174.0,153,6.12,26,174
2000,64,1754.0,898,35.92,246,1754
10000,64,8781.0,3645,145.8,1219,8781
20000,64,17586.0,6969,278.76,2414,17586
40000,64,35119.0,13724,548.96,4881,35119
60000,64,52644.0,20418,816.72,7356,52644
80000,64,70211.0,27265,1090.6,9789,70211
100000,64,87758.0,33961,1358.44,12242,87758
200000,64,175537.0,67261,2690.44,24463,175537
400000,64,351296.0,133765,5350.6,48704,351296
600000,64,526458.0,200463,8018.52,73542,526458
800000,64,701942.0,267127,10685.08,98058,701942
1000000,64,877025.0,333392,13335.68,122975,877025
2,65,2.0,2,0.08,0,2
3,65,3.0,3,0.12,0,3
100,65,82.0,67,2.68,18,82
200,65,171.0,142,5.68,29,171
2000,65,1734.0,826,33.04,266,1734
10000,65,8754.0,3434,137.36,1246,8754
20000,65,17526.0,6882,275.28,2474,17526
40000,65,35003.0,13627,545.08,4997,35003
60000,65,52520.0,20205,808.2,7480,52520
80000,65,70078.0,26955,1078.2,9922,70078
100000,65,87567.0,33626,1345.04,12433,87567
200000,65,175240.0,67314,2692.56,24760,175240
400000,65,350625.0,133839,5353.56,49375,350625
600000,65,525849.0,200713,8028.52,74151,525849
800000,65,701099.0,267621,10704.84,98901,701099
1000000,65,876379.0,334271,13370.84,123621,876379
2,66,2.0,2,0.08,0,2
3,66,3.0,3,0.12,0,3
100,66,81.0,89,3.56,19,81
200,66,166.0,133,5.32,34,166
2000,66,1730.0,748,29.92,270,1730
10000,66,8729.0,3453,138.12,1271,8729
20000,66,17441.0,6726,269.04,2559,17441
40000,66,34930.0,13496,539.84,5070,34930
60000,66,52494.0,20180,807.2,7506,52494
80000,66,70067.0,26841,1073.64,9933,70067
100000,66,87623.0,33376,1335.04,12377,87623
200000,66,175286.0,66764,2670.56,24714,175286
400000,66,350820.0,133663,5346.52,49180,350820
600000,66,525891.0,200047,8001.88,74109,525891
800000,66,701306.0,266479,10659.16,98694,701306
1000000,66,876846.0,332702,13308.08,123154,876846
2,67,2.0,2,0.08,0,2
3,67,3.0,3,0.12,0,3
100,67,88.0,49,1.96,12,88
200,67,179.0,79,3.16,21,179
2000,67,1755.0,682,27.28,245,1755
10000,67,8747.0,3311,132.44,1253,8747
20000,67,17546.0,6632,265.28,2454,17546
40000,67,35086.0,13256,530.24,4914,35086
60000,67,52612.0,19928,797.12,7388,52612
80000,67,70236.0,26725,1069.0,9764,70236
100000,67,87788.0,33459,1338.36,12212,87788
200000,67,175546.0,66722,2668.88,24454,175546
400000,67,350825.0,133208,5328.32,49175,350825
600000,67,525873.0,199765,7990.6,74127,525873
800000,67,701424.0,266815,10672.6,98576,701424
1000000,67,877103.0,333642,13345.68,122897,877103
2,68,2.0,2,0.08,0,2
3,68,3.0,3,0.12,0,3
100,68,83.0,49,1.96,17,83
200,68,169.0,80,3.2,31,169
2000,68,1734.0,664,26.56,266,1734
10000,68,8657.0,3300,132.0,1343,8657
20000,68,17432.0,6680,267.2,2568,17432
40000,68,34885.0,13332,533.28,5115,34885
60000,68,52500.0,20050,802.0,7500,52500
80000,68,70010.0,26878,1075.12,9990,70010
100000,68,87491.0,33577,1343.08,12509,87491
200000,68,175203.0,66761,2670.44,24797,175203
400000,68,350121.0,133529,5341.16,49879,350121
600000,68,525459.0,200206,8008.24,74541,525459
800000,68,700981.0,266983,10679.32,99019,700981
1000000,68,876359.0,333727,13349.08,123641,876359
2,69,1.0,2,0.08,1,1
3,69,2.0,3,0.12,1,2
100,69,77.0,83,3.32,23,77
200,69,161.0,162,6.48,39,161
2000,69,1728.0,942,37.68,272,1728
10000,69,8735.0,3600,144.0,1265,8735
20000,69,17534.0,6928,277.12,2466,17534
40000,69,35097.0,13596,543.84,4903,35097
60000,69,52634.0,20282,811.28,7366,52634
80000,69,70182.0,26842,1073.68,9818,70182
100000,69,87734.0,33417,1336.68,12266,87734
200000,69,175395.0,66651,2666.04,24605,175395
400000,69,350671.0,132990,5319.6,49329,350671
600000,69,526106.0,199759,7990.36,73894,526106
800000,69,701601.0,266325,10653.0,98399,701601
1000000,69,877365.0,332911,13316.44,122635,877365
2,70,2.0,2,0.08,0,2
3,70,3.0,3,0.12,0,3
100,70,88.0,52,2.08,12,88
200,70,175.0,86,3.44,25,175
2000,70,1752.0,709,28.36,248,1752
10000,70,8755.0,3342,133.68,1245,8755
20000,70,17490.0,6630,265.2,2510,17490
40000,70,34981.0,13328,533.12,5019,34981
60000,70,52410.0,20066,802.64,7590,52410
80000,70,69959.0,26653,1066.12,10041,69959
100000,70,87462.0,33396,1335.84,12538,87462
200000,70,175159.0,66722,2668.88,24841,175159
400000,70,350257.0,133245,5329.8,49743,350257
600000,70,525932.0,199881,7995.24,74068,525932
800000,70,701061.0,266860,10674.4,98939,701061
1000000,70,876542.0,333634,13345.36,123458,876542
2,71,2.0,1,0.04,0,2
3,71,3.0,2,0.08,0,3
100,71,89.0,37,1.48,11,89
200,71,177.0,69,2.76,23,177
2000,71,1731.0,656,26.24,269,1731
10000,71,8720.0,3288,131.52,1280,8720
20000,71,17512.0,6642,265.68,2488,17512
40000,71,35044.0,13383,535.32,4956,35044
60000,71,52579.0,20030,801.2,7421,52579
80000,71,70167.0,26672,1066.88,9833,70167
100000,71,87746.0,33299,1331.96,12254,87746
200000,71,175491.0,66720,2668.8,24509,175491
400000,71,350889.0,133489,5339.56,49111,350889
600000,71,525939.0,200141,8005.64,74061,525939
800000,71,701307.0,266788,10671.52,98693,701307
1000000,71,876628.0,333592,13343.68,123372,876628
2,72,0.0,2,0.08,2,0
3,72,1.0,2,0.08,2,1
100,72,81.0,79,3.16,19,81
200,72,167.0,145,5.8,33,167
2000,72,1737.0,738,29.52,263,1737
10000,72,8727.0,3426,137.04,1273,8727
20000,72,17502.0,6814,272.56,2498,17502
40000,72,35005.0,13509,540.36,4995,35005
60000,72,52581.0,20072,802.88,7419,52581
80000,72,70148.0,26783,1071.32,9852,70148
100000,72,87683.0,33469,1338.76,12317,87683
200000,72,175446.0,66681,2667.24,24554,175446
400000,72,350821.0,133344,5333.76,49179,350821
600000,72,526225.0,200018,8000.72,73775,526225
800000,72,701909.0,266456,10658.24,98091,701909
1000000,72,877153.0,333061,13322.44,122847,877153
2,73,2.0,2,0.08,0,2
3,73,3.0,3,0.12,0,3
100,73,85.0,72,2.88,15,85
200,73,175.0,98,3.92,25,175
2000,73,1761.0,720,28.8,239,1761
10000,73,8772.0,3336,133.44,1228,8772
20000,73,17542.0,6646,265.84,2458,17542
40000,73,35163.0,13290,531.6,4837,35163
60000,73,52654.0,20125,805.0,7346,52654
80000,73,70128.0,26841,1073.64,9872,70128
100000,73,87599.0,33455,1338.2,12401,87599
200000,73,175230.0,66777,2671.08,24770,175230
400000,73,350577.0,133063,5322.52,49423,350577
600000,73,525915.0,199875,7995.0,74085,525915
800000,73,701150.0,266347,10653.88,98850,701150
1000000,73,876459.0,333186,13327.44,123541,876459
2,74,1.0,2,0.08,1,1
3,74,1.0,3,0.12,2,1
100,74,79.0,81,3.24,21,79
200,74,166.0,122,4.88,34,166
2000,74,1704.0,735,29.4,296,1704
10000,74,8768.0,3406,136.24,1232,8768
20000,74,17556.0,6672,266.88,2444,17556
40000,74,35054.0,13290,531.6,4946,35054
60000,74,52602.0,20046,801.84,7398,52602
80000,74,70171.0,26713,1068.52,9829,70171
100000,74,87733.0,33455,1338.2,12267,87733
200000,74,175208.0,66693,2667.72,24792,175208
400000,74,350461.0,133200,5328.0,49539,350461
600000,74,525763.0,199612,7984.48,74237,525763
800000,74,701202.0,266188,10647.52,98798,701202
1000000,74,876716.0,333211,13328.44,123284,876716
2,75,2.0,0,0.0,0,2
3,75,3.0,1,0.04,0,3
100,75,88.0,80,3.2,12,88
200,75,173.0,166,6.64,27,173
2000,75,1765.0,823,32.92,235,1765
10000,75,8786.0,3479,139.16,1214,8786
20000,75,17600.0,6829,273.16,2400,17600
40000,75,35084.0,13578,543.12,4916,35084
60000,75,52605.0,20415,816.6,7395,52605
80000,75,70093.0,27158,1086.32,9907,70093
100000,75,87565.0,33829,1353.16,12435,87565
200000,75,175260.0,67205,2688.2,24740,175260
400000,75,350729.0,133716,5348.64,49271,350729
600000,75,526385.0,199980,7999.2,73615,526385
800000,75,701757.0,266948,10677.92,98243,701757
1000000,75,877055.0,333552,13342.08,122945,877055
2,76,1.0,0,0.0,1,1
3,76,2.0,1,0.04,1,2
100,76,91.0,88,3.52,9,91
200,76,182.0,156,6.24,18,182
2000,76,1711.0,1637,65.48,289,1711
10000,76,8665.0,4959,198.36,1335,8665
20000,76,17471.0,8261,330.44,2529,17471
40000,76,35012.0,14932,597.28,4988,35012
60000,76,52520.0,21572,862.88,7480,52520
80000,76,70055.0,28229,1129.16,9945,70055
100000,76,87617.0,34900,1396.0,12383,87617
200000,76,175352.0,68413,2736.52,24648,175352
400000,76,350929.0,135275,5411.0,49071,350929
600000,76,526350.0,201848,8073.92,73650,526350
800000,76,701657.0,268310,10732.4,98343,701657
1000000,76,876749.0,334880,13395.2,123251,876749
2,77,2.0,2,0.08,0,2
3,77,2.0,3,0.12,1,2
100,77,83.0,69,2.76,17,83
200,77,168.0,149,5.96,32,168
2000,77,1723.0,881,35.24,277,1723
10000,77,8715.0,3588,143.52,1285,8715
20000,77,17469.0,6974,278.96,2531,17469
40000,77,35025.0,13621,544.84,4975,35025
60000,77,52551.0,20214,808.56,7449,52551
80000,77,70042.0,26961,1078.44,9958,70042
100000,77,87566.0,33590,1343.6,12434,87566
200000,77,175172.0,66772,2670.88,24828,175172
400000,77,350603.0,133204,5328.16,49397,350603
600000,77,525853.0,199580,7983.2,74147,525853
800000,77,701202.0,266399,10655.96,98798,701202
1000000,77,876412.0,332882,13315.28,123588,876412
2,78,1.0,2,0.08,1,1
3,78,1.0,3,0.12,2,1
100,78,89.0,79,3.16,11,89
200,78,172.0,141,5.64,28,172
2000,78,1742.0,732,29.28,258,1742
10000,78,8763.0,3431,137.24,1237,8763
20000,78,17526.0,6819,272.76,2474,17526
40000,78,35034.0,13418,536.72,4966,35034
60000,78,52632.0,19953,798.12,7368,52632
80000,78,70168.0,26577,1063.08,9832,70168
100000,78,87698.0,33116,1324.64,12302,87698
200000,78,175267.0,66584,2663.36,24733,175267
400000,78,350410.0,133414,5336.56,49590,350410
600000,78,525931.0,200184,8007.36,74069,525931
800000,78,701560.0,266834,10673.36,98440,701560
1000000,78,876915.0,333595,13343.8,123085,876915
2,79,2.0,2,0.08,0,2
3,79,3.0,3,0.12,0,3
100,79,91.0,71,2.84,9,91
200,79,186.0,112,4.48,14,186
2000,79,1761.0,799,31.96,239,1761
10000,79,8756.0,3431,137.24,1244,8756
20000,79,17556.0,6761,270.44,2444,17556
40000,79,35071.0,13524,540.96,4929,35071
60000,79,52643.0,20168,806.72,7357,52643
80000,79,70192.0,26904,1076.16,9808,70192
100000,79,87678.0,33490,1339.6,12322,87678
200000,79,175243.0,66730,2669.2,24757,175243
400000,79,350456.0,132988,5319.52,49544,350456
600000,79,525935.0,199949,7997.96,74065,525935
800000,79,701237.0,266847,10673.88,98763,701237
1000000,79,876752.0,333826,13353.04,123248,876752
2,80,2.0,2,0.08,0,2
3,80,3.0,2,0.08,0,3
100,80,88.0,83,3.32,12,88
200,80,176.0,171,6.84,24,176
2000,80,1742.0,1048,41.92,258,1742
10000,80,8784.0,3736,149.44,1216,8784
20000,80,17598.0,7135,285.4,2402,17598
40000,80,35145.0,13893,555.72,4855,35145
60000,80,52671.0,20581,823.24,7329,52671
80000,80,70250.0,27250,1090.0,9750,70250
100000,80,87760.0,34005,1360.2,12240,87760
200000,80,175457.0,67268,2690.72,24543,175457
400000,80,351017.0,133826,5353.04,48983,351017
600000,80,526457.0,200274,8010.96,73543,526457
800000,80,701908.0,267056,10682.24,98092,701908
1000000,80,877446.0,333807,13352.28,122554,877446
2,81,2.0,2,0.08,0,2
3,81,3.0,3,0.12,0,3
100,81,86.0,77,3.08,14,86
200,81,172.0,131,5.24,28,172
2000,81,1753.0,765,30.6,247,1753
10000,81,8748.0,3441,137.64,1252,8748
20000,81,17493.0,6778,271.12,2507,17493
40000,81,34987.0,13550,542.0,5013,34987
60000,81,52483.0,20213,808.52,7517,52483
80000,81,70135.0,26898,1075.92,9865,70135
100000,81,87633.0,33557,1342.28,12367,87633
200000,81,175178.0,66801,2672.04,24822,175178
400000,81,350467.0,133365,5334.6,49533,350467
600000,81,525484.0,199973,7998.92,74516,525484
800000,81,700869.0,266888,10675.52,99131,700869
1000000,81,876316.0,333830,13353.2,123684,876316
2,82,2.0,2,0.08,0,2
3,82,2.0,2,0.08,1,2
100,82,88.0,88,3.52,12,88
200,82,179.0,181,7.24,21,179
2000,82,1718.0,1000,40.0,282,1718
10000,82,8734.0,3737,149.48,1266,8734
20000,82,17480.0,7064,282.56,2520,17480
40000,82,35006.0,13672,546.88,4994,35006
60000,82,52458.0,20428,817.12,7542,52458
80000,82,69989.0,27121,1084.84,10011,69989
100000,82,87450.0,33769,1350.76,12550,87450
200000,82,175235.0,67242,2689.68,24765,175235
400000,82,350614.0,133932,5357.28,49386,350614
600000,82,525976.0,200465,8018.6,74024,525976
800000,82,701362.0,267313,10692.52,98638,701362
1000000,82,876707.0,333782,13351.28,123293,876707
2,83,2.0,2,0.08,0,2
3,83,3.0,2,0.08,0,3
100,83,84.0,37,1.48,16,84
200,83,173.0,72,2.88,27,173
2000,83,1719.0,1273,50.92,281,1719
10000,83,8745.0,4120,164.8,1255,8745
20000,83,17494.0,7418,296.72,2506,17494
40000,83,35090.0,14049,561.96,4910,35090
60000,83,52584.0,20761,830.44,7416,52584
80000,83,70128.0,27391,1095.64,9872,70128
100000,83,87641.0,34137,1365.48,12359,87641
200000,83,175416.0,67444,2697.76,24584,175416
400000,83,350599.0,134158,5366.32,49401,350599
600000,83,526098.0,200897,8035.88,73902,526098
800000,83,701110.0,267214,10688.56,98890,701110
1000000,83,876566.0,333474,13338.96,123434,876566
2,84,2.0,0,0.0,0,2
3,84,3.0,0,0.0,0,3
100,84,84.0,72,2.88,16,84
200,84,166.0,148,5.92,34,166
2000,84,1736.0,770,30.8,264,1736
10000,84,8715.0,3443,137.72,1285,8715
20000,84,17471.0,6764,270.56,2529,17471
40000,84,34982.0,13393,535.72,5018,34982
60000,84,52438.0,20044,801.76,7562,52438
80000,84,70008.0,26756,1070.24,9992,70008
100000,84,87521.0,33362,1334.48,12479,87521
200000,84,175036.0,66468,2658.72,24964,175036
400000,84,350227.0,132890,5315.6,49773,350227
600000,84,525586.0,199694,7987.76,74414,525586
800000,84,700940.0,266396,10655.84,99060,700940
1000000,84,876262.0,333150,13326.0,123738,876262
2,85,1.0,1,0.04,1,1
3,85,2.0,2,0.08,1,2
100,85,89.0,82,3.28,11,89
200,85,175.0,160,6.4,25,175
2000,85,1754.0,1031,41.24,246,1754
10000,85,8765.0,3727,149.08,1235,8765
20000,85,17486.0,7091,283.64,2514,17486
40000,85,35129.0,13699,547.96,4871,35129
60000,85,52739.0,20338,813.52,7261,52739
80000,85,70283.0,26989,1079.56,9717,70283
100000,85,87784.0,33709,1348.36,12216,87784
200000,85,175531.0,67121,2684.84,24469,175531
400000,85,351014.0,133242,5329.68,48986,351014
600000,85,526302.0,199705,7988.2,73698,526302
800000,85,701742.0,266531,10661.24,98258,701742
1000000,85,877121.0,333138,13325.52,122879,877121
2,86,1.0,1,0.04,1,1
3,86,2.0,2,0.08,1,2
100,86,86.0,79,3.16,14,86
200,86,173.0,157,6.28,27,173
2000,86,1775.0,835,33.4,225,1775
10000,86,8728.0,3493,139.72,1272,8728
20000,86,17508.0,6819,272.76,2492,17508
40000,86,34946.0,13565,542.6,5054,34946
60000,86,52484.0,20292,811.68,7516,52484
80000,86,70086.0,26857,1074.28,9914,70086
100000,86,87678.0,33518,1340.72,12322,87678
200000,86,175423.0,66815,2672.6,24577,175423
400000,86,350579.0,132837,5313.48,49421,350579
600000,86,525609.0,199793,7991.72,74391,525609
800000,86,701004.0,266672,10666.88,98996,701004
1000000,86,876483.0,333092,13323.68,123517,876483
2,87,0.0,1,0.04,2,0
3,87,1.0,2,0.08,2,1
100,87,73.0,41,1.64,27,73
200,87,160.0,73,2.92,40,160
2000,87,1740.0,696,27.84,260,1740
10000,87,8765.0,3357,134.28,1235,8765
20000,87,17577.0,6698,267.92,2423,17577
40000,87,35121.0,13320,532.8,4879,35121
60000,87,52648.0,19971,798.84,7352,52648
80000,87,70176.0,26705,1068.2,9824,70176
100000,87,87717.0,33413,1336.52,12283,87717
200000,87,175330.0,66770,2670.8,24670,175330
400000,87,350475.0,133642,5345.68,49525,350475
600000,87,526071.0,200577,8023.08,73929,526071
800000,87,701283.0,267703,10708.12,98717,701283
1000000,87,876753.0,334301,13372.04,123247,876753
2,88,2.0,2,0.08,0,2
3,88,3.0,2,0.08,0,3
100,88,83.0,86,3.44,17,83
200,88,162.0,169,6.76,38,162
2000,88,1756.0,921,36.84,244,1756
10000,88,8774.0,3571,142.84,1226,8774
20000,88,17519.0,6895,275.8,2481,17519
40000,88,35015.0,13517,540.68,4985,35015
60000,88,52606.0,20116,804.64,7394,52606
80000,88,70211.0,26734,1069.36,9789,70211
100000,88,87737.0,33443,1337.72,12263,87737
200000,88,175354.0,66913,2676.52,24646,175354
400000,88,350504.0,133336,5333.44,49496,350504
600000,88,526048.0,199916,7996.64,73952,526048
800000,88,701480.0,266569,10662.76,98520,701480
1000000,88,876980.0,332638,13305.52,123020,876980
2,89,1.0,2,0.08,1,1
3,89,2.0,3,0.12,1,2
100,89,91.0,38,1.52,9,91
200,89,181.0,77,3.08,19,181
2000,89,1750.0,717,28.68,250,1750
10000,89,8732.0,3433,137.32,1268,8732
20000,89,17526.0,6785,271.4,2474,17526
40000,89,35050.0,13418,536.72,4950,35050
60000,89,52568.0,20068,802.72,7432,52568
80000,89,70126.0,26769,1070.76,9874,70126
100000,89,87697.0,33442,1337.68,12303,87697
200000,89,175288.0,66721,2668.84,24712,175288
400000,89,350537.0,133561,5342.44,49463,350537
600000,89,525963.0,199797,7991.88,74037,525963
800000,89,701399.0,266665,10666.6,98601,701399
1000000,89,876434.0,333467,13338.68,123566,876434
2,90,2.0,0,0.0,0,2
3,90,3.0,0,0.0,0,3
100,90,91.0,60,2.4,9,91
200,90,173.0,96,3.84,27,173
2000,90,1749.0,679,27.16,251,1749
10000,90,8793.0,3388,135.52,1207,8793
20000,90,17530.0,6660,266.4,2470,17530
40000,90,35005.0,13331,533.24,4995,35005
60000,90,52533.0,20092,803.68,7467,52533
80000,90,70048.0,26748,1069.92,9952,70048
100000,90,87593.0,33354,1334.16,12407,87593
200000,90,175229.0,66815,2672.6,24771,175229
400000,90,350653.0,133526,5341.04,49347,350653
600000,90,525832.0,200061,8002.44,74168,525832
800000,90,701212.0,266639,10665.56,98788,701212
1000000,90,876503.0,333008,13320.32,123497,876503
2,91,2.0,2,0.08,0,2
3,91,3.0,3,0.12,0,3
100,91,86.0,80,3.2,14,86
200,91,178.0,124,4.96,22,178
2000,91,1753.0,728,29.12,247,1753
10000,91,8748.0,3374,134.96,1252,8748
20000,91,17540.0,6783,271.32,2460,17540
40000,91,35039.0,13544,541.76,4961,35039
60000,91,52576.0,20239,809.56,7424,52576
80000,91,70050.0,26820,1072.8,9950,70050
100000,91,87508.0,33590,1343.6,12492,87508
200000,91,175250.0,66812,2672.48,24750,175250
400000,91,350553.0,133577,5343.08,49447,350553
600000,91,525782.0,200371,8014.84,74218,525782
800000,91,700982.0,266925,10677.0,99018,700982
1000000,91,876511.0,333066,13322.64,123489,876511
2,92,1.0,1,0.04,1,1
3,92,2.0,1,0.04,1,2
100,92,83.0,43,1.72,17,83
200,92,170.0,70,2.8,30,170
2000,92,1752.0,729,29.16,248,1752
10000,92,8757.0,3383,135.32,1243,8757
20000,92,17476.0,6760,270.4,2524,17476
40000,92,35017.0,13378,535.12,4983,35017
60000,92,52503.0,20179,807.16,7497,52503
80000,92,70073.0,26842,1073.68,9927,70073
100000,92,87626.0,33592,1343.68,12374,87626
200000,92,175190.0,66866,2674.64,24810,175190
400000,92,350410.0,133450,5338.0,49590,350410
600000,92,526003.0,200003,8000.12,73997,526003
800000,92,701312.0,266572,10662.88,98688,701312
1000000,92,876597.0,333165,13326.6,123403,876597
2,93,2.0,2,0.08,0,2
3,93,2.0,3,0.12,1,2
100,93,83.0,64,2.56,17,83
200,93,168.0,140,5.6,32,168
2000,93,1725.0,1535,61.4,275,1725
10000,93,8694.0,4265,170.6,1306,8694
20000,93,17471.0,7537,301.48,2529,17471
40000,93,34915.0,14205,568.2,5085,34915
60000,93,52422.0,20773,830.92,7578,52422
80000,93,69936.0,27399,1095.96,10064,69936
100000,93,87365.0,34110,1364.4,12635,87365
200000,93,175077.0,67460,2698.4,24923,175077
400000,93,350384.0,134354,5374.16,49616,350384
600000,93,525773.0,200830,8033.2,74227,525773
800000,93,701302.0,267636,10705.44,98698,701302
1000000,93,876791.0,334398,13375.92,123209,876791
2,94,2.0,2,0.08,0,2
3,94,3.0,2,0.08,0,3
100,94,81.0,81,3.24,19,81
200,94,162.0,161,6.44,38,162
2000,94,1742.0,771,30.84,258,1742
10000,94,8756.0,3410,136.4,1244,8756
20000,94,17547.0,6726,269.04,2453,17547
40000,94,35120.0,13428,537.12,4880,35120
60000,94,52723.0,20079,803.16,7277,52723
80000,94,70211.0,26850,1074.0,9789,70211
100000,94,87835.0,33407,1336.28,12165,87835
200000,94,175469.0,66817,2672.68,24531,175469
400000,94,350656.0,133250,5330.0,49344,350656
600000,94,525940.0,200060,8002.4,74060,525940
800000,94,701369.0,266824,10672.96,98631,701369
1000000,94,876571.0,333635,13345.4,123429,876571
2,95,2.0,2,0.08,0,2
3,95,3.0,2,0.08,0,3
100,95,88.0,83,3.32,12,88
200,95,177.0,137,5.48,23,177
2000,95,1733.0,1389,55.56,267,1733
10000,95,8739.0,4056,162.24,1261,8739
20000,95,17551.0,7419,296.76,2449,17551
40000,95,35116.0,14126,565.04,4884,35116
60000,95,52632.0,20812,832.48,7368,52632
80000,95,70257.0,27468,1098.72,9743,70257
100000,95,87797.0,34125,1365.0,12203,87797
200000,95,175593.0,67628,2705.12,24407,175593
400000,95,350940.0,134457,5378.28,49060,350940
600000,95,526160.0,200783,8031.32,73840,526160
800000,95,701417.0,267539,10701.56,98583,701417
1000000,95,876631.0,334368,13374.72,123369,876631
2,96,2.0,2,0.08,0,2
3,96,2.0,3,0.12,1,2
100,96,76.0,73,2.92,24,76
200,96,161.0,105,4.2,39,161
2000,96,1742.0,705,28.2,258,1742
10000,96,8710.0,3338,133.52,1290,8710
20000,96,17540.0,6693,267.72,2460,17540
40000,96,35053.0,13456,538.24,4947,35053
60000,96,52639.0,20185,807.4,7361,52639
80000,96,70229.0,26743,1069.72,9771,70229
100000,96,87778.0,33406,1336.24,12222,87778
200000,96,175303.0,66698,2667.92,24697,175303
400000,96,350554.0,133083,5323.32,49446,350554
600000,96,525728.0,199711,7988.44,74272,525728
800000,96,701137.0,266231,10649.24,98863,701137
1000000,96,876311.0,332536,13301.44,123689,876311
2,97,2.0,1,0.04,0,2
3,97,3.0,2,0.08,0,3
100,97,93.0,37,1.48,7,93
200,97,183.0,73,2.92,17,183
2000,97,1751.0,764,30.56,249,1751
10000,97,8785.0,3487,139.48,1215,8785
20000,97,17528.0,6784,271.36,2472,17528
40000,97,34994.0,13436,537.44,5006,34994
60000,97,52532.0,20274,810.96,7468,52532
80000,97,70082.0,26916,1076.64,9918,70082
100000,97,87632.0,33651,1346.04,12368,87632
200000,97,175308.0,67042,2681.68,24692,175308
400000,97,350683.0,133985,5359.4,49317,350683
600000,97,526443.0,201180,8047.2,73557,526443
800000,97,701597.0,267858,10714.32,98403,701597
1000000,97,876809.0,334772,13390.88,123191,876809
2,98,2.0,2,0.08,0,2
3,98,3.0,3,0.12,0,3
100,98,82.0,79,3.16,18,82
200,98,169.0,166,6.64,31,169
2000,98,1769.0,956,38.24,231,1769
10000,98,8805.0,3652,146.08,1195,8805
20000,98,17611.0,7006,280.24,2389,17611
40000,98,35142.0,13732,549.28,4858,35142
60000,98,52645.0,20405,816.2,7355,52645
80000,98,70179.0,27080,1083.2,9821,70179
100000,98,87735.0,33718,1348.72,12265,87735
200000,98,175273.0,67090,2683.6,24727,175273
400000,98,350587.0,133778,5351.12,49413,350587
600000,98,526206.0,200797,8031.88,73794,526206
800000,98,701626.0,267379,10695.16,98374,701626
1000000,98,876950.0,334620,13384.8,123050,876950
2,99,1.0,2,0.08,1,1
3,99,2.0,3,0.12,1,2
100,99,87.0,84,3.36,13,87
200,99,175.0,171,6.84,25,175
2000,99,1757.0,830,33.2,243,1757
10000,99,8834.0,3454,138.16,1166,8834
20000,99,17520.0,6846,273.84,2480,17520
40000,99,35015.0,13541,541.64,4985,35015
60000,99,52515.0,20163,806.52,7485,52515
80000,99,70106.0,26844,1073.76,9894,70106
100000,99,87666.0,33563,1342.52,12334,87666
200000,99,175247.0,66915,2676.6,24753,175247
400000,99,350535.0,133614,5344.56,49465,350535
600000,99,525701.0,200422,8016.88,74299,525701
800000,99,701049.0,267037,10681.48,98951,701049
1000000,99,876512.0,333890,13355.6,123488,876512
2,100,2.0,2,0.08,0,2
3,100,2.0,3,0.12,1,2
100,100,87.0,63,2.52,13,87
200,100,169.0,106,4.24,31,169
2000,100,1733.0,719,28.76,267,1733
10000,100,8717.0,3445,137.8,1283,8717
20000,100,17500.0,6729,269.16,2500,17500
40000,100,35034.0,13484,539.36,4966,35034
60000,100,52578.0,20204,808.16,7422,52578
80000,100,70106.0,26823,1072.92,9894,70106
100000,100,87613.0,33555,1342.2,12387,87613
200000,100,175452.0,66959,2678.36,24548,175452
400000,100,350998.0,133916,5356.64,49002,350998
600000,100,526554.0,200701,8028.04,73446,526554
800000,100,701897.0,267565,10702.6,98103,701897
1000000,100,877450.0,334076,13363.04,122550,877450
