Timestep,Iteration,Total Reward,Suboptimal Arms,Total Regret,Zeros Count,Ones Count
2,1,2.0,2,0.02,0,2
3,1,3.0,3,0.03,0,3
100,1,89.0,55,0.25,11,89
200,1,175.0,91,0.44,25,175
2000,1,1801.0,679,3.38,199,1801
10000,1,9034.0,3569,17.6,966,9034
20000,1,18055.0,6975,34.63,1945,18055
40000,1,36054.0,13602,67.31,3946,36054
60000,1,54023.0,20199,100.27,5977,54023
80000,1,71945.0,26804,133.36,8055,71945
100000,1,89897.0,33490,167.12,10103,89897
200000,1,179680.0,66634,332.1,20320,179680
400000,1,359629.0,133263,665.04,40371,359629
600000,1,539275.0,200117,999.55,60725,539275
800000,1,719115.0,266797,1331.74,80885,719115
1000000,1,898716.0,333441,1663.0,101284,898716
2,2,2.0,0,0.0,0,2
3,2,3.0,0,0.0,0,3
100,2,90.0,59,0.32,10,90
200,2,179.0,87,0.42,21,179
2000,2,1821.0,982,3.66,179,1821
10000,2,9020.0,4903,16.61,980,9020
20000,2,18015.0,8777,33.9,1985,18015
40000,2,36039.0,15305,66.25,3961,36039
60000,2,53959.0,22671,99.03,6041,53959
80000,2,71866.0,31172,132.09,8134,71866
100000,2,89893.0,37985,166.51,10107,89893
200000,2,179803.0,71213,332.69,20197,179803
400000,2,359374.0,145323,667.43,40626,359374
600000,2,539365.0,297110,1000.42,60635,539365
800000,2,718753.0,463431,1336.95,81247,718753
1000000,2,898190.0,607211,1669.49,101810,898190
2,3,2.0,2,0.02,0,2
3,3,3.0,3,0.03,0,3
100,3,89.0,39,0.21,11,89
200,3,179.0,78,0.43,21,179
2000,3,1785.0,1445,4.78,215,1785
10000,3,8956.0,8070,18.18,1044,8956
20000,3,17946.0,15659,34.64,2054,17946
40000,3,35823.0,32335,66.68,4177,35823
60000,3,53752.0,48925,99.9,6248,53752
80000,3,71640.0,65651,132.78,8360,71640
100000,3,89704.0,82346,166.09,10296,89704
200000,3,179421.0,165639,331.68,20579,179421
400000,3,359034.0,329853,665.86,40966,359034
600000,3,538737.0,493329,997.25,61263,538737
800000,3,718310.0,646154,1329.93,81690,718310
1000000,3,897772.0,723080,1664.21,102228,897772
2,4,2.0,2,0.01,0,2
3,4,3.0,3,0.02,0,3
100,4,90.0,62,0.25,10,90
200,4,180.0,146,0.37,20,180
2000,4,1813.0,1620,6.37,187,1813
10000,4,8964.0,7628,20.3,1036,8964
20000,4,17984.0,14253,37.03,2016,17984
40000,4,35970.0,24831,70.54,4030,35970
60000,4,53965.0,41016,103.27,6035,53965
80000,4,71916.0,50377,136.06,8084,71916
100000,4,89967.0,56966,170.22,10033,89967
200000,4,179723.0,90073,334.65,20277,179723
400000,4,359442.0,156813,665.23,40558,359442
600000,4,539278.0,262869,1000.43,60722,539278
800000,4,719088.0,407590,1333.76,80912,719088
1000000,4,898675.0,568193,1667.17,101325,898675
2,5,1.0,0,0.0,1,1
3,5,2.0,1,0.0,1,2
100,5,91.0,51,0.2,9,91
200,5,186.0,76,0.34,14,186
2000,5,1808.0,932,3.38,192,1808
10000,5,8959.0,4170,16.74,1041,8959
20000,5,17898.0,11107,32.63,2102,17898
40000,5,35723.0,26252,66.21,4277,35723
60000,5,53721.0,33283,98.31,6279,53721
80000,5,71643.0,39935,131.98,8357,71643
100000,5,89646.0,46679,165.39,10354,89646
200000,5,179445.0,79712,330.56,20555,179445
400000,5,359399.0,146102,661.57,40601,359399
600000,5,539172.0,221873,993.14,60828,539172
800000,5,718883.0,294637,1326.13,81117,718883
1000000,5,898518.0,361310,1658.39,101482,898518
2,6,0.0,1,0.0,2,0
3,6,1.0,2,0.0,2,1
100,6,91.0,79,0.14,9,91
200,6,184.0,145,0.32,16,184
2000,6,1811.0,1641,3.58,189,1811
10000,6,8977.0,8295,17.37,1023,8977
20000,6,17996.0,16666,33.94,2004,17996
40000,6,35915.0,33301,66.27,4085,35915
60000,6,53940.0,49909,99.94,6060,53940
80000,6,71894.0,66564,134.06,8106,71894
100000,6,89825.0,83207,168.09,10175,89825
200000,6,179703.0,166760,333.79,20297,179703
400000,6,359295.0,333405,667.34,40705,359295
600000,6,538986.0,499825,1000.57,61014,538986
800000,6,718768.0,666393,1332.15,81232,718768
1000000,6,898386.0,833156,1665.7,101614,898386
2,7,2.0,0,0.0,0,2
3,7,3.0,0,0.0,0,3
100,7,93.0,57,0.18,7,93
200,7,184.0,128,0.34,16,184
2000,7,1802.0,883,3.17,198,1802
10000,7,8953.0,3673,16.56,1047,8953
20000,7,17921.0,6979,32.94,2079,17921
40000,7,35903.0,13704,66.59,4097,35903
60000,7,53888.0,20422,99.69,6112,53888
80000,7,71776.0,31709,133.02,8224,71776
100000,7,89748.0,47143,165.96,10252,89748
200000,7,179624.0,130512,331.88,20376,179624
400000,7,359475.0,297351,665.36,40525,359475
600000,7,539308.0,460245,998.8,60692,539308
800000,7,719047.0,537128,1332.13,80953,719047
1000000,7,898676.0,603785,1665.0,101324,898676
2,8,2.0,2,0.0,0,2
3,8,3.0,3,0.01,0,3
100,8,91.0,86,0.3,9,91
200,8,179.0,146,0.52,21,179
2000,8,1779.0,1308,3.49,221,1779
10000,8,8960.0,3965,16.54,1040,8960
20000,8,17911.0,8856,32.76,2089,17911
40000,8,35871.0,18898,66.27,4129,35871
60000,8,53876.0,35524,99.76,6124,53876
80000,8,71798.0,52169,132.71,8202,71798
100000,8,89718.0,68763,166.31,10282,89718
200000,8,179643.0,120031,331.39,20357,179643
400000,8,359367.0,186582,664.42,40633,359367
600000,8,539134.0,253488,998.51,60866,539134
800000,8,718871.0,320308,1330.95,81129,718871
1000000,8,898641.0,386671,1664.13,101359,898641
2,9,2.0,0,0.0,0,2
3,9,3.0,1,0.01,0,3
100,9,93.0,74,0.19,7,93
200,9,184.0,163,0.35,16,184
2000,9,1825.0,1570,3.34,175,1825
10000,9,9015.0,7048,17.39,985,9015
20000,9,17977.0,10903,34.38,2023,17977
40000,9,36010.0,17558,68.01,3990,36010
60000,9,53965.0,24259,101.21,6035,53965
80000,9,71933.0,30831,134.75,8067,71933
100000,9,89941.0,37861,167.48,10059,89941
200000,9,179725.0,71318,335.42,20275,179725
400000,9,359287.0,137887,667.93,40713,359287
600000,9,538998.0,204740,1002.95,61002,538998
800000,9,718348.0,271788,1338.5,81652,718348
1000000,9,897967.0,338695,1674.89,102033,897967
2,10,1.0,0,0.0,1,1
3,10,2.0,0,0.0,1,2
100,10,87.0,62,0.17,13,87
200,10,177.0,143,0.32,23,177
2000,10,1784.0,847,4.28,216,1784
10000,10,8977.0,3512,17.63,1023,8977
20000,10,17923.0,6809,33.85,2077,17923
40000,10,35866.0,13537,67.54,4134,35866
60000,10,53860.0,25513,101.26,6140,53860
80000,10,71795.0,41339,133.87,8205,71795
100000,10,89758.0,53676,166.71,10242,89758
200000,10,179656.0,87026,333.83,20344,179656
400000,10,359266.0,153170,664.91,40734,359266
600000,10,538851.0,256514,999.17,61149,538851
800000,10,718283.0,323219,1331.41,81717,718283
1000000,10,897942.0,390164,1665.15,102058,897942
2,11,2.0,0,0.0,0,2
3,11,3.0,0,0.0,0,3
100,11,89.0,40,0.17,11,89
200,11,174.0,98,0.41,26,174
2000,11,1786.0,1595,3.42,214,1786
10000,11,8999.0,8308,17.35,1001,8999
20000,11,18025.0,16587,33.01,1975,18025
40000,11,35989.0,32402,66.02,4011,35989
60000,11,53979.0,45581,98.46,6021,53979
80000,11,71937.0,62219,131.94,8063,71937
100000,11,89912.0,78965,165.32,10088,89912
200000,11,179859.0,162242,329.35,20141,179859
400000,11,359673.0,328930,662.89,40327,359673
600000,11,539179.0,491955,999.07,60821,539179
800000,11,718712.0,656626,1330.57,81288,718712
1000000,11,898297.0,823185,1663.46,101703,898297
2,12,2.0,1,0.0,0,2
3,12,3.0,2,0.01,0,3
100,12,84.0,43,0.27,16,84
200,12,172.0,79,0.44,28,172
2000,12,1806.0,1281,3.1,194,1806
10000,12,8971.0,7736,18.31,1029,8971
20000,12,17919.0,15650,34.4,2081,17919
40000,12,35857.0,32346,67.18,4143,35857
60000,12,53847.0,46246,100.46,6153,53847
80000,12,71857.0,52915,134.25,8143,71857
100000,12,89866.0,59426,166.67,10134,89866
200000,12,179778.0,92738,333.63,20222,179778
400000,12,359613.0,159495,667.64,40387,359613
600000,12,539603.0,226248,1002.96,60397,539603
800000,12,719184.0,292572,1334.05,80816,719184
1000000,12,898803.0,363037,1669.27,101197,898803
2,13,1.0,1,0.01,1,1
3,13,2.0,1,0.01,1,2
100,13,88.0,67,0.16,12,88
200,13,176.0,145,0.34,24,176
2000,13,1791.0,1617,4.11,209,1791
10000,13,8985.0,7918,17.25,1015,8985
20000,13,17949.0,16177,33.7,2051,17949
40000,13,35885.0,31182,67.34,4115,35885
60000,13,53860.0,37836,100.91,6140,53860
80000,13,71743.0,44548,134.27,8257,71743
100000,13,89737.0,51180,167.21,10263,89737
200000,13,179598.0,84628,333.47,20402,179598
400000,13,359387.0,150542,662.09,40613,359387
600000,13,539102.0,217024,994.52,60898,539102
800000,13,718597.0,283772,1327.57,81403,718597
1000000,13,898251.0,350677,1663.61,101749,898251
2,14,2.0,0,0.0,0,2
3,14,3.0,0,0.0,0,3
100,14,92.0,72,0.57,8,92
200,14,176.0,150,1.26,24,176
2000,14,1785.0,844,4.99,215,1785
10000,14,8955.0,5532,19.12,1045,8955
20000,14,17932.0,13833,35.38,2068,17932
40000,14,35915.0,30453,68.6,4085,35915
60000,14,53955.0,40739,103.02,6045,53955
80000,14,71947.0,47458,137.06,8053,71947
100000,14,89912.0,55883,170.0,10088,89912
200000,14,180023.0,89123,337.49,19977,180023
400000,14,359798.0,155925,670.56,40202,359798
600000,14,539416.0,222446,1001.87,60584,539416
800000,14,719111.0,289505,1332.43,80889,719111
1000000,14,898799.0,363057,1663.71,101201,898799
2,15,2.0,2,0.0,0,2
3,15,3.0,3,0.0,0,3
100,15,90.0,80,0.56,10,90
200,15,183.0,160,1.18,17,183
2000,15,1826.0,1235,4.24,174,1826
10000,15,9007.0,6468,17.48,993,9007
20000,15,17968.0,10877,35.62,2032,17968
40000,15,35927.0,17792,67.58,4073,35927
60000,15,53923.0,26837,100.48,6077,53923
80000,15,71902.0,43310,132.91,8098,71902
100000,15,89886.0,53716,166.67,10114,89886
200000,15,179665.0,135534,333.25,20335,179665
400000,15,359463.0,302149,666.69,40537,359463
600000,15,538884.0,468927,999.04,61116,538884
800000,15,718545.0,635462,1333.7,81455,718545
1000000,15,898063.0,802302,1668.33,101937,898063
2,16,2.0,0,0.0,0,2
3,16,3.0,0,0.0,0,3
100,16,89.0,73,0.17,11,89
200,16,181.0,157,0.35,19,181
2000,16,1802.0,1647,3.92,198,1802
10000,16,8977.0,6231,17.27,1023,8977
20000,16,17970.0,9615,34.06,2030,17970
40000,16,35955.0,16320,67.88,4045,35955
60000,16,53998.0,22983,101.55,6002,53998
80000,16,72072.0,29657,135.53,7928,72072
100000,16,90065.0,36380,169.14,9935,90065
200000,16,179698.0,72427,336.74,20302,179698
400000,16,359170.0,143852,667.17,40830,359170
600000,16,538745.0,210605,1001.74,61255,538745
800000,16,718262.0,277404,1333.1,81738,718262
1000000,16,897912.0,344150,1665.8,102088,897912
2,17,2.0,1,0.01,0,2
3,17,3.0,2,0.01,0,3
100,17,90.0,68,0.18,10,90
200,17,178.0,146,0.39,22,178
2000,17,1801.0,1599,3.52,199,1801
10000,17,8976.0,8275,24.64,1024,8976
20000,17,17944.0,15140,41.52,2056,17944
40000,17,35954.0,21777,74.26,4046,35954
60000,17,53901.0,28428,107.6,6099,53901
80000,17,71877.0,35102,140.96,8123,71877
100000,17,89780.0,41891,175.2,10220,89780
200000,17,179615.0,75315,342.68,20385,179615
400000,17,359123.0,141803,675.43,40877,359123
600000,17,538911.0,208272,1010.73,61089,538911
800000,17,718302.0,341049,1344.03,81698,718302
1000000,17,898080.0,434052,1673.97,101920,898080
2,18,2.0,2,0.0,0,2
3,18,3.0,3,0.0,0,3
100,18,86.0,84,0.35,14,86
200,18,173.0,164,0.47,27,173
2000,18,1781.0,1653,11.18,219,1781
10000,18,8977.0,8289,26.05,1023,8977
20000,18,17927.0,16084,42.68,2073,17927
40000,18,36009.0,32730,76.96,3991,36009
60000,18,53964.0,42874,110.37,6036,53964
80000,18,71931.0,49548,143.8,8069,71931
100000,18,89934.0,56208,177.26,10066,89934
200000,18,179952.0,89243,341.7,20048,179952
400000,18,359578.0,183781,676.83,40422,359578
600000,18,539433.0,250528,1011.43,60567,539433
800000,18,718921.0,317099,1346.67,81079,718921
1000000,18,898477.0,383718,1678.49,101523,898477
2,19,2.0,0,0.0,0,2
3,19,3.0,0,0.0,0,3
100,19,90.0,76,0.45,10,90
200,19,180.0,153,0.93,20,180
2000,19,1790.0,1638,5.42,210,1790
10000,19,8980.0,8302,19.18,1020,8980
20000,19,18010.0,14072,36.12,1990,18010
40000,19,36017.0,30741,69.27,3983,36017
60000,19,53941.0,47376,102.51,6059,53941
80000,19,71935.0,64025,135.63,8065,71935
100000,19,89812.0,80710,169.6,10188,89812
200000,19,179456.0,163852,336.1,20544,179456
400000,19,359160.0,330691,668.9,40840,359160
600000,19,538792.0,497330,1002.5,61208,538792
800000,19,718548.0,663446,1332.74,81452,718548
1000000,19,897968.0,766027,1663.9,102032,897968
2,20,2.0,0,0.0,0,2
3,20,3.0,0,0.0,0,3
100,20,94.0,32,0.18,6,94
200,20,189.0,67,0.32,11,189
2000,20,1815.0,1174,3.3,185,1815
10000,20,9004.0,4072,16.45,996,9004
20000,20,18005.0,7280,32.45,1995,18005
40000,20,36008.0,14004,65.72,3992,36008
60000,20,54015.0,20597,98.29,5985,54015
80000,20,71990.0,27833,131.68,8010,71990
100000,20,90021.0,34476,165.02,9979,90021
200000,20,179892.0,69151,329.94,20108,179892
400000,20,359483.0,198697,662.97,40517,359483
600000,20,539351.0,265381,996.86,60649,539351
800000,20,718904.0,332480,1332.14,81096,718904
1000000,20,898546.0,398849,1664.79,101454,898546
2,21,2.0,1,0.01,0,2
3,21,3.0,2,0.02,0,3
100,21,92.0,58,0.18,8,92
200,21,180.0,128,0.38,20,180
2000,21,1801.0,1328,3.03,199,1801
10000,21,8982.0,7947,16.38,1018,8982
20000,21,17939.0,12711,32.66,2061,17939
40000,21,35851.0,22507,66.34,4149,35851
60000,21,53835.0,39068,100.25,6165,53835
80000,21,71790.0,55675,134.06,8210,71790
100000,21,89721.0,72353,167.67,10279,89721
200000,21,179698.0,111643,333.25,20302,179698
400000,21,359456.0,185659,668.95,40544,359456
600000,21,539066.0,255663,1004.76,60934,539066
800000,21,718811.0,365534,1336.19,81189,718811
1000000,21,898368.0,532107,1671.84,101632,898368
2,22,2.0,0,0.0,0,2
3,22,3.0,1,0.0,0,3
100,22,92.0,76,0.32,8,92
200,22,182.0,150,0.61,18,182
2000,22,1797.0,963,3.68,203,1797
10000,22,8984.0,3981,18.57,1016,8984
20000,22,18019.0,7406,35.22,1981,18019
40000,22,36024.0,22136,68.03,3976,36024
60000,22,53883.0,37289,102.42,6117,53883
80000,22,71893.0,53910,135.07,8107,71893
100000,22,89848.0,67390,169.66,10152,89848
200000,22,179698.0,103600,337.96,20302,179698
400000,22,359231.0,188051,671.92,40769,359231
600000,22,538916.0,254680,1006.66,61084,538916
800000,22,718868.0,321444,1340.07,81132,718868
1000000,22,898881.0,408913,1671.79,101119,898881
2,23,2.0,2,0.02,0,2
3,23,3.0,3,0.03,0,3
100,23,83.0,76,0.19,17,83
200,23,176.0,160,0.36,24,176
2000,23,1791.0,1403,3.18,209,1791
10000,23,8957.0,5113,21.87,1043,8957
20000,23,17960.0,8385,38.35,2040,17960
40000,23,35834.0,15027,71.36,4166,35834
60000,23,53849.0,21666,104.07,6151,53849
80000,23,71832.0,28420,138.14,8168,71832
100000,23,89867.0,35079,171.02,10133,89867
200000,23,179692.0,68468,339.24,20308,179692
400000,23,359256.0,135521,675.2,40744,359256
600000,23,538847.0,202458,1009.22,61153,538847
800000,23,718502.0,268812,1342.36,81498,718502
1000000,23,898249.0,335674,1676.21,101751,898249
2,24,2.0,2,0.02,0,2
3,24,3.0,3,0.03,0,3
100,24,94.0,69,0.36,6,94
200,24,177.0,135,0.49,23,177
2000,24,1802.0,885,4.27,198,1802
10000,24,8976.0,6424,38.65,1024,8976
20000,24,17967.0,9780,55.44,2033,17967
40000,24,35947.0,16537,89.31,4053,35947
60000,24,53859.0,23420,124.35,6141,53859
80000,24,71805.0,30089,157.63,8195,71805
100000,24,89772.0,37128,191.07,10228,89772
200000,24,179666.0,70799,357.23,20334,179666
400000,24,359352.0,137467,688.83,40648,359352
600000,24,539183.0,203725,1022.97,60817,539183
800000,24,718684.0,270665,1358.48,81316,718684
1000000,24,898099.0,337293,1691.63,101901,898099
2,25,1.0,1,0.01,1,1
3,25,2.0,1,0.01,1,2
100,25,88.0,69,0.2,12,88
200,25,172.0,150,0.37,28,172
2000,25,1794.0,912,4.28,206,1794
10000,25,9007.0,6048,41.88,993,9007
20000,25,17947.0,14355,108.45,2053,17947
40000,25,35932.0,23140,144.07,4068,35932
60000,25,53933.0,29865,177.07,6067,53933
80000,25,71904.0,41291,210.15,8096,71904
100000,25,89908.0,55154,243.58,10092,89908
200000,25,179706.0,125524,411.76,20294,179706
400000,25,359331.0,292445,744.58,40669,359331
600000,25,538755.0,458917,1078.06,61245,538755
800000,25,718520.0,625464,1410.76,81480,718520
1000000,25,898289.0,792343,1745.16,101711,898289
2,26,1.0,0,0.0,1,1
3,26,2.0,0,0.0,1,2
100,26,89.0,69,0.24,11,89
200,26,176.0,147,0.39,24,176
2000,26,1795.0,793,4.04,205,1795
10000,26,8977.0,3444,17.02,1023,8977
20000,26,17942.0,6835,34.31,2058,17942
40000,26,35956.0,16383,68.65,4044,35956
60000,26,53900.0,23514,102.33,6100,53900
80000,26,71915.0,30217,136.22,8085,71915
100000,26,89937.0,43246,169.41,10063,89937
200000,26,179561.0,98371,336.46,20439,179561
400000,26,359397.0,164922,668.06,40603,359397
600000,26,538981.0,231840,1001.81,61019,538981
800000,26,718556.0,341125,1335.8,81444,718556
1000000,26,898181.0,483961,1670.29,101819,898181
2,27,2.0,0,0.0,0,2
3,27,2.0,0,0.0,1,2
100,27,87.0,52,0.28,13,87
200,27,170.0,121,0.66,30,170
2000,27,1800.0,1644,12.8,200,1800
10000,27,8964.0,8255,65.12,1036,8964
20000,27,17911.0,16617,131.1,2089,17911
40000,27,35908.0,33209,169.43,4092,35908
60000,27,53869.0,49819,202.1,6131,53869
80000,27,71821.0,64154,236.13,8179,71821
100000,27,89773.0,78039,268.34,10227,89773
200000,27,179574.0,158856,435.07,20426,179574
400000,27,359391.0,276450,768.32,40609,359391
600000,27,538990.0,389219,1102.54,61010,538990
800000,27,718700.0,470612,1434.73,81300,718700
1000000,27,898354.0,609634,1766.18,101646,898354
2,28,0.0,1,0.01,2,0
3,28,1.0,2,0.02,2,1
100,28,84.0,80,0.33,16,84
200,28,174.0,159,0.53,26,174
2000,28,1772.0,786,3.31,228,1772
10000,28,8936.0,6513,16.18,1064,8936
20000,28,17934.0,14884,32.43,2066,17934
40000,28,35860.0,31387,66.0,4140,35860
60000,28,53880.0,46558,99.55,6120,53880
80000,28,71812.0,63155,133.09,8188,71812
100000,28,89789.0,79807,166.25,10211,89789
200000,28,179592.0,163426,334.26,20408,179592
400000,28,359278.0,309014,666.03,40722,359278
600000,28,538596.0,468163,997.76,61404,538596
800000,28,718273.0,634991,1330.83,81727,718273
1000000,28,898065.0,801833,1663.12,101935,898065
2,29,2.0,1,0.0,0,2
3,29,3.0,1,0.0,0,3
100,29,85.0,41,0.24,15,85
200,29,179.0,78,0.5,21,179
2000,29,1773.0,1509,11.9,227,1773
10000,29,8958.0,6094,27.38,1042,8958
20000,29,17926.0,14423,43.76,2074,17926
40000,29,35891.0,26820,77.19,4109,35891
60000,29,53831.0,33404,110.36,6169,53831
80000,29,71807.0,40211,143.5,8193,71807
100000,29,89836.0,46891,176.51,10164,89836
200000,29,179836.0,86847,342.15,20164,179836
400000,29,359321.0,233539,673.54,40679,359321
600000,29,538997.0,399704,1004.57,61003,538997
800000,29,718585.0,566471,1339.04,81415,718585
1000000,29,898235.0,730323,1673.67,101765,898235
2,30,2.0,1,0.01,0,2
3,30,3.0,2,0.02,0,3
100,30,90.0,39,0.18,10,90
200,30,176.0,75,0.36,24,176
2000,30,1791.0,684,3.28,209,1791
10000,30,8934.0,3756,16.23,1066,8934
20000,30,17870.0,8537,33.07,2130,17870
40000,30,35746.0,24886,66.66,4254,35746
60000,30,53687.0,41451,98.95,6313,53687
80000,30,71632.0,58036,131.74,8368,71632
100000,30,89688.0,74717,165.39,10312,89688
200000,30,179449.0,157931,332.22,20551,179449
400000,30,358960.0,322431,664.77,41040,358960
600000,30,538729.0,489023,997.05,61271,538729
800000,30,718298.0,655791,1329.86,81702,718298
1000000,30,897847.0,822301,1663.38,102153,897847
2,31,2.0,0,0.0,0,2
3,31,3.0,1,0.0,0,3
100,31,88.0,73,0.2,12,88
200,31,173.0,162,0.59,27,173
2000,31,1786.0,1668,3.65,214,1786
10000,31,8952.0,8132,16.51,1048,8952
20000,31,17910.0,16362,33.76,2090,17910
40000,31,35798.0,29281,66.39,4202,35798
60000,31,53726.0,36428,99.67,6274,53726
80000,31,71656.0,43166,134.21,8344,71656
100000,31,89520.0,49835,167.67,10480,89520
200000,31,179281.0,83201,333.85,20719,179281
400000,31,359117.0,149863,668.99,40883,359117
600000,31,538710.0,216480,1004.0,61290,538710
800000,31,718473.0,283727,1339.62,81527,718473
1000000,31,898026.0,350191,1672.71,101974,898026
2,32,1.0,0,0.0,1,1
3,32,2.0,1,0.01,1,2
100,32,92.0,81,0.63,8,92
200,32,182.0,160,1.19,18,182
2000,32,1790.0,1666,12.8,210,1790
10000,32,9010.0,8390,28.88,990,9010
20000,32,18009.0,16480,45.21,1991,18009
40000,32,35933.0,33168,78.89,4067,35933
60000,32,53877.0,49738,112.01,6123,53877
80000,32,71839.0,66500,145.58,8161,71839
100000,32,89895.0,83154,177.71,10105,89895
200000,32,179837.0,166409,344.06,20163,179837
400000,32,359416.0,332914,677.6,40584,359416
600000,32,539035.0,499466,1013.16,60965,539035
800000,32,718757.0,666107,1346.47,81243,718757
1000000,32,898409.0,832593,1680.03,101591,898409
2,33,2.0,0,0.0,0,2
3,33,3.0,0,0.0,0,3
100,33,91.0,24,0.15,9,91
200,33,178.0,51,0.24,22,178
2000,33,1783.0,954,6.15,217,1783
10000,33,8961.0,5796,19.46,1039,8961
20000,33,18009.0,9054,35.68,1991,18009
40000,33,36043.0,15814,70.01,3957,36043
60000,33,53975.0,26063,103.49,6025,53975
80000,33,71999.0,42748,136.27,8001,71999
100000,33,89929.0,59411,170.25,10071,89929
200000,33,179746.0,142768,335.09,20254,179746
400000,33,359426.0,301820,666.96,40574,359426
600000,33,538949.0,417430,1000.34,61051,538949
800000,33,718480.0,560600,1332.52,81520,718480
1000000,33,897955.0,715017,1667.52,102045,897955
2,34,1.0,1,0.01,1,1
3,34,2.0,2,0.01,1,2
100,34,92.0,43,0.19,8,92
200,34,185.0,82,0.38,15,185
2000,34,1794.0,791,4.16,206,1794
10000,34,8961.0,4097,17.81,1039,8961
20000,34,17909.0,7497,35.34,2091,17909
40000,34,35813.0,14262,69.1,4187,35813
60000,34,53754.0,20898,101.75,6246,53754
80000,34,71677.0,27543,135.16,8323,71677
100000,34,89589.0,34205,168.68,10411,89589
200000,34,179203.0,67359,334.69,20797,179203
400000,34,358644.0,214232,667.15,41356,358644
600000,34,538314.0,380764,1001.63,61686,538314
800000,34,718057.0,547377,1333.85,81943,718057
1000000,34,897732.0,714121,1666.67,102268,897732
2,35,1.0,1,0.01,1,1
3,35,2.0,2,0.01,1,2
100,35,87.0,63,0.15,13,87
200,35,181.0,140,0.26,19,181
2000,35,1798.0,1579,3.53,202,1798
10000,35,8932.0,6432,31.47,1068,8932
20000,35,17833.0,13102,82.33,2167,17833
40000,35,35808.0,29818,115.41,4192,35808
60000,35,53746.0,46416,149.26,6254,53746
80000,35,71715.0,63040,182.13,8285,71715
100000,35,89737.0,79675,216.26,10263,89737
200000,35,179515.0,162872,384.36,20485,179515
400000,35,359037.0,280139,716.67,40963,359037
600000,35,538704.0,346695,1050.63,61296,538704
800000,35,718466.0,413190,1383.54,81534,718466
1000000,35,897930.0,479885,1717.6,102070,897930
2,36,2.0,0,0.0,0,2
3,36,3.0,0,0.0,0,3
100,36,94.0,68,0.25,6,94
200,36,186.0,145,0.41,14,186
2000,36,1811.0,1081,3.44,189,1811
10000,36,8995.0,6823,16.87,1005,8995
20000,36,17951.0,14978,33.89,2049,17951
40000,36,35896.0,26750,66.85,4104,35896
60000,36,53874.0,33445,99.73,6126,53874
80000,36,71789.0,40139,133.29,8211,71789
100000,36,89791.0,46783,166.75,10209,89791
200000,36,179528.0,99554,331.74,20472,179528
400000,36,358881.0,246572,667.48,41119,358881
600000,36,538605.0,411421,1001.78,61395,538605
800000,36,718143.0,514431,1334.86,81857,718143
1000000,36,897867.0,581139,1667.94,102133,897867
2,37,2.0,1,0.01,0,2
3,37,3.0,1,0.01,0,3
100,37,94.0,62,0.32,6,94
200,37,186.0,146,0.98,14,186
2000,37,1815.0,1526,11.64,185,1815
10000,37,8998.0,6759,25.36,1002,8998
20000,37,17986.0,13269,41.66,2014,17986
40000,37,35967.0,24391,74.29,4033,35967
60000,37,53948.0,31538,108.29,6052,53948
80000,37,71878.0,44487,141.27,8122,71878
100000,37,89892.0,61137,174.35,10108,89892
200000,37,179649.0,143788,342.75,20351,179649
400000,37,359200.0,264905,677.51,40800,359200
600000,37,538665.0,351607,1010.46,61335,538665
800000,37,718505.0,418095,1344.19,81495,718505
1000000,37,898153.0,484808,1676.55,101847,898153
2,38,2.0,0,0.0,0,2
3,38,3.0,0,0.0,0,3
100,38,83.0,79,0.38,17,83
200,38,174.0,162,0.69,26,174
2000,38,1772.0,1668,3.8,228,1772
10000,38,8942.0,8114,17.03,1058,8942
20000,38,17914.0,16477,34.3,2086,17914
40000,38,35905.0,33091,67.66,4095,35905
60000,38,53882.0,49737,100.64,6118,53882
80000,38,71846.0,66423,134.99,8154,71846
100000,38,89824.0,82995,167.83,10176,89824
200000,38,179748.0,166201,333.39,20252,179748
400000,38,359311.0,332910,668.93,40689,359311
600000,38,538925.0,498493,1001.45,61075,538925
800000,38,718517.0,665092,1334.27,81483,718517
1000000,38,898062.0,831532,1667.34,101938,898062
2,39,2.0,1,0.0,0,2
3,39,3.0,1,0.0,0,3
100,39,90.0,52,0.25,10,90
200,39,178.0,104,0.49,22,178
2000,39,1814.0,846,3.57,186,1814
10000,39,9009.0,3635,16.62,991,9009
20000,39,17956.0,7023,33.26,2044,17956
40000,39,35912.0,13645,67.21,4088,35912
60000,39,53913.0,22048,99.29,6087,53913
80000,39,71864.0,28773,133.1,8136,71864
100000,39,89903.0,35398,166.63,10097,89903
200000,39,179822.0,68982,333.56,20178,179822
400000,39,359522.0,156437,667.77,40478,359522
600000,39,539453.0,248143,1003.47,60547,539453
800000,39,718954.0,367997,1337.12,81046,718954
1000000,39,898604.0,502300,1668.64,101396,898604
2,40,1.0,2,0.0,1,1
3,40,2.0,3,0.0,1,2
100,40,88.0,74,0.27,12,88
200,40,176.0,159,0.57,24,176
2000,40,1807.0,1476,5.54,193,1807
10000,40,8957.0,7980,21.26,1043,8957
20000,40,17954.0,16307,38.07,2046,17954
40000,40,35936.0,32944,71.97,4064,35936
60000,40,53906.0,49538,105.82,6094,53906
80000,40,71875.0,66219,139.11,8125,71875
100000,40,89886.0,82861,172.15,10114,89886
200000,40,179698.0,166222,339.72,20302,179698
400000,40,359259.0,333016,674.66,40741,359259
600000,40,538737.0,499621,1007.52,61263,538737
800000,40,718625.0,666386,1340.27,81375,718625
1000000,40,898032.0,832969,1671.29,101968,898032
2,41,1.0,1,0.01,1,1
3,41,2.0,1,0.01,1,2
100,41,91.0,40,0.13,9,91
200,41,177.0,70,0.28,23,177
2000,41,1770.0,911,3.38,230,1770
10000,41,8946.0,3608,16.89,1054,8946
20000,41,17898.0,7090,33.42,2102,17898
40000,41,35902.0,13943,66.35,4098,35902
60000,41,53828.0,20683,100.97,6172,53828
80000,41,71797.0,27410,134.33,8203,71797
100000,41,89770.0,34036,167.44,10230,89770
200000,41,179648.0,67377,334.33,20352,179648
400000,41,359638.0,168418,666.73,40362,359638
600000,41,539452.0,334970,997.58,60548,539452
800000,41,718865.0,483296,1331.29,81135,718865
1000000,41,898477.0,645201,1669.28,101523,898477
2,42,2.0,2,0.0,0,2
3,42,3.0,3,0.01,0,3
100,42,83.0,71,0.17,17,83
200,42,172.0,159,0.45,28,172
2000,42,1796.0,1674,3.64,204,1796
10000,42,8961.0,5658,16.33,1039,8961
20000,42,17980.0,9013,33.19,2020,17980
40000,42,36008.0,18249,65.9,3992,36008
60000,42,53985.0,30812,99.26,6015,53985
80000,42,71906.0,42254,131.83,8094,71906
100000,42,89838.0,53316,164.78,10162,89838
200000,42,179741.0,135154,331.9,20259,179741
400000,42,359416.0,301960,668.11,40584,359416
600000,42,539070.0,449534,999.73,60930,539070
800000,42,718880.0,616196,1335.27,81120,718880
1000000,42,898520.0,782896,1666.12,101480,898520
2,43,2.0,0,0.0,0,2
3,43,3.0,0,0.0,0,3
100,43,86.0,33,0.12,14,86
200,43,174.0,76,0.32,26,174
2000,43,1786.0,977,6.42,214,1786
10000,43,8984.0,7045,19.74,1016,8984
20000,43,17980.0,14687,36.35,2020,17980
40000,43,35980.0,22069,69.84,4020,35980
60000,43,53990.0,30666,104.4,6010,53990
80000,43,71939.0,45722,136.97,8061,71939
100000,43,89977.0,62404,170.16,10023,89977
200000,43,179756.0,145735,336.16,20244,179756
400000,43,359675.0,312229,669.78,40325,359675
600000,43,539437.0,462187,1005.64,60563,539437
800000,43,719130.0,629036,1339.06,80870,719130
1000000,43,898777.0,795756,1674.16,101223,898777
2,44,2.0,2,0.01,0,2
3,44,3.0,3,0.02,0,3
100,44,89.0,81,0.39,11,89
200,44,173.0,161,0.86,27,173
2000,44,1790.0,1040,3.9,210,1790
10000,44,8975.0,3727,17.6,1025,8975
20000,44,17908.0,7090,34.1,2092,17908
40000,44,35879.0,13802,67.87,4121,35879
60000,44,53841.0,20603,101.99,6159,53841
80000,44,71805.0,27178,134.67,8195,71805
100000,44,89865.0,36926,167.74,10135,89865
200000,44,179741.0,120174,334.45,20259,179741
400000,44,359447.0,286850,669.05,40553,359447
600000,44,538920.0,453498,1006.22,61080,538920
800000,44,718735.0,620057,1338.45,81265,718735
1000000,44,898337.0,786869,1672.33,101663,898337
2,45,1.0,0,0.0,1,1
3,45,1.0,0,0.0,2,1
100,45,86.0,77,0.17,14,86
200,45,175.0,164,0.34,25,175
2000,45,1774.0,1703,3.72,226,1774
10000,45,8977.0,8177,17.48,1023,8977
20000,45,17991.0,16545,34.03,2009,17991
40000,45,35968.0,33030,67.77,4032,35968
60000,45,53911.0,49693,100.95,6089,53911
80000,45,71949.0,66365,134.15,8051,71949
100000,45,89949.0,83032,167.96,10051,89949
200000,45,179874.0,166512,335.19,20126,179874
400000,45,359674.0,333088,670.02,40326,359674
600000,45,539416.0,499715,1002.93,60584,539416
800000,45,718928.0,662796,1336.04,81072,718928
1000000,45,898485.0,822277,1666.6,101515,898485
2,46,2.0,1,0.01,0,2
3,46,3.0,1,0.01,0,3
100,46,94.0,39,0.23,6,94
200,46,186.0,74,0.41,14,186
2000,46,1814.0,680,3.5,186,1814
10000,46,9062.0,3350,16.62,938,9062
20000,46,18015.0,6755,33.67,1985,18015
40000,46,35999.0,13431,67.43,4001,35999
60000,46,53990.0,20016,100.07,6010,53990
80000,46,71922.0,26690,132.71,8078,71922
100000,46,89938.0,33303,166.33,10062,89938
200000,46,179782.0,72274,332.03,20218,179782
400000,46,359398.0,170547,667.13,40602,359398
600000,46,539025.0,279273,996.93,60975,539025
800000,46,718863.0,345557,1330.42,81137,718863
1000000,46,898489.0,412065,1663.98,101511,898489
2,47,1.0,0,0.0,1,1
3,47,2.0,0,0.0,1,2
100,47,85.0,69,0.27,15,85
200,47,175.0,155,0.43,25,175
2000,47,1784.0,1648,3.68,216,1784
10000,47,9038.0,8278,16.88,962,9038
20000,47,17959.0,16628,34.9,2041,17959
40000,47,35881.0,33365,69.08,4119,35881
60000,47,53818.0,49980,102.01,6182,53818
80000,47,71775.0,66600,135.78,8225,71775
100000,47,89697.0,83334,169.84,10303,89697
200000,47,179598.0,135262,338.35,20402,179598
400000,47,359174.0,247309,670.12,40826,359174
600000,47,538840.0,348060,1003.85,61160,538840
800000,47,718582.0,493052,1337.98,81418,718582
1000000,47,898116.0,658124,1670.5,101884,898116
2,48,2.0,0,0.0,0,2
3,48,3.0,0,0.0,0,3
100,48,94.0,69,0.26,6,94
200,48,182.0,147,0.48,18,182
2000,48,1788.0,1627,3.66,212,1788
10000,48,8966.0,8214,16.78,1034,8966
20000,48,17937.0,16416,33.24,2063,17937
40000,48,35843.0,32171,66.2,4157,35843
60000,48,53789.0,48914,100.41,6211,53789
80000,48,71727.0,65541,134.89,8273,71727
100000,48,89628.0,82324,168.82,10372,89628
200000,48,179440.0,165610,334.52,20560,179440
400000,48,359143.0,332091,667.52,40857,359143
600000,48,539037.0,498739,999.51,60963,539037
800000,48,718782.0,665644,1334.46,81218,718782
1000000,48,898373.0,832318,1666.37,101627,898373
2,49,2.0,0,0.0,0,2
3,49,3.0,1,0.0,0,3
100,49,86.0,52,0.24,14,86
200,49,176.0,122,0.42,24,176
2000,49,1797.0,971,3.56,203,1797
10000,49,8990.0,6493,17.49,1010,8990
20000,49,17938.0,14872,34.85,2062,17938
40000,49,35906.0,31571,68.57,4094,35906
60000,49,53950.0,48227,101.47,6050,53950
80000,49,71886.0,60884,134.28,8114,71886
100000,49,89898.0,69392,167.59,10102,89898
200000,49,179656.0,103661,333.22,20344,179656
400000,49,359437.0,170149,666.6,40563,359437
600000,49,538991.0,237039,999.74,61009,538991
800000,49,718580.0,343195,1331.47,81420,718580
1000000,49,898111.0,410032,1666.8,101889,898111
2,50,2.0,0,0.0,0,2
3,50,3.0,0,0.0,0,3
100,50,94.0,51,0.39,6,94
200,50,182.0,116,0.84,18,182
2000,50,1803.0,1307,4.74,197,1803
10000,50,8990.0,4120,18.17,1010,8990
20000,50,17972.0,7462,34.59,2028,17972
40000,50,35992.0,14085,67.4,4008,35992
60000,50,54021.0,22537,100.37,5979,54021
80000,50,71996.0,29171,133.31,8004,71996
100000,50,89992.0,35848,166.55,10008,89992
200000,50,179874.0,72014,334.44,20126,179874
400000,50,359617.0,142028,666.73,40383,359617
600000,50,539249.0,208593,999.66,60751,539249
800000,50,718870.0,275446,1334.47,81130,718870
1000000,50,898509.0,341989,1665.63,101491,898509
2,51,2.0,2,0.02,0,2
3,51,3.0,3,0.03,0,3
100,51,92.0,88,0.62,8,92
200,51,185.0,171,0.76,15,185
2000,51,1788.0,1054,4.03,212,1788
10000,51,8914.0,5895,17.49,1086,8914
20000,51,17884.0,14196,33.83,2116,17884
40000,51,35857.0,30971,67.88,4143,35857
60000,51,53762.0,47635,102.29,6238,53762
80000,51,71628.0,64274,135.9,8372,71628
100000,51,89611.0,80950,168.3,10389,89611
200000,51,179503.0,164211,335.8,20497,179503
400000,51,359254.0,330865,667.48,40746,359254
600000,51,538838.0,472959,997.51,61162,538838
800000,51,718427.0,590873,1332.98,81573,718427
1000000,51,898012.0,756795,1667.82,101988,898012
2,52,2.0,1,0.01,0,2
3,52,3.0,2,0.02,0,3
100,52,93.0,61,0.34,7,93
200,52,186.0,90,0.46,14,186
2000,52,1803.0,1157,4.44,197,1803
10000,52,9012.0,7795,18.25,988,9012
20000,52,18003.0,15579,35.51,1997,18003
40000,52,36065.0,27468,68.54,3935,36065
60000,52,54092.0,38281,102.25,5908,54092
80000,52,72128.0,54929,135.62,7872,72128
100000,52,90134.0,71075,169.58,9866,90134
200000,52,179997.0,138607,338.09,20003,179997
400000,52,359844.0,237914,671.44,40156,359844
600000,52,539675.0,389826,1004.79,60325,539675
800000,52,719501.0,555576,1338.11,80499,719501
1000000,52,899446.0,722149,1672.48,100554,899446
2,53,2.0,0,0.0,0,2
3,53,3.0,0,0.0,0,3
100,53,88.0,79,0.28,12,88
200,53,177.0,161,0.44,23,177
2000,53,1795.0,1693,3.44,205,1795
10000,53,8965.0,7860,16.8,1035,8965
20000,53,17963.0,11790,33.49,2037,17963
40000,53,35926.0,18445,67.07,4074,35926
60000,53,53849.0,25236,100.75,6151,53849
80000,53,71783.0,31914,133.79,8217,71783
100000,53,89764.0,46933,166.92,10236,89764
200000,53,179625.0,130315,333.9,20375,179625
400000,53,358996.0,252855,666.22,41004,358996
600000,53,538653.0,319951,999.33,61347,538653
800000,53,718164.0,386366,1329.73,81836,718164
1000000,53,898156.0,452904,1660.77,101844,898156
2,54,2.0,0,0.0,0,2
3,54,3.0,0,0.0,0,3
100,54,95.0,30,0.11,5,95
200,54,185.0,62,0.31,15,185
2000,54,1799.0,663,3.26,201,1799
10000,54,9037.0,3908,16.94,963,9037
20000,54,17980.0,8795,33.85,2020,17980
40000,54,36010.0,25353,67.44,3990,36010
60000,54,53981.0,41398,101.49,6019,53981
80000,54,71935.0,53840,134.01,8065,71935
100000,54,89868.0,70409,167.12,10132,89868
200000,54,179606.0,153813,333.94,20394,179606
400000,54,359125.0,320774,667.86,40875,359125
600000,54,538754.0,487608,1002.3,61246,538754
800000,54,718380.0,654391,1333.79,81620,718380
1000000,54,898211.0,820701,1666.34,101789,898211
2,55,1.0,0,0.0,1,1
3,55,2.0,0,0.0,1,2
100,55,92.0,86,0.18,8,92
200,55,181.0,168,0.6,19,181
2000,55,1775.0,1510,8.49,225,1775
10000,55,8916.0,7016,49.84,1084,8916
20000,55,17925.0,10493,65.7,2075,17925
40000,55,35844.0,17399,99.9,4156,35844
60000,55,53843.0,23997,132.55,6157,53843
80000,55,71789.0,30635,165.68,8211,71789
100000,55,89736.0,37307,199.33,10264,89736
200000,55,179632.0,71186,364.35,20368,179632
400000,55,359209.0,140748,696.06,40791,359209
600000,55,538830.0,250589,1028.93,61170,538830
800000,55,718496.0,349953,1359.91,81504,718496
1000000,55,898296.0,416672,1693.16,101704,898296
2,56,2.0,0,0.0,0,2
3,56,3.0,0,0.0,0,3
100,56,91.0,44,0.3,9,91
200,56,180.0,94,0.58,20,180
2000,56,1793.0,1524,3.62,207,1793
10000,56,8976.0,8123,16.75,1024,8976
20000,56,17977.0,16494,33.84,2023,17977
40000,56,35947.0,33126,66.66,4053,35947
60000,56,53945.0,49811,100.02,6055,53945
80000,56,71948.0,66374,134.08,8052,71948
100000,56,89937.0,82936,167.63,10063,89937
200000,56,179825.0,154291,335.54,20175,179825
400000,56,359356.0,223447,666.54,40644,359356
600000,56,539066.0,357760,998.65,60934,539066
800000,56,718553.0,500403,1330.77,81447,718553
1000000,56,898174.0,667313,1663.21,101826,898174
2,57,1.0,1,0.0,1,1
3,57,2.0,1,0.0,1,2
100,57,92.0,79,0.54,8,92
200,57,180.0,160,1.2,20,180
2000,57,1797.0,921,4.99,203,1797
10000,57,9008.0,3614,18.28,992,9008
20000,57,18013.0,6942,35.09,1987,18013
40000,57,36033.0,13496,67.98,3967,36033
60000,57,54010.0,20887,101.94,5990,54010
80000,57,72001.0,29122,134.69,7999,72001
100000,57,90099.0,44757,167.57,9901,90099
200000,57,179909.0,123520,330.68,20091,179909
400000,57,359772.0,290458,663.46,40228,359772
600000,57,539337.0,455821,997.42,60663,539337
800000,57,719166.0,595739,1328.54,80834,719166
1000000,57,898939.0,710195,1664.15,101061,898939
2,58,2.0,2,0.0,0,2
3,58,3.0,3,0.0,0,3
100,58,93.0,50,0.22,7,93
200,58,179.0,93,0.47,21,179
2000,58,1798.0,959,3.8,202,1798
10000,58,8994.0,3682,17.2,1006,8994
20000,58,17978.0,7003,34.01,2022,17978
40000,58,35946.0,16810,66.54,4054,35946
60000,58,53915.0,23381,100.1,6085,53915
80000,58,72003.0,29966,133.2,7997,72003
100000,58,89969.0,36663,166.73,10031,89969
200000,58,179752.0,69918,332.67,20248,179752
400000,58,359284.0,136629,666.51,40716,359284
600000,58,539013.0,203507,1001.41,60987,539013
800000,58,718625.0,271964,1334.81,81375,718625
1000000,58,898312.0,342093,1669.97,101688,898312
2,59,2.0,0,0.0,0,2
3,59,3.0,1,0.01,0,3
100,59,86.0,35,0.15,14,86
200,59,175.0,66,0.32,25,175
2000,59,1785.0,747,4.01,215,1785
10000,59,8975.0,3376,17.63,1025,8975
20000,59,17934.0,6742,35.01,2066,17934
40000,59,35884.0,14380,68.31,4116,35884
60000,59,53861.0,22002,101.72,6139,53861
80000,59,71834.0,28671,135.53,8166,71834
100000,59,89709.0,35344,169.23,10291,89709
200000,59,179688.0,68763,337.21,20312,179688
400000,59,359338.0,135337,669.11,40662,359338
600000,59,538965.0,202096,1003.27,61035,538965
800000,59,718744.0,268597,1338.38,81256,718744
1000000,59,898417.0,347424,1674.11,101583,898417
2,60,2.0,0,0.0,0,2
3,60,3.0,1,0.01,0,3
100,60,93.0,71,0.52,7,93
200,60,181.0,152,1.1,19,181
2000,60,1805.0,1368,4.17,195,1805
10000,60,9009.0,5127,18.9,991,9009
20000,60,18009.0,10434,35.68,1991,18009
40000,60,35958.0,21940,70.1,4042,35958
60000,60,53987.0,28642,103.52,6013,53987
80000,60,71909.0,36537,137.01,8091,71909
100000,60,89905.0,43847,171.22,10095,89905
200000,60,179769.0,77341,337.28,20231,179769
400000,60,359520.0,154945,671.45,40480,359520
600000,60,539208.0,225476,1005.12,60792,539208
800000,60,718940.0,390711,1338.81,81060,718940
1000000,60,898973.0,557311,1671.83,101027,898973
2,61,1.0,0,0.0,1,1
3,61,1.0,0,0.0,2,1
100,61,86.0,82,0.16,14,86
200,61,174.0,163,0.34,26,174
2000,61,1801.0,946,3.52,199,1801
10000,61,9075.0,3550,16.63,925,9075
20000,61,18037.0,6827,33.15,1963,18037
40000,61,35987.0,13493,67.3,4013,35987
60000,61,53860.0,20633,100.77,6140,53860
80000,61,71814.0,27292,134.06,8186,71814
100000,61,89803.0,33923,167.19,10197,89803
200000,61,179686.0,67381,334.14,20314,179686
400000,61,359468.0,134210,669.42,40532,359468
600000,61,539205.0,200911,1002.18,60795,539205
800000,61,718795.0,267702,1337.31,81205,718795
1000000,61,898469.0,334602,1671.71,101531,898469
2,62,2.0,0,0.0,0,2
3,62,3.0,0,0.0,0,3
100,62,87.0,62,0.17,13,87
200,62,175.0,141,0.28,25,175
2000,62,1774.0,1637,3.3,226,1774
10000,62,8917.0,6887,16.33,1083,8917
20000,62,17898.0,15204,33.42,2102,17898
40000,62,35890.0,31888,67.06,4110,35890
60000,62,53880.0,48518,100.49,6120,53880
80000,62,71767.0,65176,132.78,8233,71767
100000,62,89705.0,81833,164.7,10295,89705
200000,62,179622.0,165035,331.8,20378,179622
400000,62,359388.0,326999,665.24,40612,359388
600000,62,539071.0,493467,996.73,60929,539071
800000,62,718829.0,660251,1328.42,81171,718829
1000000,62,898554.0,826666,1661.48,101446,898554
2,63,2.0,1,0.01,0,2
3,63,3.0,1,0.01,0,3
100,63,90.0,77,0.61,10,90
200,63,182.0,159,1.05,18,182
2000,63,1807.0,1619,4.04,193,1807
10000,63,8956.0,8276,17.07,1044,8956
20000,63,17997.0,16576,33.55,2003,17997
40000,63,35996.0,33181,67.57,4004,35996
60000,63,53917.0,49827,100.24,6083,53917
80000,63,71919.0,66480,133.38,8081,71919
100000,63,89849.0,83142,167.13,10151,89849
200000,63,179745.0,166509,334.22,20255,179745
400000,63,359298.0,333177,665.86,40702,359298
600000,63,538888.0,499947,1000.84,61112,538888
800000,63,718531.0,666480,1334.54,81469,718531
1000000,63,898022.0,832837,1668.86,101978,898022
2,64,1.0,0,0.0,1,1
3,64,2.0,1,0.01,1,2
100,64,87.0,81,0.66,13,87
200,64,175.0,158,0.93,25,175
2000,64,1797.0,1568,8.08,203,1797
10000,64,8979.0,8015,22.0,1021,8979
20000,64,17951.0,16232,38.82,2049,17951
40000,64,35892.0,32943,71.92,4108,35892
60000,64,53850.0,49372,104.74,6150,53850
80000,64,71874.0,65599,137.69,8126,71874
100000,64,89857.0,72849,170.88,10143,89857
200000,64,179673.0,120757,338.25,20327,179673
400000,64,359200.0,230331,672.15,40800,359200
600000,64,538805.0,396622,1007.41,61195,538805
800000,64,718380.0,563061,1339.77,81620,718380
1000000,64,898114.0,729640,1671.82,101886,898114
2,65,2.0,1,0.0,0,2
3,65,3.0,2,0.01,0,3
100,65,87.0,80,0.28,13,87
200,65,181.0,161,0.37,19,181
2000,65,1793.0,1678,3.76,207,1793
10000,65,9020.0,8380,17.21,980,9020
20000,65,17970.0,16616,34.39,2030,17970
40000,65,35938.0,29676,67.86,4062,35938
60000,65,53898.0,36261,100.54,6102,53898
80000,65,71777.0,43956,133.14,8223,71777
100000,65,89726.0,53679,166.79,10274,89726
200000,65,179523.0,127044,335.4,20477,179523
400000,65,359347.0,293786,668.69,40653,359347
600000,65,539074.0,460306,999.62,60926,539074
800000,65,718876.0,626719,1331.16,81124,718876
1000000,65,898543.0,793441,1666.29,101457,898543
2,66,2.0,0,0.0,0,2
3,66,3.0,0,0.0,0,3
100,66,95.0,79,0.6,5,95
200,66,189.0,128,0.86,11,189
2000,66,1804.0,1055,4.9,196,1804
10000,66,9017.0,7658,57.9,983,9017
20000,66,18032.0,13061,79.77,1968,18032
40000,66,36094.0,29712,112.74,3906,36094
60000,66,54046.0,42398,149.59,5954,54046
80000,66,72016.0,49903,184.65,7984,72016
100000,66,89996.0,59755,218.18,10004,89996
200000,66,179815.0,132145,385.91,20185,179815
400000,66,359223.0,229738,718.86,40777,359223
600000,66,538720.0,296549,1053.38,61280,538720
800000,66,718342.0,363251,1386.89,81658,718342
1000000,66,898277.0,429653,1719.98,101723,898277
2,67,2.0,1,0.0,0,2
3,67,3.0,1,0.0,0,3
100,67,90.0,41,0.18,10,90
200,67,182.0,79,0.39,18,182
2000,67,1822.0,638,3.06,178,1822
10000,67,9035.0,3467,15.88,965,9035
20000,67,18015.0,8455,32.37,1985,18015
40000,67,36011.0,18387,83.93,3989,36011
60000,67,53970.0,24990,116.46,6030,53970
80000,67,71890.0,31659,150.37,8110,71890
100000,67,89813.0,38314,183.38,10187,89813
200000,67,179711.0,71511,351.1,20289,179711
400000,67,359298.0,143186,685.76,40702,359298
600000,67,538899.0,222382,1016.74,61101,538899
800000,67,718466.0,288679,1347.65,81534,718466
1000000,67,898112.0,355540,1680.09,101888,898112
2,68,1.0,2,0.02,1,1
3,68,2.0,3,0.02,1,2
100,68,88.0,54,0.18,12,88
200,68,186.0,78,0.31,14,186
2000,68,1818.0,734,3.28,182,1818
10000,68,9022.0,4857,16.62,978,9022
20000,68,17988.0,10355,32.98,2012,17988
40000,68,36033.0,21646,65.76,3967,36033
60000,68,54002.0,38330,98.92,5998,54002
80000,68,72013.0,54890,132.47,7987,72013
100000,68,89993.0,71551,165.32,10007,89993
200000,68,179774.0,142323,331.96,20226,179774
400000,68,359545.0,288090,665.38,40455,359545
600000,68,539389.0,454731,999.14,60611,539389
800000,68,719245.0,621426,1329.98,80755,719245
1000000,68,898867.0,756082,1662.98,101133,898867
2,69,1.0,0,0.0,1,1
3,69,2.0,0,0.0,1,2
100,69,93.0,70,0.14,7,93
200,69,181.0,148,0.64,19,181
2000,69,1785.0,1190,7.56,215,1785
10000,69,8949.0,7869,58.02,1051,8949
20000,69,17997.0,12956,91.82,2003,17997
40000,69,36001.0,19665,125.8,3999,36001
60000,69,54001.0,26835,158.92,5999,54001
80000,69,71921.0,33425,191.43,8079,71921
100000,69,89841.0,40209,225.0,10159,89841
200000,69,179643.0,78119,393.2,20357,179643
400000,69,359510.0,144619,726.45,40490,359510
600000,69,539188.0,211405,1061.16,60812,539188
800000,69,718958.0,278059,1393.91,81042,718958
1000000,69,898536.0,344382,1725.88,101464,898536
2,70,2.0,2,0.0,0,2
3,70,2.0,2,0.0,1,2
100,70,84.0,73,0.38,16,84
200,70,175.0,154,1.01,25,175
2000,70,1797.0,1482,5.13,203,1797
10000,70,8975.0,7824,20.13,1025,8975
20000,70,17980.0,16171,36.29,2020,17980
40000,70,35981.0,32840,70.42,4019,35981
60000,70,53935.0,49532,104.82,6065,53935
80000,70,71867.0,66198,137.65,8133,71867
100000,70,89834.0,82802,171.2,10166,89834
200000,70,179716.0,166130,336.62,20284,179716
400000,70,359141.0,257418,669.88,40859,359141
600000,70,538895.0,419219,1006.02,61105,538895
800000,70,718516.0,585745,1338.19,81484,718516
1000000,70,898171.0,752093,1671.9,101829,898171
2,71,2.0,1,0.01,0,2
3,71,3.0,1,0.01,0,3
100,71,91.0,45,0.17,9,91
200,71,181.0,84,0.32,19,181
2000,71,1805.0,1539,3.88,195,1805
10000,71,9014.0,7786,17.14,986,9014
20000,71,18010.0,13085,34.32,1990,18010
40000,71,35914.0,28559,66.79,4086,35914
60000,71,53811.0,45234,100.24,6189,53811
80000,71,71783.0,52413,133.82,8217,71783
100000,71,89720.0,59021,167.12,10280,89720
200000,71,179511.0,92174,332.07,20489,179511
400000,71,359302.0,158774,666.71,40698,359302
600000,71,538847.0,225589,1000.4,61153,538847
800000,71,718654.0,292194,1333.26,81346,718654
1000000,71,898384.0,359349,1666.27,101616,898384
2,72,2.0,2,0.02,0,2
3,72,3.0,2,0.02,0,3
100,72,89.0,74,0.59,11,89
200,72,175.0,127,0.91,25,175
2000,72,1785.0,1625,12.94,215,1785
10000,72,8980.0,5839,41.67,1020,8980
20000,72,17967.0,9239,58.55,2033,17967
40000,72,36003.0,16024,92.43,3997,36003
60000,72,53911.0,22660,125.52,6089,53911
80000,72,71889.0,31615,159.13,8111,71889
100000,72,89888.0,47394,192.07,10112,89888
200000,72,179844.0,94493,359.02,20156,179844
400000,72,359290.0,208521,693.21,40710,359290
600000,72,539048.0,375045,1026.06,60952,539048
800000,72,718650.0,513506,1358.0,81350,718650
1000000,72,898217.0,623599,1691.49,101783,898217
2,73,2.0,2,0.01,0,2
3,73,2.0,3,0.02,1,2
100,73,91.0,79,0.25,9,91
200,73,183.0,167,0.45,17,183
2000,73,1779.0,1673,3.63,221,1779
10000,73,8955.0,7791,17.04,1045,8955
20000,73,17892.0,14806,34.03,2108,17892
40000,73,35830.0,22165,66.04,4170,35830
60000,73,53844.0,30894,99.82,6156,53844
80000,73,71871.0,37465,132.44,8129,71871
100000,73,89821.0,44139,165.78,10179,89821
200000,73,179681.0,77375,332.14,20319,179681
400000,73,359415.0,144314,665.64,40585,359415
600000,73,539011.0,210877,1001.45,60989,539011
800000,73,718575.0,277793,1336.1,81425,718575
1000000,73,898205.0,344366,1669.48,101795,898205
2,74,2.0,1,0.01,0,2
3,74,3.0,2,0.02,0,3
100,74,92.0,80,0.58,8,92
200,74,187.0,166,1.01,13,187
2000,74,1773.0,1539,3.75,227,1773
10000,74,8949.0,4160,16.45,1051,8949
20000,74,17882.0,8124,33.44,2118,17882
40000,74,35881.0,14891,67.99,4119,35881
60000,74,53884.0,21595,101.67,6116,53884
80000,74,71840.0,28259,135.27,8160,71840
100000,74,89821.0,34866,168.61,10179,89821
200000,74,179549.0,68644,336.62,20451,179549
400000,74,359087.0,135616,671.54,40913,359087
600000,74,538732.0,202222,1005.31,61268,538732
800000,74,718501.0,268482,1335.91,81499,718501
1000000,74,898089.0,335348,1668.56,101911,898089
2,75,2.0,0,0.0,0,2
3,75,3.0,1,0.0,0,3
100,75,89.0,74,0.48,11,89
200,75,183.0,147,1.11,17,183
2000,75,1801.0,1499,5.31,199,1801
10000,75,8978.0,7140,18.99,1022,8978
20000,75,17932.0,14896,36.43,2068,17932
40000,75,35889.0,22837,70.82,4111,35889
60000,75,53802.0,29447,104.12,6198,53802
80000,75,71840.0,36134,138.2,8160,71840
100000,75,89744.0,42750,171.4,10256,89744
200000,75,179528.0,80804,340.34,20472,179528
400000,75,359202.0,247404,672.0,40798,359202
600000,75,538932.0,413998,1006.44,61068,538932
800000,75,718541.0,580811,1340.7,81459,718541
1000000,75,898138.0,712789,1674.57,101862,898138
2,76,1.0,1,0.01,1,1
3,76,2.0,2,0.02,1,2
100,76,92.0,79,0.66,8,92
200,76,187.0,169,1.33,13,187
2000,76,1793.0,1666,13.13,207,1793
10000,76,8971.0,8388,58.12,1029,8971
20000,76,17952.0,16549,74.52,2048,17952
40000,76,35974.0,27157,107.12,4026,35974
60000,76,53903.0,36009,140.1,6097,53903
80000,76,71878.0,52625,173.65,8122,71878
100000,76,89860.0,69229,207.86,10140,89860
200000,76,179727.0,152704,375.19,20273,179727
400000,76,359404.0,289511,705.8,40596,359404
600000,76,539087.0,453498,1038.53,60913,539087
800000,76,718810.0,616296,1374.91,81190,718810
1000000,76,898633.0,682897,1706.74,101367,898633
2,77,2.0,0,0.0,0,2
3,77,3.0,1,0.0,0,3
100,77,92.0,70,0.29,8,92
200,77,183.0,106,0.44,17,183
2000,77,1796.0,1037,3.58,204,1796
10000,77,8974.0,3806,17.26,1026,8974
20000,77,17973.0,7121,33.85,2027,17973
40000,77,35912.0,14084,67.58,4088,35912
60000,77,53903.0,20684,100.52,6097,53903
80000,77,71858.0,29897,134.32,8142,71858
100000,77,89784.0,45980,167.6,10216,89784
200000,77,179514.0,81076,334.94,20486,179514
400000,77,359329.0,147737,667.83,40671,359329
600000,77,539264.0,264188,1000.92,60736,539264
800000,77,718932.0,332323,1334.03,81068,718932
1000000,77,898708.0,423579,1664.08,101292,898708
2,78,2.0,2,0.0,0,2
3,78,2.0,3,0.0,1,2
100,78,87.0,58,0.38,13,87
200,78,175.0,149,1.09,25,175
2000,78,1782.0,955,5.95,218,1782
10000,78,8903.0,3591,18.94,1097,8903
20000,78,17867.0,6970,35.83,2133,17867
40000,78,35886.0,13607,69.01,4114,35886
60000,78,53828.0,20195,101.87,6172,53828
80000,78,71760.0,26884,135.19,8240,71760
100000,78,89741.0,33516,168.77,10259,89741
200000,78,179499.0,66886,335.08,20501,179499
400000,78,359143.0,133484,669.17,40857,359143
600000,78,538778.0,200065,1002.0,61222,538778
800000,78,718464.0,266993,1338.75,81536,718464
1000000,78,898125.0,333610,1672.01,101875,898125
2,79,2.0,0,0.0,0,2
3,79,3.0,0,0.0,0,3
100,79,92.0,76,0.42,8,92
200,79,183.0,152,0.57,17,183
2000,79,1801.0,1544,3.46,199,1801
10000,79,8955.0,6889,17.09,1045,8955
20000,79,18004.0,10193,33.57,1996,18004
40000,79,35901.0,16816,65.91,4099,35901
60000,79,53832.0,23559,99.4,6168,53832
80000,79,71783.0,31024,133.5,8217,71783
100000,79,89718.0,38848,166.95,10282,89718
200000,79,179647.0,72359,334.81,20353,179647
400000,79,359237.0,176965,668.27,40763,359237
600000,79,539039.0,343694,998.96,60961,539039
800000,79,718605.0,500112,1331.43,81395,718605
1000000,79,898266.0,566756,1664.53,101734,898266
2,80,2.0,0,0.0,0,2
3,80,2.0,1,0.01,1,2
100,80,91.0,73,0.31,9,91
200,80,184.0,158,0.93,16,184
2000,80,1806.0,936,4.63,194,1806
10000,80,8998.0,3972,18.56,1002,8998
20000,80,17992.0,7404,35.78,2008,17992
40000,80,35991.0,14369,69.43,4009,35991
60000,80,53976.0,21025,102.84,6024,53976
80000,80,71974.0,27824,136.82,8026,71974
100000,80,89962.0,34433,170.58,10038,89962
200000,80,179813.0,69046,337.33,20187,179813
400000,80,359502.0,135542,669.05,40498,359502
600000,80,539180.0,201839,999.08,60820,539180
800000,80,718841.0,268180,1333.74,81159,718841
1000000,80,898463.0,334756,1667.66,101537,898463
2,81,2.0,2,0.0,0,2
3,81,2.0,3,0.0,1,2
100,81,90.0,48,0.26,10,90
200,81,182.0,106,0.43,18,182
2000,81,1801.0,1594,3.24,199,1801
10000,81,8988.0,8311,16.29,1012,8988
20000,81,17936.0,16633,32.9,2064,17936
40000,81,35927.0,33270,66.05,4073,35927
60000,81,53858.0,49943,99.23,6142,53858
80000,81,71822.0,66733,133.06,8178,71822
100000,81,89789.0,83345,166.39,10211,89789
200000,81,179596.0,166757,333.79,20404,179596
400000,81,359319.0,333108,665.58,40681,359319
600000,81,538905.0,499698,998.87,61095,538905
800000,81,718714.0,666394,1332.72,81286,718714
1000000,81,898359.0,833024,1665.26,101641,898359
2,82,2.0,1,0.01,0,2
3,82,3.0,1,0.01,0,3
100,82,93.0,79,0.48,7,93
200,82,183.0,138,0.97,17,183
2000,82,1794.0,1565,5.12,206,1794
10000,82,9020.0,8146,23.3,980,9020
20000,82,18017.0,16478,39.94,1983,18017
40000,82,35961.0,33195,73.52,4039,35961
60000,82,53951.0,49883,107.18,6049,53951
80000,82,72028.0,66531,140.28,7972,72028
100000,82,89963.0,83254,174.82,10037,89963
200000,82,179837.0,166632,341.33,20163,179837
400000,82,359634.0,324142,670.07,40366,359634
600000,82,539101.0,426626,1004.77,60899,539101
800000,82,718825.0,545479,1335.99,81175,718825
1000000,82,898233.0,709966,1663.62,101767,898233
2,83,2.0,1,0.01,0,2
3,83,3.0,1,0.01,0,3
100,83,90.0,70,0.49,10,90
200,83,177.0,150,1.05,23,177
2000,83,1805.0,1013,6.74,195,1805
10000,83,8964.0,3711,20.36,1036,8964
20000,83,17956.0,7046,36.88,2044,17956
40000,83,35895.0,13720,69.77,4105,35895
60000,83,53835.0,20376,103.17,6165,53835
80000,83,71785.0,27029,136.8,8215,71785
100000,83,89795.0,33758,170.48,10205,89795
200000,83,179675.0,67014,337.36,20325,179675
400000,83,359150.0,133813,673.38,40850,359150
600000,83,538726.0,201410,1005.04,61274,538726
800000,83,718331.0,344048,1343.38,81669,718331
1000000,83,898193.0,510727,1675.5,101807,898193
2,84,1.0,0,0.0,1,1
3,84,1.0,1,0.01,2,1
100,84,88.0,80,0.18,12,88
200,84,178.0,158,0.37,22,178
2000,84,1808.0,1665,3.74,192,1808
10000,84,9074.0,5554,17.1,926,9074
20000,84,18095.0,8922,34.16,1905,18095
40000,84,36084.0,15608,67.13,3916,36084
60000,84,54050.0,22111,99.63,5950,54050
80000,84,72028.0,28731,132.75,7972,72028
100000,84,90084.0,35464,165.36,9916,90084
200000,84,179902.0,99660,332.42,20098,179902
400000,84,359619.0,257541,665.51,40381,359619
600000,84,538940.0,424198,1000.77,61060,538940
800000,84,718610.0,551791,1336.04,81390,718610
1000000,84,898132.0,618326,1668.49,101868,898132
2,85,2.0,2,0.02,0,2
3,85,3.0,3,0.03,0,3
100,85,89.0,41,0.19,11,89
200,85,179.0,78,0.37,21,179
2000,85,1793.0,1503,3.35,207,1793
10000,85,9039.0,4719,17.21,961,9039
20000,85,18046.0,9523,34.26,1954,18046
40000,85,36040.0,23351,68.25,3960,36040
60000,85,53988.0,32511,101.61,6012,53988
80000,85,71952.0,41883,134.36,8048,71952
100000,85,89952.0,56072,167.71,10048,89952
200000,85,179833.0,120214,332.24,20167,179833
400000,85,359568.0,247858,660.12,40432,359568
600000,85,539337.0,338831,993.45,60663,539337
800000,85,719287.0,441498,1327.58,80713,719287
1000000,85,898720.0,583933,1661.89,101280,898720
2,86,2.0,0,0.0,0,2
3,86,2.0,1,0.0,1,2
100,86,90.0,65,0.42,10,90
200,86,181.0,105,0.68,19,181
2000,86,1783.0,1465,10.32,217,1783
10000,86,8968.0,7930,52.11,1032,8968
20000,86,17967.0,16287,80.01,2033,17967
40000,86,35960.0,32949,114.71,4040,35960
60000,86,53854.0,49644,147.57,6146,53854
80000,86,71788.0,66379,180.97,8212,71788
100000,86,89799.0,83071,214.04,10201,89799
200000,86,179626.0,166288,379.65,20374,179626
400000,86,359185.0,325746,712.63,40815,359185
600000,86,539021.0,492449,1045.46,60979,539021
800000,86,718937.0,605559,1378.96,81063,718937
1000000,86,898677.0,671902,1712.92,101323,898677
2,87,2.0,0,0.0,0,2
3,87,2.0,0,0.0,1,2
100,87,86.0,71,0.43,14,86
200,87,177.0,155,1.14,23,177
2000,87,1791.0,860,4.87,209,1791
10000,87,8969.0,4035,18.42,1031,8969
20000,87,17934.0,7268,34.6,2066,17934
40000,87,35914.0,13926,68.97,4086,35914
60000,87,53877.0,20693,102.58,6123,53877
80000,87,71871.0,27449,136.94,8129,71871
100000,87,89875.0,34211,171.34,10125,89875
200000,87,179720.0,67647,338.61,20280,179720
400000,87,359421.0,134024,672.68,40579,359421
600000,87,539412.0,200498,1006.84,60588,539412
800000,87,719049.0,267301,1341.09,80951,719049
1000000,87,898414.0,333713,1670.67,101586,898414
2,88,2.0,1,0.01,0,2
3,88,3.0,1,0.01,0,3
100,88,89.0,82,0.23,11,89
200,88,181.0,168,0.41,19,181
2000,88,1819.0,983,3.76,181,1819
10000,88,8978.0,3781,17.07,1022,8978
20000,88,17974.0,7152,33.9,2026,17974
40000,88,35874.0,13838,66.82,4126,35874
60000,88,53855.0,20513,100.24,6145,53855
80000,88,71780.0,27174,133.91,8220,71780
100000,88,89673.0,33896,167.66,10327,89673
200000,88,179614.0,69626,333.93,20386,179614
400000,88,359427.0,157773,667.59,40573,359427
600000,88,538953.0,252848,1001.42,61047,538953
800000,88,718334.0,360618,1334.44,81666,718334
1000000,88,898066.0,512293,1669.72,101934,898066
2,89,2.0,2,0.02,0,2
3,89,3.0,3,0.03,0,3
100,89,88.0,87,0.58,12,88
200,89,175.0,155,1.0,25,175
2000,89,1804.0,1503,3.87,196,1804
10000,89,9029.0,8178,16.76,971,9029
20000,89,18023.0,16539,33.22,1977,18023
40000,89,35951.0,33142,65.54,4049,35951
60000,89,53898.0,49876,99.38,6102,53898
80000,89,71865.0,66445,132.23,8135,71865
100000,89,89850.0,83001,166.49,10150,89850
200000,89,179617.0,122762,333.18,20383,179617
400000,89,359378.0,189851,668.79,40622,359378
600000,89,538829.0,256701,1003.02,61171,538829
800000,89,718602.0,323476,1335.02,81398,718602
1000000,89,898224.0,390099,1669.59,101776,898224
2,90,2.0,0,0.0,0,2
3,90,3.0,0,0.0,0,3
100,90,88.0,71,0.29,12,88
200,90,176.0,154,0.49,24,176
2000,90,1782.0,1649,3.68,218,1782
10000,90,8966.0,6719,17.18,1034,8966
20000,90,17924.0,14620,34.42,2076,17924
40000,90,35888.0,31336,69.51,4112,35888
60000,90,53932.0,48123,103.63,6068,53932
80000,90,71834.0,64668,135.99,8166,71834
100000,90,89855.0,81401,169.64,10145,89855
200000,90,179668.0,164808,334.41,20332,179668
400000,90,359284.0,331728,668.68,40716,359284
600000,90,538986.0,498243,1002.92,61014,538986
800000,90,718968.0,664841,1336.47,81032,718968
1000000,90,898785.0,831734,1667.57,101215,898785
2,91,2.0,0,0.0,0,2
3,91,3.0,0,0.0,0,3
100,91,93.0,49,0.33,7,93
200,91,184.0,101,0.53,16,184
2000,91,1777.0,1615,3.84,223,1777
10000,91,8950.0,5359,17.47,1050,8950
20000,91,17932.0,10020,33.98,2068,17932
40000,91,35865.0,19822,68.19,4135,35865
60000,91,53829.0,26923,101.64,6171,53829
80000,91,71751.0,34037,135.24,8249,71751
100000,91,89777.0,40656,168.62,10223,89777
200000,91,179688.0,73782,334.14,20312,179688
400000,91,359375.0,140647,670.6,40625,359375
600000,91,538854.0,206913,1001.1,61146,538854
800000,91,718340.0,273441,1333.46,81660,718340
1000000,91,897968.0,339777,1665.18,102032,897968
2,92,2.0,0,0.0,0,2
3,92,3.0,0,0.0,0,3
100,92,89.0,71,0.44,11,89
200,92,175.0,156,0.73,25,175
2000,92,1814.0,1560,3.67,186,1814
10000,92,8978.0,8025,17.31,1022,8978
20000,92,17980.0,16309,34.18,2020,17980
40000,92,36020.0,24471,67.28,3980,36020
60000,92,53963.0,38251,99.98,6037,53963
80000,92,71918.0,46964,133.62,8082,71918
100000,92,89869.0,54079,167.19,10131,89869
200000,92,179703.0,122439,331.93,20297,179703
400000,92,359011.0,205281,662.68,40989,359011
600000,92,538529.0,271451,992.82,61471,538529
800000,92,718339.0,338464,1327.49,81661,718339
1000000,92,898025.0,405509,1659.93,101975,898025
2,93,2.0,2,0.0,0,2
3,93,3.0,2,0.0,0,3
100,93,90.0,70,0.46,10,90
200,93,185.0,105,0.63,15,185
2000,93,1826.0,696,3.85,174,1826
10000,93,9044.0,3351,16.79,956,9044
20000,93,18102.0,6662,33.28,1898,18102
40000,93,36040.0,14719,66.69,3960,36040
60000,93,53972.0,21822,100.3,6028,53972
80000,93,71915.0,28561,134.22,8085,71915
100000,93,89885.0,35249,167.39,10115,89885
200000,93,179844.0,68866,333.7,20156,179844
400000,93,359769.0,143434,666.2,40231,359769
600000,93,539474.0,270650,996.16,60526,539474
800000,93,719116.0,347923,1328.99,80884,719116
1000000,93,898932.0,414519,1662.26,101068,898932
2,94,2.0,0,0.0,0,2
3,94,3.0,0,0.0,0,3
100,94,82.0,28,0.13,18,82
200,94,174.0,89,0.46,26,174
2000,94,1820.0,1575,4.26,180,1820
10000,94,8977.0,8204,18.24,1023,8977
20000,94,18047.0,16608,35.21,1953,18047
40000,94,36060.0,33192,67.81,3940,36060
60000,94,54053.0,44297,101.1,5947,54053
80000,94,71994.0,55335,133.51,8006,71994
100000,94,89997.0,63160,167.83,10003,89997
200000,94,179754.0,118609,335.31,20246,179754
400000,94,359255.0,238456,669.28,40745,359255
600000,94,538609.0,311021,1004.97,61391,538609
800000,94,718305.0,463692,1338.9,81695,718305
1000000,94,898013.0,579816,1672.3,101987,898013
2,95,2.0,1,0.01,0,2
3,95,3.0,1,0.01,0,3
100,95,87.0,37,0.14,13,87
200,95,181.0,109,0.7,19,181
2000,95,1813.0,1087,6.89,187,1813
10000,95,9000.0,7033,22.61,1000,9000
20000,95,17980.0,13340,39.19,2020,17980
40000,95,35965.0,28374,72.84,4035,35965
60000,95,53994.0,45062,106.48,6006,53994
80000,95,71946.0,61697,139.42,8054,71946
100000,95,89940.0,78323,173.85,10060,89940
200000,95,179791.0,141913,340.36,20209,179791
400000,95,359330.0,275370,677.32,40670,359330
600000,95,539010.0,441755,1010.6,60990,539010
800000,95,718714.0,608630,1344.85,81286,718714
1000000,95,898503.0,775224,1679.45,101497,898503
2,96,2.0,2,0.0,0,2
3,96,3.0,3,0.0,0,3
100,96,92.0,79,0.63,8,92
200,96,184.0,151,1.2,16,184
2000,96,1779.0,1661,7.34,221,1779
10000,96,9025.0,8304,20.35,975,9025
20000,96,17957.0,16622,36.53,2043,17957
40000,96,35947.0,33033,70.23,4053,35947
60000,96,53955.0,49802,103.97,6045,53955
80000,96,71982.0,66460,137.33,8018,71982
100000,96,89992.0,83145,169.95,10008,89992
200000,96,179921.0,163485,337.12,20079,179921
400000,96,359582.0,327712,671.52,40418,359582
600000,96,539253.0,483116,1005.84,60747,539253
800000,96,718881.0,649488,1339.9,81119,718881
1000000,96,898513.0,816117,1671.09,101487,898513
2,97,2.0,2,0.02,0,2
3,97,3.0,3,0.03,0,3
100,97,91.0,48,0.33,9,91
200,97,176.0,91,0.48,24,176
2000,97,1776.0,706,3.38,224,1776
10000,97,9007.0,3323,16.46,993,9007
20000,97,17989.0,7605,33.7,2011,17989
40000,97,36007.0,14352,67.28,3993,36007
60000,97,53989.0,20959,100.01,6011,53989
80000,97,71948.0,31533,133.58,8052,71948
100000,97,89935.0,39384,166.22,10065,89935
200000,97,179809.0,93235,333.93,20191,179809
400000,97,359622.0,229445,669.01,40378,359622
600000,97,539322.0,322546,1002.58,60678,539322
800000,97,718739.0,389810,1335.22,81261,718739
1000000,97,898587.0,456465,1667.53,101413,898587
2,98,1.0,1,0.01,1,1
3,98,2.0,2,0.02,1,2
100,98,90.0,38,0.18,10,90
200,98,182.0,89,0.35,18,182
2000,98,1798.0,1252,3.07,202,1798
10000,98,8996.0,7404,16.6,1004,8996
20000,98,18028.0,12237,32.97,1972,18028
40000,98,36011.0,19018,66.16,3989,36011
60000,98,54044.0,25726,99.43,5956,54044
80000,98,72016.0,32316,132.64,7984,72016
100000,98,89969.0,39001,166.45,10031,89969
200000,98,179815.0,72655,334.6,20185,179815
400000,98,359198.0,139480,667.57,40802,359198
600000,98,538904.0,277932,1003.63,61096,538904
800000,98,718626.0,444627,1333.92,81374,718626
1000000,98,898204.0,610790,1667.51,101796,898204
2,99,1.0,0,0.0,1,1
3,99,2.0,1,0.0,1,2
100,99,88.0,59,0.44,12,88
200,99,177.0,97,0.67,23,177
2000,99,1798.0,716,3.59,202,1798
10000,99,8971.0,3436,17.29,1029,8971
20000,99,17952.0,7794,34.31,2048,17952
40000,99,36001.0,15863,67.92,3999,36001
60000,99,53970.0,22533,101.07,6030,53970
80000,99,72041.0,29265,134.29,7959,72041
100000,99,89967.0,35851,167.35,10033,89967
200000,99,179854.0,68916,332.09,20146,179854
400000,99,359422.0,135384,664.04,40578,359422
600000,99,538933.0,202134,997.28,61067,538933
800000,99,718542.0,269266,1332.39,81458,718542
1000000,99,898245.0,335774,1665.65,101755,898245
2,100,2.0,0,0.0,0,2
3,100,3.0,0,0.0,0,3
100,100,96.0,43,0.24,4,96
200,100,189.0,122,0.52,11,189
2000,100,1811.0,1350,4.09,189,1811
10000,100,8968.0,7365,17.06,1032,8968
20000,100,17927.0,15620,34.23,2073,17927
40000,100,35921.0,32315,67.9,4079,35921
60000,100,53877.0,48972,100.97,6123,53877
80000,100,71891.0,65173,133.78,8109,71891
100000,100,89874.0,81078,166.99,10126,89874
200000,100,179868.0,116405,334.65,20132,179868
400000,100,359304.0,208173,666.34,40696,359304
600000,100,538739.0,313626,998.69,61261,538739
800000,100,718215.0,399889,1332.8,81785,718215
1000000,100,897844.0,466154,1667.0,102156,897844
