Timestep,Iteration,Total Reward,Suboptimal Arms,Total Regret,Zeros Count,Ones Count
2,1,2.0,1,0.01,0,2
3,1,3.0,1,0.01,0,3
100,1,93.0,78,0.39,7,93
200,1,185.0,162,0.81,15,185
2000,1,1787.0,1700,8.5,213,1787
10000,1,8937.0,8331,41.66,1063,8937
20000,1,17794.0,16673,83.36,2206,17794
40000,1,35540.0,32965,164.82,4460,35540
60000,1,53372.0,43473,217.36,6628,53372
80000,1,71228.0,50190,250.95,8772,71228
100000,1,88975.0,56821,284.1,11025,88975
200000,1,178226.0,90114,450.57,21774,178226
400000,1,356648.0,156810,784.05,43352,356648
600000,1,535424.0,223267,1116.34,64576,535424
800000,1,713813.0,290170,1450.85,86187,713813
1000000,1,892575.0,356686,1783.43,107425,892575
2,2,1.0,0,0.0,1,1
3,2,2.0,0,0.0,1,2
100,2,83.0,71,0.36,17,83
200,2,174.0,148,0.74,26,174
2000,2,1779.0,1048,5.24,221,1779
10000,2,8933.0,3779,18.9,1067,8933
20000,2,17890.0,7123,35.61,2110,17890
40000,2,35755.0,13809,69.05,4245,35755
60000,2,53540.0,21935,109.67,6460,53540
80000,2,71377.0,29106,145.53,8623,71377
100000,2,89336.0,35740,178.7,10664,89336
200000,2,178731.0,69044,345.22,21269,178731
400000,2,357303.0,135525,677.62,42697,357303
600000,2,536081.0,202249,1011.24,63919,536081
800000,2,714679.0,269036,1345.18,85321,714679
1000000,2,893198.0,335446,1677.23,106802,893198
2,3,1.0,0,0.0,1,1
3,3,2.0,1,0.01,1,2
100,3,89.0,94,0.47,11,89
200,3,178.0,170,0.85,22,178
2000,3,1775.0,1679,8.39,225,1775
10000,3,8896.0,7243,36.22,1104,8896
20000,3,17828.0,15107,75.54,2172,17828
40000,3,35624.0,25543,127.71,4376,35624
60000,3,53504.0,32102,160.51,6496,53504
80000,3,71391.0,38661,193.3,8609,71391
100000,3,89239.0,45320,226.6,10761,89239
200000,3,178596.0,78428,392.14,21404,178596
400000,3,357371.0,144930,724.65,42629,357371
600000,3,535893.0,211665,1058.32,64107,535893
800000,3,714682.0,278734,1393.67,85318,714682
1000000,3,893249.0,345435,1727.18,106751,893249
2,4,2.0,0,0.0,0,2
3,4,3.0,0,0.0,0,3
100,4,90.0,69,0.35,10,90
200,4,177.0,142,0.71,23,177
2000,4,1797.0,1449,7.24,203,1797
10000,4,8963.0,5493,27.46,1037,8963
20000,4,17910.0,8887,44.44,2090,17910
40000,4,35702.0,15582,77.91,4298,35702
60000,4,53623.0,22104,110.52,6377,53623
80000,4,71462.0,28884,144.42,8538,71462
100000,4,89424.0,35542,177.71,10576,89424
200000,4,178836.0,68871,344.35,21164,178836
400000,4,357356.0,135695,678.47,42644,357356
600000,4,535799.0,202275,1011.37,64201,535799
800000,4,714449.0,269100,1345.5,85551,714449
1000000,4,892910.0,335502,1677.51,107090,892910
2,5,2.0,1,0.01,0,2
3,5,3.0,1,0.01,0,3
100,5,90.0,67,0.34,10,90
200,5,183.0,151,0.76,17,183
2000,5,1787.0,1636,8.18,213,1787
10000,5,8924.0,7922,39.61,1076,8924
20000,5,17850.0,11556,57.78,2150,17850
40000,5,35663.0,20269,101.34,4337,35663
60000,5,53490.0,26850,134.25,6510,53490
80000,5,71414.0,35051,175.25,8586,71414
100000,5,89300.0,41759,208.79,10700,89300
200000,5,178641.0,75103,375.51,21359,178641
400000,5,357489.0,141376,706.88,42511,357489
600000,5,535929.0,208045,1040.22,64071,535929
800000,5,714628.0,274522,1372.61,85372,714628
1000000,5,893276.0,341450,1707.25,106724,893276
2,6,2.0,2,0.01,0,2
3,6,3.0,3,0.02,0,3
100,6,93.0,38,0.19,7,93
200,6,182.0,77,0.39,18,182
2000,6,1789.0,703,3.51,211,1789
10000,6,8986.0,3408,17.04,1014,8986
20000,6,17956.0,7773,38.87,2044,17956
40000,6,35837.0,14503,72.52,4163,35837
60000,6,53572.0,21016,105.08,6428,53572
80000,6,71415.0,27637,138.18,8585,71415
100000,6,89242.0,34397,171.98,10758,89242
200000,6,178524.0,67723,338.61,21476,178524
400000,6,357215.0,134408,672.04,42785,357215
600000,6,535627.0,201338,1006.69,64373,535627
800000,6,714355.0,267950,1339.75,85645,714355
1000000,6,892997.0,334393,1671.97,107003,892997
2,7,2.0,0,0.0,0,2
3,7,2.0,0,0.0,1,2
100,7,91.0,77,0.39,9,91
200,7,178.0,161,0.81,22,178
2000,7,1790.0,1674,8.37,210,1790
10000,7,8961.0,8300,41.5,1039,8961
20000,7,17878.0,16657,83.28,2122,17878
40000,7,35640.0,28657,143.28,4360,35640
60000,7,53453.0,41643,208.21,6547,53453
80000,7,71332.0,48305,241.52,8668,71332
100000,7,89225.0,54837,274.18,10775,89225
200000,7,178572.0,88013,440.06,21428,178572
400000,7,357411.0,154673,773.36,42589,357411
600000,7,536046.0,221922,1109.61,63954,536046
800000,7,714872.0,288569,1442.85,85128,714872
1000000,7,893573.0,355405,1777.03,106427,893573
2,8,1.0,2,0.01,1,1
3,8,2.0,3,0.02,1,2
100,8,88.0,60,0.3,12,88
200,8,172.0,119,0.6,28,172
2000,8,1784.0,941,4.7,216,1784
10000,8,8907.0,3892,19.46,1093,8907
20000,8,17840.0,7158,35.79,2160,17840
40000,8,35633.0,13926,69.63,4367,35633
60000,8,53559.0,20582,102.91,6441,53559
80000,8,71358.0,27170,135.85,8642,71358
100000,8,89254.0,33898,169.49,10746,89254
200000,8,178579.0,69160,345.8,21421,178579
400000,8,357291.0,135690,678.45,42709,357291
600000,8,535884.0,202897,1014.48,64116,535884
800000,8,714478.0,269790,1348.95,85522,714478
1000000,8,892822.0,336608,1683.04,107178,892822
2,9,2.0,2,0.01,0,2
3,9,3.0,2,0.01,0,3
100,9,92.0,71,0.36,8,92
200,9,185.0,130,0.65,15,185
2000,9,1779.0,1044,5.22,221,1779
10000,9,8912.0,4805,24.02,1088,8912
20000,9,17913.0,8193,40.97,2087,17913
40000,9,35760.0,14849,74.25,4240,35760
60000,9,53632.0,21602,108.01,6368,53632
80000,9,71560.0,28275,141.37,8440,71560
100000,9,89477.0,34857,174.28,10523,89477
200000,9,178836.0,68007,340.03,21164,178836
400000,9,357540.0,134348,671.74,42460,357540
600000,9,536251.0,201307,1006.53,63749,536251
800000,9,714854.0,268378,1341.89,85146,714854
1000000,9,893394.0,334851,1674.26,106606,893394
2,10,2.0,0,0.0,0,2
3,10,3.0,1,0.01,0,3
100,10,89.0,34,0.17,11,89
200,10,177.0,56,0.28,23,177
2000,10,1781.0,1170,5.85,219,1781
10000,10,8910.0,6283,31.41,1090,8910
20000,10,17818.0,9631,48.16,2182,17818
40000,10,35818.0,16305,81.52,4182,35818
60000,10,53672.0,22959,114.79,6328,53672
80000,10,71494.0,29656,148.28,8506,71494
100000,10,89373.0,36280,181.4,10627,89373
200000,10,178821.0,69740,348.7,21179,178821
400000,10,357541.0,136169,680.84,42459,357541
600000,10,535921.0,203196,1015.98,64079,535921
800000,10,714576.0,269623,1348.12,85424,714576
1000000,10,893149.0,336306,1681.53,106851,893149
2,11,2.0,0,0.0,0,2
3,11,3.0,1,0.01,0,3
100,11,91.0,41,0.21,9,91
200,11,185.0,126,0.63,15,185
2000,11,1791.0,1551,7.75,209,1791
10000,11,8903.0,6487,32.43,1097,8903
20000,11,17863.0,9794,48.97,2137,17863
40000,11,35733.0,16562,82.81,4267,35733
60000,11,53540.0,23205,116.02,6460,53540
80000,11,71416.0,29865,149.32,8584,71416
100000,11,89328.0,36560,182.8,10672,89328
200000,11,178599.0,69986,349.93,21401,178599
400000,11,357427.0,136799,683.99,42573,357427
600000,11,536322.0,203652,1018.26,63678,536322
800000,11,714908.0,270441,1352.21,85092,714908
1000000,11,893478.0,337250,1686.25,106522,893478
2,12,2.0,0,0.0,0,2
3,12,3.0,0,0.0,0,3
100,12,87.0,72,0.36,13,87
200,12,175.0,149,0.75,25,175
2000,12,1785.0,1056,5.28,215,1785
10000,12,8930.0,4867,24.33,1070,8930
20000,12,17831.0,9753,48.77,2169,17831
40000,12,35737.0,19194,95.97,4263,35737
60000,12,53585.0,31715,158.57,6415,53585
80000,12,71368.0,42041,210.2,8632,71368
100000,12,89236.0,48812,244.06,10764,89236
200000,12,178549.0,82010,410.05,21451,178549
400000,12,357322.0,148280,741.4,42678,357322
600000,12,536022.0,215142,1075.71,63978,536022
800000,12,714779.0,281890,1409.45,85221,714779
1000000,12,893632.0,348570,1742.85,106368,893632
2,13,2.0,0,0.0,0,2
3,13,3.0,0,0.0,0,3
100,13,93.0,75,0.38,7,93
200,13,183.0,150,0.75,17,183
2000,13,1786.0,1550,7.75,214,1786
10000,13,8911.0,8225,41.13,1089,8911
20000,13,17839.0,16514,82.57,2161,17839
40000,13,35691.0,28538,142.69,4309,35691
60000,13,53539.0,37709,188.54,6461,53539
80000,13,71392.0,44437,222.18,8608,71392
100000,13,89284.0,51196,255.98,10716,89284
200000,13,178618.0,84534,422.67,21382,178618
400000,13,357150.0,151510,757.55,42850,357150
600000,13,535719.0,218071,1090.36,64281,535719
800000,13,714334.0,284585,1422.93,85666,714334
1000000,13,893178.0,351515,1757.58,106822,893178
2,14,1.0,2,0.01,1,1
3,14,2.0,3,0.02,1,2
100,14,91.0,40,0.2,9,91
200,14,180.0,73,0.37,20,180
2000,14,1776.0,859,4.29,224,1776
10000,14,8968.0,3488,17.44,1032,8968
20000,14,17869.0,6807,34.03,2131,17869
40000,14,35642.0,13820,69.1,4358,35642
60000,14,53516.0,20561,102.8,6484,53516
80000,14,71437.0,27293,136.46,8563,71437
100000,14,89286.0,33920,169.6,10714,89286
200000,14,178565.0,67506,337.53,21435,178565
400000,14,357281.0,134635,673.17,42719,357281
600000,14,535989.0,201114,1005.57,64011,535989
800000,14,714759.0,267333,1336.67,85241,714759
1000000,14,893125.0,334101,1670.51,106875,893125
2,15,2.0,0,0.0,0,2
3,15,2.0,0,0.0,1,2
100,15,89.0,61,0.31,11,89
200,15,179.0,124,0.62,21,179
2000,15,1797.0,1605,8.02,203,1797
10000,15,8986.0,5748,28.74,1014,8986
20000,15,17962.0,9066,45.33,2038,17962
40000,15,35748.0,16782,83.91,4252,35748
60000,15,53560.0,23681,118.4,6440,53560
80000,15,71490.0,30392,151.96,8510,71490
100000,15,89382.0,37014,185.07,10618,89382
200000,15,178578.0,70229,351.14,21422,178578
400000,15,357050.0,136937,684.68,42950,357050
600000,15,535769.0,203544,1017.72,64231,535769
800000,15,714474.0,270271,1351.36,85526,714474
1000000,15,893268.0,336683,1683.42,106732,893268
2,16,2.0,1,0.01,0,2
3,16,3.0,1,0.01,0,3
100,16,92.0,83,0.42,8,92
200,16,181.0,148,0.74,19,181
2000,16,1794.0,1275,6.37,206,1794
10000,16,8965.0,5652,28.26,1035,8965
20000,16,17916.0,8998,44.99,2084,17916
40000,16,35729.0,16241,81.2,4271,35729
60000,16,53641.0,22902,114.51,6359,53641
80000,16,71565.0,29547,147.73,8435,71565
100000,16,89435.0,36267,181.33,10565,89435
200000,16,179096.0,69434,347.17,20904,179096
400000,16,357702.0,135807,679.03,42298,357702
600000,16,536429.0,202610,1013.05,63571,536429
800000,16,715274.0,269045,1345.23,84726,715274
1000000,16,893812.0,335400,1677.0,106188,893812
2,17,2.0,0,0.0,0,2
3,17,3.0,0,0.0,0,3
100,17,90.0,63,0.32,10,90
200,17,183.0,147,0.74,17,183
2000,17,1792.0,1662,8.31,208,1792
10000,17,8949.0,5924,29.62,1051,8949
20000,17,17899.0,9351,46.76,2101,17899
40000,17,35717.0,16046,80.23,4283,35717
60000,17,53599.0,22703,113.51,6401,53599
80000,17,71484.0,29343,146.71,8516,71484
100000,17,89364.0,35926,179.63,10636,89364
200000,17,178787.0,69082,345.41,21213,178787
400000,17,357605.0,135655,678.27,42395,357605
600000,17,536285.0,201960,1009.8,63715,536285
800000,17,714714.0,268432,1342.16,85286,714714
1000000,17,893321.0,334963,1674.82,106679,893321
2,18,2.0,0,0.0,0,2
3,18,3.0,1,0.01,0,3
100,18,89.0,74,0.37,11,89
200,18,177.0,165,0.83,23,177
2000,18,1780.0,1113,5.56,220,1780
10000,18,8883.0,6424,32.12,1117,8883
20000,18,17775.0,10802,54.01,2225,17775
40000,18,35690.0,17589,87.94,4310,35690
60000,18,53579.0,24224,121.12,6421,53579
80000,18,71366.0,30937,154.68,8634,71366
100000,18,89219.0,37599,187.99,10781,89219
200000,18,178582.0,70790,353.95,21418,178582
400000,18,357163.0,137389,686.94,42837,357163
600000,18,535930.0,204176,1020.88,64070,535930
800000,18,714529.0,270593,1352.97,85471,714529
1000000,18,893235.0,337225,1686.13,106765,893235
2,19,2.0,0,0.0,0,2
3,19,3.0,0,0.0,0,3
100,19,90.0,73,0.37,10,90
200,19,182.0,149,0.75,18,182
2000,19,1777.0,1237,6.18,223,1777
10000,19,8870.0,5785,28.92,1130,8870
20000,19,17822.0,10642,53.21,2178,17822
40000,19,35606.0,17880,89.4,4394,35606
60000,19,53432.0,29214,146.07,6568,53432
80000,19,71234.0,45410,227.05,8766,71234
100000,19,89112.0,51980,259.9,10888,89112
200000,19,178240.0,85451,427.25,21760,178240
400000,19,356794.0,152504,762.52,43206,356794
600000,19,535501.0,219373,1096.87,64499,535501
800000,19,713983.0,285840,1429.2,86017,713983
1000000,19,892652.0,352753,1763.77,107348,892652
2,20,2.0,1,0.01,0,2
3,20,3.0,1,0.01,0,3
100,20,92.0,58,0.29,8,92
200,20,182.0,140,0.7,18,182
2000,20,1773.0,862,4.31,227,1773
10000,20,8886.0,6379,31.89,1114,8886
20000,20,17774.0,14705,73.53,2226,17774
40000,20,35567.0,31399,156.99,4433,35567
60000,20,53311.0,48078,240.39,6689,53311
80000,20,71092.0,64793,323.96,8908,71092
100000,20,88922.0,81464,407.32,11078,88922
200000,20,178243.0,115212,576.06,21757,178243
400000,20,356974.0,181981,909.9,43026,356974
600000,20,535686.0,248560,1242.8,64314,535686
800000,20,714453.0,315182,1575.91,85547,714453
1000000,20,892917.0,382016,1910.08,107083,892917
2,21,2.0,0,0.0,0,2
3,21,3.0,0,0.0,0,3
100,21,90.0,69,0.35,10,90
200,21,182.0,136,0.68,18,182
2000,21,1787.0,1326,6.63,213,1787
10000,21,8944.0,4825,24.12,1056,8944
20000,21,17860.0,8257,41.29,2140,17860
40000,21,35706.0,14907,74.54,4294,35706
60000,21,53612.0,21615,108.07,6388,53612
80000,21,71526.0,28223,141.11,8474,71526
100000,21,89320.0,34976,174.88,10680,89320
200000,21,178594.0,68215,341.07,21406,178594
400000,21,357241.0,134781,673.9,42759,357241
600000,21,535893.0,201400,1007.0,64107,535893
800000,21,714747.0,268127,1340.64,85253,714747
1000000,21,893204.0,334778,1673.89,106796,893204
2,22,2.0,1,0.01,0,2
3,22,3.0,1,0.01,0,3
100,22,93.0,64,0.32,7,93
200,22,181.0,137,0.69,19,181
2000,22,1793.0,1187,5.93,207,1793
10000,22,8933.0,6112,30.56,1067,8933
20000,22,17816.0,11253,56.27,2184,17816
40000,22,35676.0,18290,91.45,4324,35676
60000,22,53532.0,25620,128.1,6468,53532
80000,22,71475.0,32417,162.08,8525,71475
100000,22,89346.0,39119,195.59,10654,89346
200000,22,178873.0,72631,363.15,21127,178873
400000,22,357523.0,139079,695.39,42477,357523
600000,22,536461.0,205954,1029.77,63539,536461
800000,22,715140.0,272622,1363.11,84860,715140
1000000,22,893740.0,339595,1697.98,106260,893740
2,23,1.0,1,0.01,1,1
3,23,2.0,2,0.01,1,2
100,23,85.0,81,0.41,15,85
200,23,172.0,164,0.82,28,172
2000,23,1759.0,1638,8.19,241,1759
10000,23,8895.0,8314,41.57,1105,8895
20000,23,17792.0,13828,69.14,2208,17792
40000,23,35594.0,23631,118.15,4406,35594
60000,23,53442.0,30317,151.58,6558,53442
80000,23,71307.0,36909,184.54,8693,71307
100000,23,89163.0,43516,217.58,10837,89163
200000,23,178493.0,76721,383.6,21507,178493
400000,23,357141.0,143414,717.07,42859,357141
600000,23,535731.0,209924,1049.62,64269,535731
800000,23,714379.0,276474,1382.37,85621,714379
1000000,23,893169.0,343011,1715.06,106831,893169
2,24,2.0,2,0.01,0,2
3,24,3.0,3,0.02,0,3
100,24,89.0,45,0.23,11,89
200,24,177.0,86,0.43,23,177
2000,24,1767.0,707,3.53,233,1767
10000,24,8872.0,3389,16.95,1128,8872
20000,24,17857.0,6706,33.53,2143,17857
40000,24,35759.0,14537,72.69,4241,35759
60000,24,53572.0,21173,105.86,6428,53572
80000,24,71413.0,27744,138.72,8587,71413
100000,24,89356.0,34562,172.81,10644,89356
200000,24,178602.0,67721,338.6,21398,178602
400000,24,357231.0,134108,670.54,42769,357231
600000,24,535725.0,200998,1004.99,64275,535725
800000,24,714279.0,267891,1339.46,85721,714279
1000000,24,892962.0,335012,1675.06,107038,892962
2,25,2.0,0,0.0,0,2
3,25,3.0,1,0.01,0,3
100,25,85.0,39,0.2,15,85
200,25,178.0,115,0.58,22,178
2000,25,1789.0,1626,8.13,211,1789
10000,25,8938.0,6865,34.32,1062,8938
20000,25,17851.0,15204,76.02,2149,17851
40000,25,35667.0,31850,159.25,4333,35667
60000,25,53356.0,48516,242.58,6644,53356
80000,25,71234.0,59662,298.31,8766,71234
100000,25,89107.0,66337,331.68,10893,89107
200000,25,178435.0,99451,497.25,21565,178435
400000,25,357279.0,166097,830.48,42721,357279
600000,25,535918.0,233448,1167.24,64082,535918
800000,25,714518.0,300083,1500.42,85482,714518
1000000,25,893286.0,366637,1833.19,106714,893286
2,26,2.0,0,0.0,0,2
3,26,3.0,0,0.0,0,3
100,26,91.0,79,0.4,9,91
200,26,174.0,160,0.8,26,174
2000,26,1789.0,1668,8.34,211,1789
10000,26,8977.0,4580,22.9,1023,8977
20000,26,17872.0,7966,39.83,2128,17872
40000,26,35743.0,14638,73.19,4257,35743
60000,26,53594.0,21306,106.53,6406,53594
80000,26,71460.0,31698,158.49,8540,71460
100000,26,89345.0,40356,201.78,10655,89345
200000,26,178660.0,73866,369.33,21340,178660
400000,26,357480.0,140277,701.38,42520,357480
600000,26,535965.0,206791,1033.95,64035,535965
800000,26,714561.0,273312,1366.56,85439,714561
1000000,26,893232.0,340147,1700.74,106768,893232
2,27,2.0,0,0.0,0,2
3,27,3.0,0,0.0,0,3
100,27,91.0,49,0.25,9,91
200,27,179.0,97,0.49,21,179
2000,27,1797.0,999,4.99,203,1797
10000,27,8931.0,4131,20.66,1069,8931
20000,27,17901.0,7492,37.46,2099,17901
40000,27,35692.0,18461,92.3,4308,35692
60000,27,53474.0,32394,161.97,6526,53474
80000,27,71368.0,39026,195.13,8632,71368
100000,27,89165.0,45756,228.78,10835,89165
200000,27,178499.0,79142,395.71,21501,178499
400000,27,357039.0,146006,730.03,42961,357039
600000,27,535487.0,212618,1063.09,64513,535487
800000,27,714158.0,279061,1395.31,85842,714158
1000000,27,892768.0,345693,1728.47,107232,892768
2,28,2.0,1,0.01,0,2
3,28,3.0,1,0.01,0,3
100,28,94.0,77,0.39,6,94
200,28,180.0,150,0.75,20,180
2000,28,1789.0,847,4.23,211,1789
10000,28,8915.0,7182,35.91,1085,8915
20000,28,17826.0,11067,55.34,2174,17826
40000,28,35679.0,17744,88.72,4321,35679
60000,28,53571.0,24336,121.68,6429,53571
80000,28,71375.0,31013,155.06,8625,71375
100000,28,89240.0,37771,188.85,10760,89240
200000,28,178614.0,71147,355.73,21386,178614
400000,28,357296.0,137589,687.94,42704,357296
600000,28,535751.0,204239,1021.19,64249,535751
800000,28,714298.0,270773,1353.87,85702,714298
1000000,28,892870.0,337208,1686.04,107130,892870
2,29,2.0,2,0.01,0,2
3,29,2.0,3,0.02,1,2
100,29,91.0,87,0.44,9,91
200,29,177.0,171,0.86,23,177
2000,29,1773.0,1634,8.17,227,1773
10000,29,8918.0,7127,35.63,1082,8918
20000,29,17823.0,13736,68.68,2177,17823
40000,29,35617.0,26694,133.47,4383,35617
60000,29,53474.0,33245,166.22,6526,53474
80000,29,71294.0,39978,199.89,8706,71294
100000,29,89108.0,46603,233.01,10892,89108
200000,29,178409.0,79755,398.77,21591,178409
400000,29,357277.0,146670,733.35,42723,357277
600000,29,535736.0,213294,1066.47,64264,535736
800000,29,714235.0,279698,1398.49,85765,714235
1000000,29,893033.0,346399,1732.0,106967,893033
2,30,2.0,0,0.0,0,2
3,30,3.0,1,0.01,0,3
100,30,90.0,64,0.32,10,90
200,30,179.0,123,0.62,21,179
2000,30,1825.0,1570,7.85,175,1825
10000,30,9002.0,7069,35.34,998,9002
20000,30,17946.0,13615,68.08,2054,17946
40000,30,35707.0,29431,147.15,4293,35707
60000,30,53548.0,38327,191.63,6452,53548
80000,30,71500.0,44941,224.7,8500,71500
100000,30,89369.0,51660,258.3,10631,89369
200000,30,178824.0,85139,425.69,21176,178824
400000,30,357375.0,151706,758.53,42625,357375
600000,30,535922.0,218455,1092.28,64078,535922
800000,30,714600.0,284950,1424.75,85400,714600
1000000,30,893329.0,351892,1759.46,106671,893329
2,31,1.0,2,0.01,1,1
3,31,2.0,3,0.02,1,2
100,31,86.0,35,0.18,14,86
200,31,173.0,67,0.34,27,173
2000,31,1774.0,1489,7.44,226,1774
10000,31,8933.0,8167,40.84,1067,8933
20000,31,17867.0,15933,79.67,2133,17867
40000,31,35730.0,27926,139.63,4270,35730
60000,31,53572.0,39838,199.19,6428,53572
80000,31,71417.0,49467,247.33,8583,71417
100000,31,89300.0,56139,280.69,10700,89300
200000,31,178426.0,93359,466.79,21574,178426
400000,31,357192.0,159912,799.56,42808,357192
600000,31,535537.0,226370,1131.85,64463,535537
800000,31,714119.0,292495,1462.48,85881,714119
1000000,31,892622.0,359745,1798.73,107378,892622
2,32,2.0,0,0.0,0,2
3,32,3.0,0,0.0,0,3
100,32,92.0,61,0.31,8,92
200,32,183.0,149,0.75,17,183
2000,32,1783.0,1604,8.02,217,1783
10000,32,8917.0,6191,30.95,1083,8917
20000,32,17883.0,9622,48.11,2117,17883
40000,32,35774.0,16254,81.27,4226,35774
60000,32,53625.0,22931,114.65,6375,53625
80000,32,71511.0,29561,147.8,8489,71511
100000,32,89254.0,36172,180.86,10746,89254
200000,32,178441.0,69545,347.72,21559,178441
400000,32,357011.0,136235,681.17,42989,357011
600000,32,535864.0,203016,1015.08,64136,535864
800000,32,714353.0,269915,1349.58,85647,714353
1000000,32,893055.0,336615,1683.08,106945,893055
2,33,2.0,1,0.01,0,2
3,33,3.0,1,0.01,0,3
100,33,88.0,41,0.21,12,88
200,33,176.0,76,0.38,24,176
2000,33,1808.0,650,3.25,192,1808
10000,33,8969.0,3325,16.63,1031,8969
20000,33,17870.0,6678,33.39,2130,17870
40000,33,35706.0,13323,66.62,4294,35706
60000,33,53564.0,19980,99.9,6436,53564
80000,33,71363.0,26559,132.79,8637,71363
100000,33,89224.0,33154,165.77,10776,89224
200000,33,178690.0,66621,333.1,21310,178690
400000,33,357379.0,133425,667.12,42621,357379
600000,33,536114.0,200043,1000.21,63886,536114
800000,33,714928.0,266665,1333.33,85072,714928
1000000,33,893516.0,333241,1666.21,106484,893516
2,34,2.0,1,0.01,0,2
3,34,3.0,1,0.01,0,3
100,34,91.0,71,0.36,9,91
200,34,182.0,154,0.77,18,182
2000,34,1766.0,1467,7.33,234,1766
10000,34,8897.0,4289,21.45,1103,8897
20000,34,17867.0,7608,38.04,2133,17867
40000,34,35798.0,14168,70.84,4202,35798
60000,34,53614.0,20901,104.5,6386,53614
80000,34,71524.0,27682,138.41,8476,71524
100000,34,89406.0,34391,171.95,10594,89406
200000,34,178692.0,67755,338.77,21308,178692
400000,34,357772.0,134100,670.5,42228,357772
600000,34,536217.0,201175,1005.87,63783,536217
800000,34,714719.0,267898,1339.49,85281,714719
1000000,34,893353.0,334956,1674.78,106647,893353
2,35,2.0,1,0.01,0,2
3,35,2.0,1,0.01,1,2
100,35,84.0,71,0.36,16,84
200,35,177.0,108,0.54,23,177
2000,35,1744.0,1409,7.04,256,1744
10000,35,8880.0,4406,22.03,1120,8880
20000,35,17764.0,7800,39.0,2236,17764
40000,35,35679.0,14431,72.16,4321,35679
60000,35,53567.0,25531,127.65,6433,53567
80000,35,71487.0,32091,160.45,8513,71487
100000,35,89371.0,38667,193.33,10629,89371
200000,35,178633.0,72002,360.01,21367,178633
400000,35,357430.0,138722,693.61,42570,357430
600000,35,535983.0,205321,1026.6,64017,535983
800000,35,714777.0,272164,1360.82,85223,714777
1000000,35,893543.0,338904,1694.52,106457,893543
2,36,2.0,2,0.01,0,2
3,36,3.0,2,0.01,0,3
100,36,88.0,54,0.27,12,88
200,36,177.0,138,0.69,23,177
2000,36,1787.0,1002,5.01,213,1787
10000,36,8945.0,3651,18.26,1055,8945
20000,36,17889.0,6927,34.63,2111,17889
40000,36,35829.0,13555,67.78,4171,35829
60000,36,53691.0,20184,100.92,6309,53691
80000,36,71601.0,26910,134.55,8399,71601
100000,36,89362.0,33464,167.32,10638,89362
200000,36,178578.0,67068,335.34,21422,178578
400000,36,357230.0,133515,667.57,42770,357230
600000,36,535807.0,200052,1000.26,64193,535807
800000,36,714728.0,267030,1335.15,85272,714728
1000000,36,893466.0,333752,1668.76,106534,893466
2,37,2.0,0,0.0,0,2
3,37,3.0,0,0.0,0,3
100,37,91.0,76,0.38,9,91
200,37,182.0,110,0.55,18,182
2000,37,1791.0,755,3.77,209,1791
10000,37,8958.0,6200,31.0,1042,8958
20000,37,17903.0,11858,59.29,2097,17903
40000,37,35745.0,18423,92.11,4255,35745
60000,37,53679.0,24976,124.88,6321,53679
80000,37,71560.0,31693,158.46,8440,71560
100000,37,89408.0,43711,218.55,10592,89408
200000,37,178647.0,78095,390.47,21353,178647
400000,37,357385.0,144812,724.06,42615,357385
600000,37,536404.0,211406,1057.03,63596,536404
800000,37,714991.0,277805,1389.03,85009,714991
1000000,37,893706.0,344344,1721.72,106294,893706
2,38,2.0,0,0.0,0,2
3,38,3.0,0,0.0,0,3
100,38,90.0,72,0.36,10,90
200,38,179.0,158,0.79,21,179
2000,38,1799.0,926,4.63,201,1799
10000,38,8916.0,3775,18.88,1084,8916
20000,38,17856.0,12110,60.55,2144,17856
40000,38,35739.0,21702,108.51,4261,35739
60000,38,53541.0,28310,141.55,6459,53541
80000,38,71371.0,34913,174.56,8629,71371
100000,38,89232.0,41541,207.7,10768,89232
200000,38,178619.0,74582,372.91,21381,178619
400000,38,357122.0,140986,704.93,42878,357122
600000,38,535725.0,207633,1038.16,64275,535725
800000,38,714677.0,274025,1370.13,85323,714677
1000000,38,893476.0,340723,1703.62,106524,893476
2,39,2.0,2,0.01,0,2
3,39,3.0,3,0.02,0,3
100,39,90.0,43,0.22,10,90
200,39,177.0,82,0.41,23,177
2000,39,1811.0,673,3.36,189,1811
10000,39,8926.0,3610,18.05,1074,8926
20000,39,17883.0,7245,36.23,2117,17883
40000,39,35686.0,16894,84.47,4314,35686
60000,39,53599.0,23502,117.51,6401,53599
80000,39,71449.0,30282,151.41,8551,71449
100000,39,89338.0,36950,184.75,10662,89338
200000,39,178656.0,70322,351.61,21344,178656
400000,39,357323.0,137049,685.24,42677,357323
600000,39,535796.0,203953,1019.76,64204,535796
800000,39,714424.0,270324,1351.62,85576,714424
1000000,39,892993.0,336601,1683.01,107007,892993
2,40,2.0,0,0.0,0,2
3,40,3.0,1,0.01,0,3
100,40,91.0,68,0.34,9,91
200,40,181.0,101,0.51,19,181
2000,40,1774.0,1308,6.54,226,1774
10000,40,8888.0,7877,39.39,1112,8888
20000,40,17888.0,11641,58.21,2112,17888
40000,40,35741.0,18283,91.41,4259,35741
60000,40,53587.0,24856,124.28,6413,53587
80000,40,71447.0,31527,157.63,8553,71447
100000,40,89345.0,40764,203.82,10655,89345
200000,40,178500.0,75004,375.02,21500,178500
400000,40,356944.0,141448,707.24,43056,356944
600000,40,535467.0,208008,1040.04,64533,535467
800000,40,713895.0,275194,1375.97,86105,713895
1000000,40,892580.0,341960,1709.8,107420,892580
2,41,2.0,0,0.0,0,2
3,41,3.0,0,0.0,0,3
100,41,89.0,62,0.31,11,89
200,41,174.0,135,0.68,26,174
2000,41,1784.0,1241,6.2,216,1784
10000,41,8885.0,7087,35.43,1115,8885
20000,41,17802.0,10447,52.24,2198,17802
40000,41,35631.0,17127,85.63,4369,35631
60000,41,53406.0,23848,119.24,6594,53406
80000,41,71212.0,30616,153.08,8788,71212
100000,41,89066.0,37329,186.64,10934,89066
200000,41,178431.0,70711,353.55,21569,178431
400000,41,357240.0,137685,688.42,42760,357240
600000,41,535820.0,204386,1021.93,64180,535820
800000,41,714345.0,271044,1355.22,85655,714345
1000000,41,893020.0,337589,1687.95,106980,893020
2,42,2.0,0,0.0,0,2
3,42,3.0,0,0.0,0,3
100,42,90.0,67,0.34,10,90
200,42,180.0,108,0.54,20,180
2000,42,1821.0,764,3.82,179,1821
10000,42,8963.0,3392,16.96,1037,8963
20000,42,17879.0,6760,33.8,2121,17879
40000,42,35724.0,13470,67.35,4276,35724
60000,42,53538.0,20221,101.1,6462,53538
80000,42,71366.0,26944,134.72,8634,71366
100000,42,89298.0,33595,167.97,10702,89298
200000,42,178774.0,66805,334.02,21226,178774
400000,42,357367.0,133518,667.59,42633,357367
600000,42,536002.0,199902,999.51,63998,536002
800000,42,714956.0,266698,1333.49,85044,714956
1000000,42,893624.0,333433,1667.17,106376,893624
2,43,2.0,0,0.0,0,2
3,43,3.0,0,0.0,0,3
100,43,92.0,34,0.17,8,92
200,43,184.0,70,0.35,16,184
2000,43,1805.0,1075,5.37,195,1805
10000,43,8921.0,4585,22.92,1079,8921
20000,43,17857.0,7924,39.62,2143,17857
40000,43,35688.0,14619,73.1,4312,35688
60000,43,53524.0,21418,107.09,6476,53524
80000,43,71354.0,28143,140.71,8646,71354
100000,43,89218.0,34848,174.24,10782,89218
200000,43,178534.0,68308,341.54,21466,178534
400000,43,357108.0,135068,675.34,42892,357108
600000,43,535730.0,201493,1007.46,64270,535730
800000,43,714460.0,268428,1342.14,85540,714460
1000000,43,893187.0,335080,1675.4,106813,893187
2,44,2.0,0,0.0,0,2
3,44,3.0,0,0.0,0,3
100,44,83.0,52,0.26,17,83
200,44,170.0,116,0.58,30,170
2000,44,1753.0,753,3.76,247,1753
10000,44,8933.0,3429,17.15,1067,8933
20000,44,17959.0,6770,33.85,2041,17959
40000,44,35854.0,13365,66.83,4146,35854
60000,44,53702.0,20068,100.34,6298,53702
80000,44,71532.0,26667,133.33,8468,71532
100000,44,89455.0,33347,166.73,10545,89455
200000,44,178699.0,66740,333.7,21301,178699
400000,44,357127.0,133616,668.08,42873,357127
600000,44,535855.0,200219,1001.09,64145,535855
800000,44,714463.0,266661,1333.31,85537,714463
1000000,44,892843.0,333256,1666.28,107157,892843
2,45,2.0,2,0.01,0,2
3,45,3.0,3,0.02,0,3
100,45,86.0,45,0.23,14,86
200,45,174.0,136,0.68,26,174
2000,45,1775.0,1435,7.17,225,1775
10000,45,8930.0,4345,21.72,1070,8930
20000,45,17836.0,9341,46.71,2164,17836
40000,45,35702.0,23904,119.52,4298,35702
60000,45,53470.0,36126,180.63,6530,53470
80000,45,71292.0,44782,223.91,8708,71292
100000,45,89201.0,51470,257.35,10799,89201
200000,45,178593.0,84825,424.12,21407,178593
400000,45,357333.0,151380,756.9,42667,357333
600000,45,535907.0,217808,1089.04,64093,535907
800000,45,714421.0,284990,1424.95,85579,714421
1000000,45,893032.0,351842,1759.21,106968,893032
2,46,2.0,2,0.01,0,2
3,46,3.0,3,0.02,0,3
100,46,90.0,69,0.35,10,90
200,46,175.0,133,0.67,25,175
2000,46,1774.0,1482,7.41,226,1774
10000,46,8878.0,8131,40.66,1122,8878
20000,46,17821.0,14678,73.39,2179,17821
40000,46,35681.0,21411,107.05,4319,35681
60000,46,53620.0,27959,139.79,6380,53620
80000,46,71557.0,34632,173.16,8443,71557
100000,46,89363.0,41365,206.82,10637,89363
200000,46,178710.0,75062,375.31,21290,178710
400000,46,357469.0,141554,707.77,42531,357469
600000,46,536154.0,208525,1042.62,63846,536154
800000,46,714851.0,275075,1375.38,85149,714851
1000000,46,893395.0,341471,1707.36,106605,893395
2,47,2.0,0,0.0,0,2
3,47,3.0,0,0.0,0,3
100,47,91.0,75,0.38,9,91
200,47,181.0,161,0.81,19,181
2000,47,1786.0,1550,7.75,214,1786
10000,47,8870.0,7587,37.94,1130,8870
20000,47,17770.0,14687,73.44,2230,17770
40000,47,35657.0,30675,153.37,4343,35657
60000,47,53462.0,46078,230.39,6538,53462
80000,47,71326.0,53265,266.32,8674,71326
100000,47,89223.0,59934,299.67,10777,89223
200000,47,178541.0,93478,467.39,21459,178541
400000,47,357260.0,160247,801.23,42740,357260
600000,47,535724.0,226853,1134.27,64276,535724
800000,47,714634.0,293493,1467.47,85366,714634
1000000,47,892888.0,360108,1800.54,107112,892888
2,48,1.0,1,0.01,1,1
3,48,2.0,2,0.01,1,2
100,48,91.0,46,0.23,9,91
200,48,182.0,77,0.39,18,182
2000,48,1770.0,1517,7.58,230,1770
10000,48,8888.0,8216,41.08,1112,8888
20000,48,17783.0,15366,76.83,2217,17783
40000,48,35616.0,22021,110.1,4384,35616
60000,48,53478.0,28634,143.17,6522,53478
80000,48,71334.0,35296,176.48,8666,71334
100000,48,89252.0,41930,209.65,10748,89252
200000,48,178644.0,75404,377.02,21356,178644
400000,48,357357.0,142145,710.72,42643,357357
600000,48,535974.0,208746,1043.73,64026,535974
800000,48,714277.0,275451,1377.26,85723,714277
1000000,48,892836.0,342141,1710.71,107164,892836
2,49,2.0,0,0.0,0,2
3,49,3.0,1,0.01,0,3
100,49,91.0,82,0.41,9,91
200,49,178.0,170,0.85,22,178
2000,49,1791.0,1569,7.84,209,1791
10000,49,8932.0,5173,25.86,1068,8932
20000,49,17897.0,13028,65.14,2103,17897
40000,49,35671.0,29522,147.61,4329,35671
60000,49,53436.0,44950,224.75,6564,53436
80000,49,71362.0,51642,258.21,8638,71362
100000,49,89261.0,58359,291.79,10739,89261
200000,49,178734.0,91859,459.29,21266,178734
400000,49,357378.0,158311,791.55,42622,357378
600000,49,535963.0,225178,1125.89,64037,535963
800000,49,714905.0,291876,1459.38,85095,714905
1000000,49,893354.0,358514,1792.57,106646,893354
2,50,2.0,0,0.0,0,2
3,50,3.0,0,0.0,0,3
100,50,96.0,46,0.23,4,96
200,50,191.0,98,0.49,9,191
2000,50,1792.0,1567,7.83,208,1792
10000,50,8909.0,7041,35.2,1091,8909
20000,50,17876.0,10749,53.75,2124,17876
40000,50,35699.0,17396,86.98,4301,35699
60000,50,53554.0,24186,120.93,6446,53554
80000,50,71409.0,30761,153.8,8591,71409
100000,50,89300.0,37563,187.81,10700,89300
200000,50,178625.0,71160,355.8,21375,178625
400000,50,357446.0,137626,688.13,42554,357446
600000,50,536184.0,204125,1020.62,63816,536184
800000,50,714895.0,270787,1353.94,85105,714895
1000000,50,893618.0,337453,1687.27,106382,893618
2,51,2.0,2,0.01,0,2
3,51,3.0,3,0.02,0,3
100,51,89.0,45,0.23,11,89
200,51,173.0,107,0.54,27,173
2000,51,1783.0,1625,8.12,217,1783
10000,51,8923.0,8315,41.58,1077,8923
20000,51,17852.0,16541,82.7,2148,17852
40000,51,35690.0,31877,159.38,4310,35690
60000,51,53552.0,42285,211.42,6448,53552
80000,51,71403.0,48875,244.37,8597,71403
100000,51,89229.0,55557,277.78,10771,89229
200000,51,178490.0,88851,444.25,21510,178490
400000,51,357437.0,155472,777.36,42563,357437
600000,51,536178.0,222748,1113.74,63822,536178
800000,51,714949.0,289614,1448.07,85051,714949
1000000,51,893534.0,356438,1782.19,106466,893534
2,52,1.0,1,0.01,1,1
3,52,1.0,2,0.01,2,1
100,52,87.0,59,0.3,13,87
200,52,179.0,124,0.62,21,179
2000,52,1771.0,1458,7.29,229,1771
10000,52,8880.0,4858,24.29,1120,8880
20000,52,17834.0,8184,40.92,2166,17834
40000,52,35708.0,14868,74.34,4292,35708
60000,52,53547.0,21484,107.42,6453,53547
80000,52,71432.0,28299,141.49,8568,71432
100000,52,89376.0,34923,174.61,10624,89376
200000,52,178601.0,68222,341.11,21399,178601
400000,52,357144.0,134865,674.32,42856,357144
600000,52,535859.0,201818,1009.09,64141,535859
800000,52,714568.0,268070,1340.35,85432,714568
1000000,52,893204.0,334558,1672.79,106796,893204
2,53,2.0,0,0.0,0,2
3,53,3.0,0,0.0,0,3
100,53,93.0,28,0.14,7,93
200,53,178.0,59,0.3,22,178
2000,53,1779.0,1005,5.02,221,1779
10000,53,8911.0,7322,36.61,1089,8911
20000,53,17795.0,13355,66.78,2205,17795
40000,53,35593.0,20038,100.19,4407,35593
60000,53,53510.0,26807,134.03,6490,53510
80000,53,71413.0,33445,167.22,8587,71413
100000,53,89296.0,40061,200.3,10704,89296
200000,53,178582.0,73357,366.78,21418,178582
400000,53,357210.0,139883,699.41,42790,357210
600000,53,535886.0,206565,1032.82,64114,535886
800000,53,714480.0,273282,1366.41,85520,714480
1000000,53,893075.0,339981,1699.91,106925,893075
2,54,2.0,2,0.01,0,2
3,54,3.0,3,0.02,0,3
100,54,97.0,45,0.23,3,97
200,54,186.0,120,0.6,14,186
2000,54,1778.0,1598,7.99,222,1778
10000,54,8868.0,6642,33.21,1132,8868
20000,54,17786.0,14967,74.84,2214,17786
40000,54,35596.0,31618,158.09,4404,35596
60000,54,53477.0,48328,241.64,6523,53477
80000,54,71371.0,61211,306.05,8629,71371
100000,54,89192.0,76323,381.61,10808,89192
200000,54,178627.0,125014,625.07,21373,178627
400000,54,357250.0,191730,958.65,42750,357250
600000,54,535784.0,258437,1292.19,64216,535784
800000,54,714483.0,325093,1625.47,85517,714483
1000000,54,893259.0,391889,1959.45,106741,893259
2,55,2.0,2,0.01,0,2
3,55,3.0,3,0.02,0,3
100,55,95.0,62,0.31,5,95
200,55,186.0,144,0.72,14,186
2000,55,1780.0,1343,6.71,220,1780
10000,55,8935.0,5377,26.88,1065,8935
20000,55,17896.0,8714,43.57,2104,17896
40000,55,35796.0,17291,86.45,4204,35796
60000,55,53662.0,23920,119.6,6338,53662
80000,55,71489.0,30638,153.19,8511,71489
100000,55,89413.0,37142,185.71,10587,89413
200000,55,178629.0,70432,352.16,21371,178629
400000,55,357276.0,136823,684.11,42724,357276
600000,55,536040.0,203429,1017.14,63960,536040
800000,55,714856.0,270189,1350.95,85144,714856
1000000,55,893463.0,336949,1684.75,106537,893463
2,56,2.0,0,0.0,0,2
3,56,3.0,1,0.01,0,3
100,56,92.0,43,0.22,8,92
200,56,186.0,75,0.38,14,186
2000,56,1813.0,681,3.4,187,1813
10000,56,8911.0,3524,17.62,1089,8911
20000,56,17829.0,7214,36.07,2171,17829
40000,56,35715.0,13929,69.65,4285,35715
60000,56,53570.0,20593,102.96,6430,53570
80000,56,71431.0,27258,136.29,8569,71431
100000,56,89289.0,33983,169.91,10711,89289
200000,56,178597.0,67178,335.89,21403,178597
400000,56,357113.0,133985,669.92,42887,357113
600000,56,535777.0,201049,1005.24,64223,535777
800000,56,714633.0,267311,1336.56,85367,714633
1000000,56,893197.0,333800,1669.0,106803,893197
2,57,2.0,1,0.01,0,2
3,57,3.0,1,0.01,0,3
100,57,81.0,53,0.27,19,81
200,57,161.0,93,0.47,39,161
2000,57,1757.0,1482,7.41,243,1757
10000,57,8857.0,8153,40.77,1143,8857
20000,57,17844.0,14112,70.56,2156,17844
40000,57,35726.0,21315,106.57,4274,35726
60000,57,53589.0,27903,139.51,6411,53589
80000,57,71483.0,34552,172.76,8517,71483
100000,57,89397.0,41177,205.88,10603,89397
200000,57,178810.0,74716,373.58,21190,178810
400000,57,357636.0,141187,705.93,42364,357636
600000,57,536166.0,207463,1037.31,63834,536166
800000,57,714534.0,274212,1371.06,85466,714534
1000000,57,893318.0,340742,1703.71,106682,893318
2,58,1.0,1,0.01,1,1
3,58,2.0,2,0.01,1,2
100,58,88.0,70,0.35,12,88
200,58,180.0,158,0.79,20,180
2000,58,1789.0,1662,8.31,211,1789
10000,58,8904.0,8217,41.09,1096,8904
20000,58,17840.0,12060,60.3,2160,17840
40000,58,35689.0,18699,93.49,4311,35689
60000,58,53545.0,25377,126.88,6455,53545
80000,58,71534.0,32024,160.12,8466,71534
100000,58,89346.0,38667,193.33,10654,89346
200000,58,178816.0,72230,361.15,21184,178816
400000,58,357452.0,138930,694.65,42548,357452
600000,58,536205.0,205266,1026.33,63795,536205
800000,58,714824.0,271850,1359.25,85176,714824
1000000,58,893717.0,339183,1695.92,106283,893717
2,59,1.0,2,0.01,1,1
3,59,2.0,3,0.02,1,2
100,59,88.0,51,0.26,12,88
200,59,176.0,82,0.41,24,176
2000,59,1759.0,1027,5.13,241,1759
10000,59,8939.0,3686,18.43,1061,8939
20000,59,17934.0,7056,35.28,2066,17934
40000,59,35786.0,13762,68.81,4214,35786
60000,59,53566.0,20441,102.2,6434,53566
80000,59,71390.0,27119,135.59,8610,71390
100000,59,89248.0,33793,168.96,10752,89248
200000,59,178645.0,66980,334.9,21355,178645
400000,59,357334.0,133533,667.66,42666,357334
600000,59,536018.0,200029,1000.14,63982,536018
800000,59,714684.0,266367,1331.84,85316,714684
1000000,59,893462.0,333002,1665.01,106538,893462
2,60,1.0,1,0.01,1,1
3,60,2.0,2,0.01,1,2
100,60,89.0,32,0.16,11,89
200,60,176.0,74,0.37,24,176
2000,60,1780.0,1524,7.62,220,1780
10000,60,8947.0,4919,24.59,1053,8947
20000,60,17882.0,8256,41.28,2118,17882
40000,60,35764.0,15027,75.14,4236,35764
60000,60,53573.0,21729,108.64,6427,53573
80000,60,71465.0,28459,142.29,8535,71465
100000,60,89260.0,35130,175.65,10740,89260
200000,60,178649.0,68288,341.44,21351,178649
400000,60,357066.0,134868,674.34,42934,357066
600000,60,535836.0,201579,1007.89,64164,535836
800000,60,714283.0,268374,1341.87,85717,714283
1000000,60,893026.0,334970,1674.85,106974,893026
2,61,2.0,0,0.0,0,2
3,61,3.0,1,0.01,0,3
100,61,93.0,63,0.32,7,93
200,61,183.0,142,0.71,17,183
2000,61,1810.0,1173,5.86,190,1810
10000,61,8935.0,4337,21.68,1065,8935
20000,61,17868.0,7636,38.18,2132,17868
40000,61,35688.0,14293,71.47,4312,35688
60000,61,53538.0,20965,104.82,6462,53538
80000,61,71431.0,27706,138.53,8569,71431
100000,61,89347.0,34414,172.07,10653,89347
200000,61,178617.0,67743,338.71,21383,178617
400000,61,357104.0,134772,673.86,42896,357104
600000,61,535922.0,201367,1006.83,64078,535922
800000,61,714461.0,268065,1340.33,85539,714461
1000000,61,893047.0,334640,1673.2,106953,893047
2,62,2.0,0,0.0,0,2
3,62,3.0,0,0.0,0,3
100,62,90.0,86,0.43,10,90
200,62,177.0,148,0.74,23,177
2000,62,1791.0,1598,7.99,209,1791
10000,62,8912.0,4637,23.18,1088,8912
20000,62,17826.0,7946,39.73,2174,17826
40000,62,35701.0,14527,72.64,4299,35701
60000,62,53532.0,21201,106.0,6468,53532
80000,62,71403.0,27851,139.25,8597,71403
100000,62,89317.0,34573,172.86,10683,89317
200000,62,178571.0,67841,339.2,21429,178571
400000,62,357089.0,134638,673.19,42911,357089
600000,62,535791.0,201653,1008.26,64209,535791
800000,62,714527.0,268366,1341.83,85473,714527
1000000,62,892982.0,335115,1675.58,107018,892982
2,63,2.0,0,0.0,0,2
3,63,3.0,1,0.01,0,3
100,63,86.0,83,0.42,14,86
200,63,173.0,173,0.87,27,173
2000,63,1791.0,1581,7.9,209,1791
10000,63,8901.0,6995,34.97,1099,8901
20000,63,17816.0,12043,60.22,2184,17816
40000,63,35648.0,18784,93.92,4352,35648
60000,63,53523.0,25373,126.86,6477,53523
80000,63,71333.0,32030,160.15,8667,71333
100000,63,89170.0,38720,193.6,10830,89170
200000,63,178540.0,72136,360.68,21460,178540
400000,63,357372.0,139032,695.16,42628,357372
600000,63,535823.0,205997,1029.98,64177,535823
800000,63,714401.0,272318,1361.59,85599,714401
1000000,63,893250.0,339186,1695.93,106750,893250
2,64,2.0,2,0.01,0,2
3,64,2.0,3,0.02,1,2
100,64,84.0,57,0.29,16,84
200,64,177.0,138,0.69,23,177
2000,64,1767.0,1374,6.87,233,1767
10000,64,8959.0,4151,20.76,1041,8959
20000,64,17871.0,7497,37.49,2129,17871
40000,64,35722.0,14139,70.7,4278,35722
60000,64,53528.0,20685,103.42,6472,53528
80000,64,71376.0,27313,136.56,8624,71376
100000,64,89206.0,33997,169.98,10794,89206
200000,64,178493.0,67386,336.93,21507,178493
400000,64,356988.0,134128,670.64,43012,356988
600000,64,536057.0,200826,1004.13,63943,536057
800000,64,714615.0,267657,1338.29,85385,714615
1000000,64,893385.0,334140,1670.7,106615,893385
2,65,2.0,0,0.0,0,2
3,65,2.0,0,0.0,1,2
100,65,88.0,79,0.4,12,88
200,65,178.0,159,0.8,22,178
2000,65,1777.0,1641,8.2,223,1777
10000,65,8916.0,7861,39.31,1084,8916
20000,65,17880.0,13851,69.26,2120,17880
40000,65,35718.0,21043,105.21,4282,35718
60000,65,53604.0,27562,137.81,6396,53604
80000,65,71469.0,34252,171.26,8531,71469
100000,65,89357.0,40947,204.73,10643,89357
200000,65,178686.0,74007,370.03,21314,178686
400000,65,357410.0,140767,703.83,42590,357410
600000,65,535939.0,207259,1036.29,64061,535939
800000,65,714565.0,273886,1369.43,85435,714565
1000000,65,893059.0,340842,1704.21,106941,893059
2,66,2.0,0,0.0,0,2
3,66,3.0,1,0.01,0,3
100,66,90.0,65,0.33,10,90
200,66,179.0,147,0.74,21,179
2000,66,1777.0,1241,6.2,223,1777
10000,66,8914.0,4305,21.52,1086,8914
20000,66,17878.0,7633,38.17,2122,17878
40000,66,35725.0,14264,71.32,4275,35725
60000,66,53501.0,20953,104.76,6499,53501
80000,66,71318.0,27554,137.77,8682,71318
100000,66,89130.0,34276,171.38,10870,89130
200000,66,178498.0,67763,338.81,21502,178498
400000,66,357173.0,134688,673.44,42827,357173
600000,66,535752.0,201174,1005.87,64248,535752
800000,66,714324.0,267673,1338.37,85676,714324
1000000,66,893198.0,334346,1671.73,106802,893198
2,67,2.0,2,0.01,0,2
3,67,3.0,3,0.02,0,3
100,67,89.0,48,0.24,11,89
200,67,175.0,135,0.68,25,175
2000,67,1804.0,862,4.31,196,1804
10000,67,8980.0,3551,17.76,1020,8980
20000,67,17901.0,7167,35.83,2099,17901
40000,67,35808.0,13768,68.84,4192,35808
60000,67,53730.0,20408,102.04,6270,53730
80000,67,71659.0,27057,135.28,8341,71659
100000,67,89568.0,33738,168.69,10432,89568
200000,67,178992.0,67411,337.05,21008,178992
400000,67,357619.0,134167,670.83,42381,357619
600000,67,536223.0,200759,1003.79,63777,536223
800000,67,714994.0,267212,1336.06,85006,714994
1000000,67,893629.0,334025,1670.13,106371,893629
2,68,1.0,0,0.0,1,1
3,68,2.0,0,0.0,1,2
100,68,89.0,79,0.4,11,89
200,68,176.0,167,0.84,24,176
2000,68,1794.0,1642,8.21,206,1794
10000,68,8976.0,8272,41.36,1024,8976
20000,68,17921.0,14400,72.0,2079,17921
40000,68,35624.0,21898,109.49,4376,35624
60000,68,53538.0,31659,158.29,6462,53538
80000,68,71466.0,38339,191.69,8534,71466
100000,68,89347.0,44979,224.89,10653,89347
200000,68,178760.0,78291,391.45,21240,178760
400000,68,357305.0,144903,724.51,42695,357305
600000,68,536040.0,211676,1058.38,63960,536040
800000,68,714609.0,278307,1391.54,85391,714609
1000000,68,893325.0,345253,1726.27,106675,893325
2,69,2.0,1,0.01,0,2
3,69,3.0,2,0.01,0,3
100,69,89.0,65,0.33,11,89
200,69,175.0,129,0.65,25,175
2000,69,1763.0,969,4.84,237,1763
10000,69,8925.0,4241,21.21,1075,8925
20000,69,17804.0,8184,40.92,2196,17804
40000,69,35645.0,16105,80.52,4355,35645
60000,69,53475.0,22737,113.68,6525,53475
80000,69,71369.0,29480,147.4,8631,71369
100000,69,89137.0,36203,181.01,10863,89137
200000,69,178570.0,69550,347.75,21430,178570
400000,69,357201.0,136431,682.15,42799,357201
600000,69,536060.0,203366,1016.83,63940,536060
800000,69,714768.0,270114,1350.57,85232,714768
1000000,69,893576.0,337133,1685.67,106424,893576
2,70,2.0,2,0.01,0,2
3,70,3.0,3,0.02,0,3
100,70,92.0,76,0.38,8,92
200,70,183.0,149,0.75,17,183
2000,70,1780.0,1441,7.2,220,1780
10000,70,8921.0,5201,26.0,1079,8921
20000,70,17874.0,8605,43.03,2126,17874
40000,70,35785.0,15259,76.3,4215,35785
60000,70,53599.0,21928,109.64,6401,53599
80000,70,71565.0,28580,142.9,8435,71565
100000,70,89472.0,35291,176.45,10528,89472
200000,70,178804.0,68614,343.07,21196,178804
400000,70,357581.0,135254,676.27,42419,357581
600000,70,536360.0,202121,1010.6,63640,536360
800000,70,714884.0,268852,1344.26,85116,714884
1000000,70,893539.0,335527,1677.64,106461,893539
2,71,2.0,2,0.01,0,2
3,71,3.0,3,0.02,0,3
100,71,91.0,84,0.42,9,91
200,71,182.0,171,0.86,18,182
2000,71,1778.0,1528,7.64,222,1778
10000,71,8925.0,5392,26.96,1075,8925
20000,71,17894.0,8706,43.53,2106,17894
40000,71,35762.0,15368,76.84,4238,35762
60000,71,53596.0,22030,110.15,6404,53596
80000,71,71521.0,28788,143.94,8479,71521
100000,71,89373.0,35383,176.91,10627,89373
200000,71,178581.0,68719,343.59,21419,178581
400000,71,357003.0,143689,718.44,42997,357003
600000,71,535522.0,210724,1053.62,64478,535522
800000,71,714168.0,277466,1387.33,85832,714168
1000000,71,892762.0,343893,1719.47,107238,892762
2,72,2.0,0,0.0,0,2
3,72,3.0,0,0.0,0,3
100,72,89.0,54,0.27,11,89
200,72,175.0,94,0.47,25,175
2000,72,1787.0,1145,5.72,213,1787
10000,72,8918.0,3865,19.33,1082,8918
20000,72,17813.0,7171,35.85,2187,17813
40000,72,35654.0,13727,68.64,4346,35654
60000,72,53530.0,20409,102.04,6470,53530
80000,72,71417.0,27109,135.54,8583,71417
100000,72,89276.0,33809,169.04,10724,89276
200000,72,178724.0,67157,335.78,21276,178724
400000,72,357568.0,133784,668.92,42432,357568
600000,72,536451.0,200350,1001.75,63549,536451
800000,72,714940.0,267182,1335.91,85060,714940
1000000,72,893606.0,333824,1669.12,106394,893606
2,73,2.0,2,0.01,0,2
3,73,3.0,3,0.02,0,3
100,73,87.0,71,0.36,13,87
200,73,175.0,140,0.7,25,175
2000,73,1792.0,1640,8.2,208,1792
10000,73,8973.0,8381,41.91,1027,8973
20000,73,17846.0,16682,83.41,2154,17846
40000,73,35653.0,30777,153.88,4347,35653
60000,73,53395.0,46859,234.29,6605,53395
80000,73,71168.0,60202,301.01,8832,71168
100000,73,89030.0,66917,334.58,10970,89030
200000,73,178278.0,100058,500.29,21722,178278
400000,73,356807.0,166831,834.15,43193,356807
600000,73,535408.0,233502,1167.51,64592,535408
800000,73,713901.0,300074,1500.37,86099,713901
1000000,73,892580.0,366429,1832.15,107420,892580
2,74,1.0,2,0.01,1,1
3,74,2.0,2,0.01,1,2
100,74,84.0,57,0.29,16,84
200,74,170.0,124,0.62,30,170
2000,74,1778.0,744,3.72,222,1778
10000,74,8867.0,4896,24.48,1133,8867
20000,74,17740.0,12950,64.75,2260,17740
40000,74,35550.0,29709,148.54,4450,35550
60000,74,53411.0,40703,203.51,6589,53411
80000,74,71297.0,47437,237.18,8703,71297
100000,74,89203.0,54168,270.84,10797,89203
200000,74,178480.0,87355,436.77,21520,178480
400000,74,357208.0,154248,771.24,42792,357208
600000,74,535774.0,221412,1107.06,64226,535774
800000,74,714486.0,288406,1442.03,85514,714486
1000000,74,893112.0,355025,1775.13,106888,893112
2,75,2.0,1,0.01,0,2
3,75,3.0,1,0.01,0,3
100,75,91.0,76,0.38,9,91
200,75,177.0,159,0.8,23,177
2000,75,1804.0,908,4.54,196,1804
10000,75,9019.0,3624,18.12,981,9019
20000,75,17930.0,6954,34.77,2070,17930
40000,75,35743.0,13595,67.98,4257,35743
60000,75,53592.0,20286,101.43,6408,53592
80000,75,71551.0,26969,134.84,8449,71551
100000,75,89398.0,33616,168.08,10602,89398
200000,75,178734.0,66804,334.02,21266,178734
400000,75,357548.0,133683,668.41,42452,357548
600000,75,536128.0,200579,1002.89,63872,536128
800000,75,714646.0,267211,1336.06,85354,714646
1000000,75,893360.0,333726,1668.63,106640,893360
2,76,2.0,0,0.0,0,2
3,76,3.0,0,0.0,0,3
100,76,90.0,45,0.23,10,90
200,76,180.0,79,0.4,20,180
2000,76,1784.0,705,3.52,216,1784
10000,76,8913.0,3839,19.2,1087,8913
20000,76,17849.0,7203,36.01,2151,17849
40000,76,35725.0,14477,72.39,4275,35725
60000,76,53592.0,21164,105.82,6408,53592
80000,76,71400.0,27745,138.72,8600,71400
100000,76,89346.0,34366,171.83,10654,89346
200000,76,178726.0,67433,337.16,21274,178726
400000,76,357666.0,133967,669.83,42334,357666
600000,76,536208.0,200882,1004.41,63792,536208
800000,76,714779.0,267646,1338.23,85221,714779
1000000,76,893458.0,334372,1671.86,106542,893458
2,77,2.0,0,0.0,0,2
3,77,3.0,0,0.0,0,3
100,77,89.0,34,0.17,11,89
200,77,180.0,69,0.35,20,180
2000,77,1782.0,1416,7.08,218,1782
10000,77,8943.0,8075,40.38,1057,8943
20000,77,17863.0,16434,82.17,2137,17863
40000,77,35683.0,26374,131.87,4317,35683
60000,77,53597.0,32993,164.96,6403,53597
80000,77,71449.0,39548,197.74,8551,71449
100000,77,89231.0,49879,249.39,10769,89231
200000,77,178522.0,90599,452.99,21478,178522
400000,77,357182.0,156595,782.97,42818,357182
600000,77,535795.0,223748,1118.74,64205,535795
800000,77,714406.0,290109,1450.55,85594,714406
1000000,77,893108.0,356249,1781.25,106892,893108
2,78,2.0,0,0.0,0,2
3,78,3.0,1,0.01,0,3
100,78,92.0,73,0.37,8,92
200,78,181.0,159,0.8,19,181
2000,78,1779.0,1559,7.79,221,1779
10000,78,8877.0,7394,36.97,1123,8877
20000,78,17794.0,10796,53.98,2206,17794
40000,78,35615.0,17452,87.26,4385,35615
60000,78,53478.0,24274,121.37,6522,53478
80000,78,71399.0,31038,155.19,8601,71399
100000,78,89198.0,37860,189.3,10802,89198
200000,78,178604.0,71186,355.93,21396,178604
400000,78,357308.0,137591,687.95,42692,357308
600000,78,536203.0,204403,1022.01,63797,536203
800000,78,715078.0,271230,1356.15,84922,715078
1000000,78,893929.0,337975,1689.88,106071,893929
2,79,2.0,0,0.0,0,2
3,79,3.0,1,0.01,0,3
100,79,87.0,79,0.4,13,87
200,79,176.0,164,0.82,24,176
2000,79,1788.0,1655,8.27,212,1788
10000,79,8919.0,5334,26.67,1081,8919
20000,79,17833.0,8638,43.19,2167,17833
40000,79,35722.0,15316,76.58,4278,35722
60000,79,53626.0,21942,109.71,6374,53626
80000,79,71535.0,28587,142.93,8465,71535
100000,79,89475.0,35153,175.76,10525,89475
200000,79,178917.0,68522,342.61,21083,178917
400000,79,357809.0,134806,674.03,42191,357809
600000,79,536595.0,201084,1005.42,63405,536595
800000,79,715552.0,267959,1339.8,84448,715552
1000000,79,894340.0,334765,1673.83,105660,894340
2,80,2.0,0,0.0,0,2
3,80,3.0,1,0.01,0,3
100,80,89.0,79,0.4,11,89
200,80,182.0,163,0.82,18,182
2000,80,1792.0,1331,6.65,208,1792
10000,80,8893.0,6923,34.61,1107,8893
20000,80,17830.0,10775,53.88,2170,17830
40000,80,35758.0,17282,86.41,4242,35758
60000,80,53591.0,23901,119.5,6409,53591
80000,80,71394.0,30593,152.96,8606,71394
100000,80,89292.0,37313,186.56,10708,89292
200000,80,178655.0,70769,353.84,21345,178655
400000,80,357380.0,137651,688.25,42620,357380
600000,80,535965.0,204196,1020.98,64035,535965
800000,80,714930.0,270605,1353.03,85070,714930
1000000,80,893769.0,337146,1685.73,106231,893769
2,81,2.0,0,0.0,0,2
3,81,3.0,0,0.0,0,3
100,81,93.0,74,0.37,7,93
200,81,183.0,147,0.74,17,183
2000,81,1791.0,1362,6.81,209,1791
10000,81,8914.0,5278,26.39,1086,8914
20000,81,17852.0,9151,45.76,2148,17852
40000,81,35664.0,25241,126.2,4336,35664
60000,81,53509.0,41872,209.36,6491,53509
80000,81,71285.0,58380,291.9,8715,71285
100000,81,89202.0,65322,326.61,10798,89202
200000,81,178296.0,98752,493.76,21704,178296
400000,81,356890.0,165504,827.52,43110,356890
600000,81,535507.0,232075,1160.38,64493,535507
800000,81,713936.0,298692,1493.46,86064,713936
1000000,81,892449.0,365434,1827.17,107551,892449
2,82,2.0,2,0.01,0,2
3,82,3.0,3,0.02,0,3
100,82,87.0,80,0.4,13,87
200,82,176.0,160,0.8,24,176
2000,82,1773.0,1609,8.04,227,1773
10000,82,8886.0,5565,27.82,1114,8886
20000,82,17807.0,8995,44.98,2193,17807
40000,82,35754.0,17487,87.43,4246,35754
60000,82,53632.0,24091,120.45,6368,53632
80000,82,71453.0,30823,154.11,8547,71453
100000,82,89319.0,38342,191.71,10681,89319
200000,82,178829.0,71629,358.14,21171,178829
400000,82,357542.0,138152,690.76,42458,357542
600000,82,536133.0,204937,1024.68,63867,536133
800000,82,714821.0,271366,1356.83,85179,714821
1000000,82,893391.0,338233,1691.17,106609,893391
2,83,2.0,2,0.01,0,2
3,83,3.0,3,0.02,0,3
100,83,94.0,43,0.22,6,94
200,83,190.0,84,0.42,10,190
2000,83,1796.0,751,3.75,204,1796
10000,83,8967.0,6318,31.59,1033,8967
20000,83,17893.0,13155,65.78,2107,17893
40000,83,35801.0,19855,99.27,4199,35801
60000,83,53643.0,26502,132.51,6357,53643
80000,83,71516.0,33050,165.25,8484,71516
100000,83,89380.0,39616,198.08,10620,89380
200000,83,178615.0,73134,365.67,21385,178615
400000,83,357293.0,139983,699.91,42707,357293
600000,83,535927.0,206720,1033.6,64073,535927
800000,83,714585.0,273215,1366.08,85415,714585
1000000,83,893236.0,340068,1700.34,106764,893236
2,84,2.0,0,0.0,0,2
3,84,3.0,0,0.0,0,3
100,84,94.0,67,0.34,6,94
200,84,184.0,108,0.54,16,184
2000,84,1807.0,909,4.54,193,1807
10000,84,8957.0,3896,19.48,1043,8957
20000,84,17888.0,7773,38.87,2112,17888
40000,84,35744.0,14468,72.34,4256,35744
60000,84,53551.0,21169,105.84,6449,53551
80000,84,71378.0,27829,139.14,8622,71378
100000,84,89261.0,34453,172.26,10739,89261
200000,84,178536.0,67628,338.14,21464,178536
400000,84,357088.0,134662,673.31,42912,357088
600000,84,535882.0,201573,1007.86,64118,535882
800000,84,714543.0,268251,1341.26,85457,714543
1000000,84,893235.0,334867,1674.34,106765,893235
2,85,2.0,1,0.01,0,2
3,85,3.0,1,0.01,0,3
100,85,94.0,62,0.31,6,94
200,85,186.0,140,0.7,14,186
2000,85,1806.0,1488,7.44,194,1806
10000,85,8899.0,8032,40.16,1101,8899
20000,85,17803.0,13041,65.21,2197,17803
40000,85,35684.0,19665,98.32,4316,35684
60000,85,53496.0,26251,131.25,6504,53496
80000,85,71335.0,33026,165.13,8665,71335
100000,85,89135.0,39649,198.24,10865,89135
200000,85,178550.0,72917,364.58,21450,178550
400000,85,357423.0,139686,698.43,42577,357423
600000,85,536134.0,206340,1031.7,63866,536134
800000,85,714638.0,273252,1366.26,85362,714638
1000000,85,893263.0,339756,1698.78,106737,893263
2,86,2.0,1,0.01,0,2
3,86,3.0,1,0.01,0,3
100,86,91.0,44,0.22,9,91
200,86,179.0,84,0.42,21,179
2000,86,1789.0,1321,6.6,211,1789
10000,86,8866.0,4533,22.66,1134,8866
20000,86,17810.0,7798,38.99,2190,17810
40000,86,35737.0,14480,72.4,4263,35737
60000,86,53651.0,21124,105.62,6349,53651
80000,86,71498.0,27884,139.42,8502,71498
100000,86,89363.0,34524,172.62,10637,89363
200000,86,178616.0,67986,339.93,21384,178616
400000,86,357357.0,134663,673.31,42643,357357
600000,86,536023.0,201463,1007.31,63977,536023
800000,86,714633.0,268082,1340.41,85367,714633
1000000,86,893350.0,334813,1674.07,106650,893350
2,87,2.0,0,0.0,0,2
3,87,3.0,1,0.01,0,3
100,87,96.0,43,0.22,4,96
200,87,186.0,89,0.45,14,186
2000,87,1783.0,712,3.56,217,1783
10000,87,8931.0,3678,18.39,1069,8931
20000,87,17869.0,6987,34.93,2131,17869
40000,87,35688.0,13675,68.38,4312,35688
60000,87,53552.0,20380,101.9,6448,53552
80000,87,71448.0,27219,136.09,8552,71448
100000,87,89313.0,33958,169.79,10687,89313
200000,87,178742.0,67530,337.65,21258,178742
400000,87,357405.0,134453,672.26,42595,357405
600000,87,536153.0,200856,1004.28,63847,536153
800000,87,714912.0,267657,1338.29,85088,714912
1000000,87,893651.0,334430,1672.15,106349,893651
2,88,2.0,0,0.0,0,2
3,88,3.0,1,0.01,0,3
100,88,92.0,78,0.39,8,92
200,88,186.0,165,0.83,14,186
2000,88,1782.0,1277,6.38,218,1782
10000,88,8943.0,5465,27.32,1057,8943
20000,88,17892.0,11988,59.94,2108,17892
40000,88,35747.0,18616,93.08,4253,35747
60000,88,53604.0,25399,126.99,6396,53604
80000,88,71473.0,32063,160.31,8527,71473
100000,88,89403.0,38611,193.05,10597,89403
200000,88,178670.0,71974,359.87,21330,178670
400000,88,357155.0,138978,694.89,42845,357155
600000,88,535831.0,205608,1028.04,64169,535831
800000,88,714219.0,272380,1361.9,85781,714219
1000000,88,892794.0,339325,1696.63,107206,892794
2,89,2.0,0,0.0,0,2
3,89,3.0,1,0.01,0,3
100,89,92.0,83,0.42,8,92
200,89,175.0,162,0.81,25,175
2000,89,1774.0,1643,8.21,226,1774
10000,89,8864.0,8325,41.63,1136,8864
20000,89,17786.0,14530,72.65,2214,17786
40000,89,35555.0,27308,136.54,4445,35555
60000,89,53407.0,33884,169.42,6593,53407
80000,89,71322.0,40580,202.9,8678,71322
100000,89,89167.0,47351,236.75,10833,89167
200000,89,178370.0,80855,404.27,21630,178370
400000,89,356785.0,147235,736.17,43215,356785
600000,89,535360.0,213893,1069.47,64640,535360
800000,89,714111.0,280643,1403.22,85889,714111
1000000,89,892781.0,347566,1737.83,107219,892781
2,90,2.0,2,0.01,0,2
3,90,2.0,3,0.02,1,2
100,90,86.0,80,0.4,14,86
200,90,182.0,170,0.85,18,182
2000,90,1800.0,1036,5.18,200,1800
10000,90,8944.0,5832,29.16,1056,8944
20000,90,17867.0,12318,61.59,2133,17867
40000,90,35695.0,19525,97.62,4305,35695
60000,90,53572.0,26157,130.78,6428,53572
80000,90,71412.0,32763,163.81,8588,71412
100000,90,89262.0,39428,197.14,10738,89262
200000,90,178505.0,72834,364.17,21495,178505
400000,90,357458.0,139457,697.28,42542,357458
600000,90,536031.0,206002,1030.01,63969,536031
800000,90,714611.0,272737,1363.69,85389,714611
1000000,90,893446.0,339372,1696.86,106554,893446
2,91,2.0,1,0.01,0,2
3,91,3.0,1,0.01,0,3
100,91,92.0,73,0.37,8,92
200,91,183.0,148,0.74,17,183
2000,91,1795.0,1068,5.34,205,1795
10000,91,8901.0,7614,38.07,1099,8901
20000,91,17831.0,15939,79.7,2169,17831
40000,91,35743.0,25210,126.05,4257,35743
60000,91,53591.0,31915,159.57,6409,53591
80000,91,71473.0,38765,193.82,8527,71473
100000,91,89314.0,45388,226.94,10686,89314
200000,91,178701.0,78612,393.06,21299,178701
400000,91,357289.0,145556,727.78,42711,357289
600000,91,536185.0,212158,1060.79,63815,536185
800000,91,714728.0,278839,1394.2,85272,714728
1000000,91,893050.0,345289,1726.45,106950,893050
2,92,2.0,1,0.01,0,2
3,92,3.0,2,0.01,0,3
100,92,92.0,73,0.37,8,92
200,92,182.0,142,0.71,18,182
2000,92,1776.0,1131,5.65,224,1776
10000,92,8879.0,3827,19.14,1121,8879
20000,92,17822.0,7314,36.57,2178,17822
40000,92,35668.0,21638,108.19,4332,35668
60000,92,53512.0,29118,145.59,6488,53512
80000,92,71310.0,35835,179.17,8690,71310
100000,92,89197.0,42513,212.56,10803,89197
200000,92,178511.0,76154,380.77,21489,178511
400000,92,357300.0,142722,713.61,42700,357300
600000,92,535951.0,209303,1046.51,64049,535951
800000,92,714460.0,276036,1380.18,85540,714460
1000000,92,893081.0,342617,1713.09,106919,893081
2,93,2.0,2,0.01,0,2
3,93,3.0,3,0.02,0,3
100,93,84.0,78,0.39,16,84
200,93,174.0,164,0.82,26,174
2000,93,1785.0,812,4.06,215,1785
10000,93,8984.0,3426,17.13,1016,8984
20000,93,17901.0,6718,33.59,2099,17901
40000,93,35684.0,13500,67.5,4316,35684
60000,93,53560.0,20195,100.97,6440,53560
80000,93,71427.0,28339,141.69,8573,71427
100000,93,89289.0,38658,193.29,10711,89289
200000,93,178645.0,72027,360.13,21355,178645
400000,93,357437.0,138955,694.77,42563,357437
600000,93,536267.0,205794,1028.97,63733,536267
800000,93,715162.0,272134,1360.67,84838,715162
1000000,93,893824.0,339028,1695.14,106176,893824
2,94,2.0,1,0.01,0,2
3,94,3.0,1,0.01,0,3
100,94,88.0,88,0.44,12,88
200,94,181.0,172,0.86,19,181
2000,94,1774.0,1591,7.95,226,1774
10000,94,8867.0,8175,40.88,1133,8867
20000,94,17773.0,16096,80.48,2227,17773
40000,94,35691.0,22877,114.38,4309,35691
60000,94,53621.0,29523,147.61,6379,53621
80000,94,71481.0,36269,181.34,8519,71481
100000,94,89408.0,43005,215.02,10592,89408
200000,94,178648.0,76629,383.14,21352,178648
400000,94,357259.0,143559,717.79,42741,357259
600000,94,536064.0,210253,1051.26,63936,536064
800000,94,714919.0,276786,1383.93,85081,714919
1000000,94,893755.0,343226,1716.13,106245,893755
2,95,2.0,0,0.0,0,2
3,95,3.0,1,0.01,0,3
100,95,93.0,35,0.18,7,93
200,95,180.0,73,0.37,20,180
2000,95,1795.0,727,3.63,205,1795
10000,95,8967.0,3804,19.02,1033,8967
20000,95,17950.0,7742,38.71,2050,17950
40000,95,35774.0,14408,72.04,4226,35774
60000,95,53638.0,21004,105.02,6362,53638
80000,95,71411.0,27582,137.91,8589,71411
100000,95,89271.0,34245,171.22,10729,89271
200000,95,178475.0,67604,338.02,21525,178475
400000,95,356787.0,134654,673.27,43213,356787
600000,95,535404.0,201201,1006.0,64596,535404
800000,95,714227.0,267793,1338.97,85773,714227
1000000,95,892869.0,334518,1672.59,107131,892869
2,96,2.0,0,0.0,0,2
3,96,3.0,0,0.0,0,3
100,96,91.0,78,0.39,9,91
200,96,186.0,161,0.81,14,186
2000,96,1801.0,1166,5.83,199,1801
10000,96,8940.0,4170,20.85,1060,8940
20000,96,17898.0,7678,38.39,2102,17898
40000,96,35770.0,14267,71.34,4230,35770
60000,96,53660.0,20915,104.57,6340,53660
80000,96,71467.0,27617,138.08,8533,71467
100000,96,89325.0,34287,171.43,10675,89325
200000,96,178609.0,67489,337.44,21391,178609
400000,96,357488.0,134149,670.74,42512,357488
600000,96,536257.0,200833,1004.16,63743,536257
800000,96,715051.0,267316,1336.58,84949,715051
1000000,96,893575.0,333757,1668.79,106425,893575
2,97,2.0,2,0.01,0,2
3,97,3.0,3,0.02,0,3
100,97,94.0,86,0.43,6,94
200,97,184.0,171,0.86,16,184
2000,97,1806.0,1516,7.58,194,1806
10000,97,8930.0,8136,40.68,1070,8930
20000,97,17833.0,16419,82.09,2167,17833
40000,97,35624.0,29160,145.8,4376,35624
60000,97,53471.0,45185,225.92,6529,53471
80000,97,71315.0,51759,258.79,8685,71315
100000,97,89127.0,58432,292.16,10873,89127
200000,97,178426.0,91976,459.88,21574,178426
400000,97,357236.0,158345,791.72,42764,357236
600000,97,536005.0,225103,1125.52,63995,536005
800000,97,714841.0,291352,1456.76,85159,714841
1000000,97,893512.0,358241,1791.21,106488,893512
2,98,2.0,0,0.0,0,2
3,98,2.0,0,0.0,1,2
100,98,93.0,81,0.41,7,93
200,98,181.0,170,0.85,19,181
2000,98,1756.0,1684,8.42,244,1756
10000,98,8868.0,6557,32.78,1132,8868
20000,98,17810.0,14889,74.45,2190,17810
40000,98,35683.0,22931,114.65,4317,35683
60000,98,53507.0,29558,147.79,6493,53507
80000,98,71357.0,36328,181.64,8643,71357
100000,98,89207.0,42985,214.92,10793,89207
200000,98,178556.0,76565,382.82,21444,178556
400000,98,357373.0,143322,716.61,42627,357373
600000,98,535705.0,209688,1048.44,64295,535705
800000,98,714468.0,276353,1381.77,85532,714468
1000000,98,892833.0,342738,1713.69,107167,892833
2,99,2.0,2,0.01,0,2
3,99,3.0,2,0.01,0,3
100,99,92.0,84,0.42,8,92
200,99,179.0,174,0.87,21,179
2000,99,1779.0,1661,8.3,221,1779
10000,99,8934.0,7279,36.4,1066,8934
20000,99,17866.0,12395,61.98,2134,17866
40000,99,35795.0,19028,95.14,4205,35795
60000,99,53644.0,25573,127.86,6356,53644
80000,99,71521.0,32114,160.57,8479,71521
100000,99,89344.0,38741,193.7,10656,89344
200000,99,178693.0,72076,360.38,21307,178693
400000,99,357550.0,138637,693.18,42450,357550
600000,99,536187.0,205436,1027.18,63813,536187
800000,99,714875.0,272668,1363.34,85125,714875
1000000,99,893671.0,339452,1697.26,106329,893671
2,100,1.0,1,0.01,1,1
3,100,2.0,2,0.01,1,2
100,100,92.0,79,0.4,8,92
200,100,183.0,162,0.81,17,183
2000,100,1783.0,1669,8.34,217,1783
10000,100,8897.0,5318,26.59,1103,8897
20000,100,17887.0,8761,43.81,2113,17887
40000,100,35746.0,15548,77.74,4254,35746
60000,100,53653.0,22190,110.95,6347,53653
80000,100,71519.0,28851,144.25,8481,71519
100000,100,89369.0,35643,178.21,10631,89369
200000,100,178727.0,68779,343.89,21273,178727
400000,100,357237.0,135302,676.51,42763,357237
600000,100,535731.0,201817,1009.08,64269,535731
800000,100,714878.0,268119,1340.6,85122,714878
1000000,100,893404.0,335021,1675.11,106596,893404
