Timestep,Iteration,Total Reward,Suboptimal Arms,Total Regret,Zeros Count,Ones Count
2,1,2.0,2,0.2,0,2
3,1,3.0,3,0.3,0,3
100,1,88.0,85,3.91,12,88
200,1,177.0,180,5.04,23,177
2000,1,1767.0,1555,24.91,233,1767
10000,1,8963.0,2046,51.24,1037,8963
20000,1,17908.0,2689,86.38,2092,17908
40000,1,35889.0,4007,157.61,4111,35889
60000,1,53873.0,5361,233.88,6127,53873
80000,1,71836.0,6679,304.21,8164,71836
100000,1,89784.0,7993,377.11,10216,89784
200000,1,179488.0,14530,736.06,20512,179488
400000,1,358933.0,27778,1467.13,41067,358933
600000,1,538216.0,41012,2194.64,61784,538216
800000,1,717480.0,54368,2931.65,82520,717480
1000000,1,896909.0,67606,3656.68,103091,896909
2,2,2.0,2,0.2,0,2
3,2,3.0,3,0.3,0,3
100,2,81.0,57,5.43,19,81
200,2,174.0,63,5.76,26,174
2000,2,1799.0,460,15.76,201,1799
10000,2,8881.0,1491,51.27,1119,8881
20000,2,17854.0,2160,88.47,2146,17854
40000,2,35758.0,3444,157.56,4242,35758
60000,2,53699.0,4771,229.78,6301,53699
80000,2,71709.0,6125,306.59,8291,71709
100000,2,89610.0,7431,378.42,10390,89610
200000,2,179211.0,14044,739.03,20789,179211
400000,2,358631.0,27237,1461.99,41369,358631
600000,2,537568.0,40603,2196.85,62432,537568
800000,2,716972.0,53983,2936.26,83028,716972
1000000,2,896349.0,67136,3650.99,103651,896349
2,3,2.0,2,0.2,0,2
3,3,3.0,3,0.3,0,3
100,3,85.0,36,2.52,15,85
200,3,174.0,42,3.03,26,174
2000,3,1788.0,158,8.24,212,1788
10000,3,8969.0,705,36.75,1031,8969
20000,3,17960.0,1387,74.8,2040,17960
40000,3,35894.0,2787,152.07,4106,35894
60000,3,53780.0,4063,222.7,6220,53780
80000,3,71676.0,5365,293.23,8324,71676
100000,3,89597.0,6662,365.24,10403,89597
200000,3,179168.0,13400,732.68,20832,179168
400000,3,358627.0,26628,1465.71,41373,358627
600000,3,538007.0,40026,2205.66,61993,538007
800000,3,717396.0,53450,2947.22,82604,717396
1000000,3,896440.0,66831,3687.09,103560,896440
2,4,2.0,2,0.2,0,2
3,4,3.0,3,0.3,0,3
100,4,91.0,25,1.87,9,91
200,4,177.0,32,2.3,23,177
2000,4,1791.0,232,9.52,209,1791
10000,4,8992.0,775,40.42,1008,8992
20000,4,17926.0,1447,75.85,2074,17926
40000,4,35829.0,2781,150.21,4171,35829
60000,4,53661.0,4131,224.82,6339,53661
80000,4,71565.0,5443,296.71,8435,71565
100000,4,89440.0,6735,368.31,10560,89440
200000,4,178944.0,13400,743.21,21056,178944
400000,4,358147.0,26729,1483.19,41853,358147
600000,4,537458.0,40101,2223.06,62542,537458
800000,4,716831.0,53464,2958.61,83169,716831
1000000,4,896053.0,66881,3689.93,103947,896053
2,5,1.0,2,0.2,1,1
3,5,2.0,3,0.3,1,2
100,5,89.0,95,5.27,11,89
200,5,180.0,193,6.52,20,180
2000,5,1774.0,1900,29.62,226,1774
10000,5,8935.0,4106,75.26,1065,8935
20000,5,17931.0,4778,111.59,2069,17931
40000,5,35863.0,6100,181.87,4137,35863
60000,5,53827.0,7458,254.49,6173,53827
80000,5,71692.0,8811,329.85,8308,71692
100000,5,89603.0,10148,402.26,10397,89603
200000,5,179265.0,16721,762.74,20735,179265
400000,5,358661.0,30172,1508.26,41339,358661
600000,5,537917.0,43540,2247.37,62083,537917
800000,5,717282.0,56833,2985.55,82718,717282
1000000,5,896246.0,70112,3720.71,103754,896246
2,6,2.0,2,0.2,0,2
3,6,3.0,3,0.3,0,3
100,6,90.0,70,2.77,10,90
200,6,179.0,93,3.45,21,179
2000,6,1794.0,219,11.19,206,1794
10000,6,8986.0,2267,57.23,1014,8986
20000,6,17898.0,3192,98.88,2102,17898
40000,6,35789.0,6337,190.27,4211,35789
60000,6,53699.0,7769,265.97,6301,53699
80000,6,71596.0,9185,340.79,8404,71596
100000,6,89578.0,10417,408.55,10422,89578
200000,6,179181.0,17120,774.92,20819,179181
400000,6,358554.0,30420,1498.86,41446,358554
600000,6,537793.0,43768,2234.62,62207,537793
800000,6,717270.0,56949,2958.09,82730,717270
1000000,6,896788.0,70221,3688.59,103212,896788
2,7,2.0,2,0.2,0,2
3,7,3.0,3,0.3,0,3
100,7,87.0,61,4.93,13,87
200,7,174.0,74,5.69,26,174
2000,7,1782.0,210,12.81,218,1782
10000,7,8931.0,755,42.11,1069,8931
20000,7,17848.0,1434,81.39,2152,17848
40000,7,35774.0,2779,157.93,4226,35774
60000,7,53768.0,4142,230.51,6232,53768
80000,7,71700.0,5497,308.14,8300,71700
100000,7,89611.0,6819,380.49,10389,89611
200000,7,179218.0,13517,747.35,20782,179218
400000,7,358575.0,26739,1479.15,41425,358575
600000,7,537754.0,40215,2224.29,62246,537754
800000,7,717073.0,53292,2946.72,82927,717073
1000000,7,896253.0,66859,3692.32,103747,896253
2,8,2.0,2,0.2,0,2
3,8,3.0,3,0.3,0,3
100,8,83.0,94,6.79,17,83
200,8,172.0,190,8.02,28,172
2000,8,1757.0,1924,30.49,243,1757
10000,8,8910.0,2488,60.43,1090,8910
20000,8,17874.0,3124,97.3,2126,17874
40000,8,35732.0,4513,174.19,4268,35732
60000,8,53684.0,5809,245.83,6316,53684
80000,8,71568.0,7155,320.04,8432,71568
100000,8,89487.0,9135,402.93,10513,89487
200000,8,179166.0,15837,770.91,20834,179166
400000,8,358446.0,29151,1508.31,41554,358446
600000,8,537802.0,42553,2239.84,62198,537802
800000,8,717038.0,56026,2983.24,82962,717038
1000000,8,896218.0,69598,3726.19,103782,896218
2,9,2.0,2,0.2,0,2
3,9,3.0,3,0.3,0,3
100,9,86.0,99,9.36,14,86
200,9,171.0,196,12.85,29,171
2000,9,1778.0,1923,35.34,222,1778
10000,9,8908.0,5076,86.13,1092,8908
20000,9,17906.0,5724,120.24,2094,17906
40000,9,35837.0,7047,191.61,4163,35837
60000,9,53781.0,8326,258.22,6219,53781
80000,9,71749.0,9636,328.74,8251,71749
100000,9,89750.0,10996,405.52,10250,89750
200000,9,179477.0,17843,789.35,20523,179477
400000,9,358644.0,31054,1513.93,41356,358644
600000,9,537877.0,44465,2245.1,62123,537877
800000,9,717313.0,57909,2980.83,82687,717313
1000000,9,896580.0,71109,3708.18,103420,896580
2,10,1.0,2,0.2,1,1
3,10,2.0,3,0.3,1,2
100,10,85.0,30,2.82,15,85
200,10,171.0,35,2.96,29,171
2000,10,1774.0,286,12.22,226,1774
10000,10,8941.0,1375,49.3,1059,8941
20000,10,17894.0,2108,90.2,2106,17894
40000,10,35745.0,3449,162.92,4255,35745
60000,10,53646.0,4806,238.86,6354,53646
80000,10,71587.0,6119,311.75,8413,71587
100000,10,89474.0,7426,382.6,10526,89474
200000,10,179126.0,14042,744.95,20874,179126
400000,10,358522.0,27430,1487.86,41478,358522
600000,10,537798.0,41036,2228.99,62202,537798
800000,10,717165.0,54207,2947.23,82835,717165
1000000,10,896421.0,67540,3674.2,103579,896421
2,11,2.0,2,0.2,0,2
3,11,3.0,3,0.3,0,3
100,11,87.0,94,6.43,13,87
200,11,179.0,192,7.59,21,179
2000,11,1769.0,1936,29.89,231,1769
10000,11,8929.0,3809,76.07,1071,8929
20000,11,17858.0,4436,111.32,2142,17858
40000,11,35799.0,5750,183.32,4201,35799
60000,11,53661.0,7094,258.86,6339,53661
80000,11,71602.0,8377,331.36,8398,71602
100000,11,89575.0,9719,404.0,10425,89575
200000,11,179107.0,16374,771.69,20893,179107
400000,11,358177.0,29663,1490.48,41823,358177
600000,11,537375.0,42862,2216.83,62625,537375
800000,11,716599.0,56223,2944.71,83401,716599
1000000,11,895837.0,69571,3677.95,104163,895837
2,12,2.0,0,0.0,0,2
3,12,3.0,0,0.0,0,3
100,12,88.0,88,0.88,12,88
200,12,178.0,184,2.11,22,178
2000,12,1794.0,1724,26.24,206,1794
10000,12,8867.0,7452,107.82,1133,8867
20000,12,17739.0,17013,232.5,2261,17739
40000,12,35448.0,36344,484.04,4552,35448
60000,12,53283.0,45097,633.31,6717,53283
80000,12,71323.0,46400,702.5,8677,71323
100000,12,89252.0,47757,777.9,10748,89252
200000,12,178933.0,54533,1142.03,21067,178933
400000,12,358438.0,67897,1879.57,41562,358438
600000,12,537776.0,81343,2623.87,62224,537776
800000,12,717000.0,94577,3349.13,83000,717000
1000000,12,896199.0,107854,4079.68,103801,896199
2,13,1.0,2,0.2,1,1
3,13,2.0,3,0.3,1,2
100,13,82.0,96,2.94,18,82
200,13,170.0,195,4.11,30,170
2000,13,1759.0,1935,26.55,241,1759
10000,13,8920.0,9666,128.34,1080,8920
20000,13,17840.0,16411,228.37,2160,17840
40000,13,35852.0,17713,298.0,4148,35852
60000,13,53845.0,19051,370.6,6155,53845
80000,13,71760.0,20335,442.12,8240,71760
100000,13,89645.0,21621,510.24,10355,89645
200000,13,179347.0,28365,880.17,20653,179347
400000,13,358792.0,41590,1609.93,41208,358792
600000,13,537913.0,54880,2345.38,62087,537913
800000,13,717080.0,68057,3067.46,82920,717080
1000000,13,896486.0,81536,3817.31,103514,896486
2,14,2.0,2,0.2,0,2
3,14,3.0,3,0.3,0,3
100,14,92.0,77,3.11,8,92
200,14,184.0,174,4.44,16,184
2000,14,1804.0,381,12.45,196,1804
10000,14,9012.0,914,41.81,988,9012
20000,14,17944.0,1590,77.55,2056,17944
40000,14,35881.0,2980,153.55,4119,35881
60000,14,53741.0,4368,231.33,6259,53741
80000,14,71650.0,5707,306.46,8350,71650
100000,14,89589.0,7023,379.74,10411,89589
200000,14,179277.0,13521,738.66,20723,179277
400000,14,358672.0,26815,1463.17,41328,358672
600000,14,537755.0,39941,2184.74,62245,537755
800000,14,716829.0,53220,2923.23,83171,716829
1000000,14,896110.0,66527,3661.73,103890,896110
2,15,2.0,2,0.2,0,2
3,15,3.0,3,0.3,0,3
100,15,79.0,96,5.73,21,79
200,15,161.0,195,7.08,39,161
2000,15,1783.0,465,15.81,217,1783
10000,15,8955.0,1021,48.1,1045,8955
20000,15,17954.0,1666,85.42,2046,17954
40000,15,35865.0,2971,157.06,4135,35865
60000,15,53813.0,4305,230.88,6187,53813
80000,15,71683.0,5623,303.73,8317,71683
100000,15,89546.0,6967,378.91,10454,89546
200000,15,179127.0,13563,735.93,20873,179127
400000,15,358175.0,27004,1479.73,41825,358175
600000,15,537470.0,40376,2214.92,62530,537470
800000,15,716879.0,53570,2935.91,83121,716879
1000000,15,896340.0,66841,3669.28,103660,896340
2,16,2.0,2,0.2,0,2
3,16,3.0,3,0.3,0,3
100,16,77.0,96,8.79,23,77
200,16,165.0,194,9.95,35,165
2000,16,1752.0,1941,32.82,248,1752
10000,16,8833.0,7958,116.48,1167,8833
20000,16,17807.0,8650,156.61,2193,17807
40000,16,35720.0,9974,227.9,4280,35720
60000,16,53587.0,11268,298.26,6413,53587
80000,16,71678.0,12566,372.08,8322,71678
100000,16,89691.0,13835,442.64,10309,89691
200000,16,179279.0,20494,818.74,20721,179279
400000,16,358564.0,33802,1551.49,41436,358564
600000,16,537918.0,47213,2286.62,62082,537918
800000,16,717180.0,60656,3023.69,82820,717180
1000000,16,896509.0,73833,3751.62,103491,896509
2,17,1.0,2,0.2,1,1
3,17,2.0,3,0.3,1,2
100,17,75.0,95,9.41,25,75
200,17,149.0,194,18.86,51,149
2000,17,1706.0,1919,83.0,294,1706
10000,17,8780.0,9647,182.33,1220,8780
20000,17,17718.0,16754,284.9,2282,17718
40000,17,35667.0,18112,359.95,4333,35667
60000,17,53629.0,19503,437.67,6371,53629
80000,17,71511.0,20837,507.35,8489,71511
100000,17,89438.0,22182,577.59,10562,89438
200000,17,179069.0,28855,945.37,20931,179069
400000,17,358418.0,42178,1680.88,41582,358418
600000,17,537763.0,55367,2418.38,62237,537763
800000,17,717121.0,68736,3157.68,82879,717121
1000000,17,896387.0,82087,3895.45,103613,896387
2,18,2.0,2,0.2,0,2
3,18,3.0,3,0.21,0,3
100,18,92.0,92,1.28,8,92
200,18,187.0,188,2.69,13,187
2000,18,1776.0,701,12.77,224,1776
10000,18,8920.0,1262,42.14,1080,8920
20000,18,17852.0,1925,81.08,2148,17852
40000,18,35770.0,3276,154.17,4230,35770
60000,18,53593.0,4610,225.2,6407,53593
80000,18,71570.0,5913,296.01,8430,71570
100000,18,89500.0,7186,364.54,10500,89500
200000,18,179128.0,13827,726.69,20872,179128
400000,18,358449.0,27021,1451.73,41551,358449
600000,18,537734.0,40454,2193.65,62266,537734
800000,18,717146.0,53804,2928.89,82854,717146
1000000,18,896365.0,67231,3666.07,103635,896365
2,19,2.0,2,0.2,0,2
3,19,3.0,3,0.3,0,3
100,19,90.0,41,2.75,10,90
200,19,182.0,49,3.01,18,182
2000,19,1795.0,163,8.47,205,1795
10000,19,8944.0,693,37.17,1056,8944
20000,19,17903.0,1398,74.73,2097,17903
40000,19,35841.0,2745,150.3,4159,35841
60000,19,53691.0,4037,222.62,6309,53691
80000,19,71632.0,5380,295.99,8368,71632
100000,19,89611.0,6673,366.25,10389,89611
200000,19,179338.0,13346,736.01,20662,179338
400000,19,358785.0,26656,1469.23,41215,358785
600000,19,538147.0,39924,2198.16,61853,538147
800000,19,717737.0,53090,2918.15,82263,717737
1000000,19,897044.0,66342,3649.26,102956,897044
2,20,1.0,2,0.2,1,1
3,20,2.0,3,0.3,1,2
100,20,86.0,21,1.74,14,86
200,20,177.0,26,1.97,23,177
2000,20,1797.0,254,9.92,203,1797
10000,20,9002.0,838,37.0,998,9002
20000,20,18000.0,1509,73.77,2000,18000
40000,20,35932.0,2860,148.03,4068,35932
60000,20,53810.0,4262,224.33,6190,53810
80000,20,71755.0,5550,294.9,8245,71755
100000,20,89664.0,6913,372.34,10336,89664
200000,20,179349.0,13527,739.62,20651,179349
400000,20,358808.0,26817,1472.37,41192,358808
600000,20,538187.0,40136,2198.93,61813,538187
800000,20,717447.0,53385,2932.8,82553,717447
1000000,20,896667.0,66826,3670.48,103333,896667
2,21,2.0,2,0.2,0,2
3,21,3.0,3,0.3,0,3
100,21,78.0,97,7.27,22,78
200,21,165.0,197,8.54,35,165
2000,21,1774.0,429,15.72,226,1774
10000,21,8922.0,989,46.61,1078,8922
20000,21,17849.0,1640,82.28,2151,17849
40000,21,35753.0,3041,159.83,4247,35753
60000,21,53702.0,4378,236.2,6298,53702
80000,21,71635.0,5724,310.59,8365,71635
100000,21,89497.0,7079,384.8,10503,89497
200000,21,179136.0,13822,757.87,20864,179136
400000,21,358400.0,26968,1482.34,41600,358400
600000,21,537718.0,40245,2206.95,62282,537718
800000,21,717089.0,53564,2938.37,82911,717089
1000000,21,896508.0,67069,3681.55,103492,896508
2,22,2.0,2,0.2,0,2
3,22,3.0,3,0.3,0,3
100,22,82.0,96,6.18,18,82
200,22,164.0,173,8.03,36,164
2000,22,1774.0,283,14.62,226,1774
10000,22,8958.0,817,43.9,1042,8958
20000,22,17936.0,1495,80.74,2064,17936
40000,22,35874.0,2801,153.47,4126,35874
60000,22,53814.0,4133,222.86,6186,53814
80000,22,71715.0,5491,294.76,8285,71715
100000,22,89648.0,6831,368.19,10352,89648
200000,22,179250.0,13494,731.46,20750,179250
400000,22,358628.0,26928,1469.43,41372,358628
600000,22,537891.0,40169,2200.43,62109,537891
800000,22,717324.0,53499,2938.71,82676,717324
1000000,22,896766.0,66939,3676.74,103234,896766
2,23,1.0,2,0.2,1,1
3,23,2.0,3,0.3,1,2
100,23,84.0,91,6.58,16,84
200,23,169.0,149,12.02,31,169
2000,23,1762.0,274,18.49,238,1762
10000,23,8955.0,779,46.22,1045,8955
20000,23,17917.0,1461,82.47,2083,17917
40000,23,35783.0,2835,160.56,4217,35783
60000,23,53744.0,4101,230.19,6256,53744
80000,23,71636.0,5438,304.4,8364,71636
100000,23,89538.0,6751,379.18,10462,89538
200000,23,179229.0,13467,745.77,20771,179229
400000,23,358582.0,26795,1480.88,41418,358582
600000,23,537702.0,39995,2209.04,62298,537702
800000,23,716921.0,53434,2948.32,83079,716921
1000000,23,895962.0,66715,3678.37,104038,895962
2,24,2.0,2,0.2,0,2
3,24,2.0,3,0.3,1,2
100,24,87.0,31,2.56,13,87
200,24,184.0,35,2.69,16,184
2000,24,1821.0,159,9.33,179,1821
10000,24,8987.0,722,40.79,1013,8987
20000,24,17965.0,1378,77.32,2035,17965
40000,24,35927.0,2644,145.15,4073,35927
60000,24,53921.0,4009,218.29,6079,53921
80000,24,71760.0,5286,287.94,8240,71760
100000,24,89613.0,6632,361.61,10387,89613
200000,24,179172.0,13407,740.22,20828,179172
400000,24,358524.0,26507,1464.86,41476,358524
600000,24,537725.0,39882,2197.38,62275,537725
800000,24,716805.0,53285,2923.7,83195,716805
1000000,24,896220.0,66414,3641.34,103780,896220
2,25,1.0,2,0.2,1,1
3,25,2.0,3,0.3,1,2
100,25,92.0,90,1.71,8,92
200,25,178.0,182,2.72,22,178
2000,25,1766.0,926,15.83,234,1766
10000,25,8937.0,1450,44.2,1063,8937
20000,25,17905.0,2105,82.43,2095,17905
40000,25,35786.0,3426,153.33,4214,35786
60000,25,53751.0,4769,227.6,6249,53751
80000,25,71629.0,6105,298.56,8371,71629
100000,25,89550.0,7470,375.84,10450,89550
200000,25,179209.0,14120,742.49,20791,179209
400000,25,358589.0,27486,1480.59,41411,358589
600000,25,537900.0,40948,2224.24,62100,537900
800000,25,717259.0,54308,2963.18,82741,717259
1000000,25,896429.0,67655,3700.91,103571,896429
2,26,2.0,2,0.2,0,2
3,26,3.0,3,0.3,0,3
100,26,91.0,57,2.82,9,91
200,26,184.0,65,3.26,16,184
2000,26,1807.0,319,12.19,193,1807
10000,26,8937.0,919,43.57,1063,8937
20000,26,17918.0,1555,78.37,2082,17918
40000,26,35817.0,2888,149.03,4183,35817
60000,26,53681.0,4224,224.76,6319,53681
80000,26,71582.0,5574,297.03,8418,71582
100000,26,89471.0,6911,370.79,10529,89471
200000,26,179134.0,13671,746.01,20866,179134
400000,26,358609.0,26922,1475.13,41391,358609
600000,26,537924.0,40299,2210.73,62076,537924
800000,26,717293.0,53607,2952.75,82707,717293
1000000,26,896515.0,67079,3687.05,103485,896515
2,27,2.0,2,0.2,0,2
3,27,2.0,3,0.3,1,2
100,27,91.0,94,1.93,9,91
200,27,178.0,186,2.94,22,178
2000,27,1781.0,514,10.27,219,1781
10000,27,8992.0,1047,38.19,1008,8992
20000,27,17913.0,1756,77.86,2087,17913
40000,27,35779.0,3139,153.61,4221,35779
60000,27,53675.0,4467,224.31,6325,53675
80000,27,71629.0,5788,297.1,8371,71629
100000,27,89565.0,7134,373.56,10435,89565
200000,27,179171.0,13840,745.36,20829,179171
400000,27,358258.0,27416,1498.34,41742,358258
600000,27,537642.0,40714,2228.65,62358,537642
800000,27,716972.0,53975,2950.85,83028,716972
1000000,27,896175.0,67081,3673.03,103825,896175
2,28,2.0,2,0.2,0,2
3,28,3.0,3,0.3,0,3
100,28,82.0,98,9.35,18,82
200,28,162.0,197,14.57,38,162
2000,28,1767.0,1952,37.88,233,1767
10000,28,8906.0,5686,98.98,1094,8906
20000,28,17823.0,6372,138.42,2177,17823
40000,28,35737.0,7753,212.44,4263,35737
60000,28,53712.0,9083,287.39,6288,53712
80000,28,71581.0,10443,359.58,8419,71581
100000,28,89550.0,11768,435.56,10450,89550
200000,28,179261.0,18405,799.74,20739,179261
400000,28,358657.0,31601,1521.02,41343,358657
600000,28,537815.0,44879,2247.71,62185,537815
800000,28,717313.0,58435,2997.43,82687,717313
1000000,28,896563.0,71827,3730.12,103437,896563
2,29,2.0,2,0.2,0,2
3,29,3.0,3,0.3,0,3
100,29,87.0,96,4.11,13,87
200,29,179.0,133,4.75,21,179
2000,29,1769.0,1124,20.69,231,1769
10000,29,9008.0,1642,49.18,992,9008
20000,29,18006.0,2299,85.54,1994,18006
40000,29,35969.0,3679,160.18,4031,35969
60000,29,53900.0,4969,229.15,6100,53900
80000,29,71834.0,6265,299.62,8166,71834
100000,29,89844.0,7585,370.24,10156,89844
200000,29,179515.0,14359,742.09,20485,179515
400000,29,358924.0,27606,1464.87,41076,358924
600000,29,538308.0,40822,2187.16,61692,538308
800000,29,717479.0,54056,2913.77,82521,717479
1000000,29,896860.0,67600,3659.23,103140,896860
2,30,2.0,2,0.2,0,2
3,30,2.0,3,0.3,1,2
100,30,90.0,13,0.67,10,90
200,30,182.0,23,0.95,18,182
2000,30,1770.0,462,10.38,230,1770
10000,30,8960.0,1039,43.42,1040,8960
20000,30,17948.0,1689,78.54,2052,17948
40000,30,35929.0,2942,146.69,4071,35929
60000,30,53822.0,4213,218.71,6178,53822
80000,30,71727.0,5585,296.15,8273,71727
100000,30,89595.0,6950,371.72,10405,89595
200000,30,179132.0,13630,742.27,20868,179132
400000,30,358328.0,26975,1470.8,41672,358328
600000,30,537396.0,40342,2210.26,62604,537396
800000,30,716693.0,53543,2930.06,83307,716693
1000000,30,895880.0,66971,3667.7,104120,895880
2,31,2.0,2,0.2,0,2
3,31,2.0,3,0.3,1,2
100,31,84.0,76,2.02,16,84
200,31,177.0,87,2.22,23,177
2000,31,1791.0,203,8.78,209,1791
10000,31,8922.0,731,37.55,1078,8922
20000,31,17851.0,1374,72.15,2149,17851
40000,31,35722.0,2705,145.76,4278,35722
60000,31,53661.0,3966,213.54,6339,53661
80000,31,71580.0,5302,288.28,8420,71580
100000,31,89515.0,6675,366.63,10485,89515
200000,31,179309.0,13385,736.67,20691,179309
400000,31,358427.0,26775,1464.48,41573,358427
600000,31,537747.0,40129,2197.15,62253,537747
800000,31,717173.0,53421,2920.83,82827,717173
1000000,31,896353.0,66816,3654.18,103647,896353
2,32,2.0,2,0.2,0,2
3,32,3.0,3,0.3,0,3
100,32,90.0,25,1.87,10,90
200,32,179.0,37,2.08,21,179
2000,32,1782.0,194,9.5,218,1782
10000,32,8997.0,773,36.8,1003,8997
20000,32,17906.0,1408,72.13,2094,17906
40000,32,35802.0,2855,145.64,4198,35802
60000,32,53777.0,4189,215.68,6223,53777
80000,32,71665.0,5515,287.89,8335,71665
100000,32,89622.0,6794,360.62,10378,89622
200000,32,179070.0,13387,720.22,20930,179070
400000,32,358445.0,26759,1460.18,41555,358445
600000,32,537558.0,40340,2194.04,62442,537558
800000,32,716935.0,53644,2919.01,83065,716935
1000000,32,896241.0,67104,3654.63,103759,896241
2,33,2.0,2,0.2,0,2
3,33,3.0,3,0.3,0,3
100,33,80.0,100,9.19,20,80
200,33,173.0,126,9.81,27,173
2000,33,1792.0,244,15.67,208,1792
10000,33,8949.0,780,46.23,1051,8949
20000,33,17890.0,1420,80.89,2110,17890
40000,33,35792.0,2782,154.54,4208,35792
60000,33,53673.0,4048,223.36,6327,53673
80000,33,71645.0,5365,294.31,8355,71645
100000,33,89565.0,6675,366.54,10435,89565
200000,33,179241.0,13291,727.81,20759,179241
400000,33,358523.0,26586,1458.9,41477,358523
600000,33,537856.0,39713,2190.65,62144,537856
800000,33,717046.0,53219,2931.32,82954,717046
1000000,33,896402.0,66692,3667.07,103598,896402
2,34,2.0,2,0.2,0,2
3,34,3.0,3,0.3,0,3
100,34,89.0,16,1.15,11,89
200,34,177.0,23,1.49,23,177
2000,34,1791.0,137,8.39,209,1791
10000,34,8927.0,679,37.66,1073,8927
20000,34,17873.0,1333,73.63,2127,17873
40000,34,35861.0,2735,151.01,4139,35861
60000,34,53782.0,4023,220.14,6218,53782
80000,34,71753.0,5373,294.66,8247,71753
100000,34,89652.0,6671,365.42,10348,89652
200000,34,179206.0,13436,735.65,20794,179206
400000,34,358463.0,26437,1437.97,41537,358463
600000,34,537907.0,39740,2171.93,62093,537907
800000,34,717105.0,53080,2903.02,82895,717105
1000000,34,896254.0,66550,3644.59,103746,896254
2,35,2.0,2,0.2,0,2
3,35,3.0,3,0.3,0,3
100,35,80.0,97,5.29,20,80
200,35,162.0,194,6.8,38,162
2000,35,1743.0,1906,29.59,257,1743
10000,35,8839.0,4752,81.45,1161,8839
20000,35,17825.0,5470,123.01,2175,17825
40000,35,35768.0,6814,196.93,4232,35768
60000,35,53677.0,8103,267.42,6323,53677
80000,35,71690.0,9423,341.73,8310,71690
100000,35,89625.0,10662,412.44,10375,89625
200000,35,179442.0,17518,791.5,20558,179442
400000,35,358724.0,30751,1517.29,41276,358724
600000,35,537947.0,44054,2250.17,62053,537947
800000,35,717276.0,57308,2984.81,82724,717276
1000000,35,896324.0,70549,3716.53,103676,896324
2,36,2.0,2,0.2,0,2
3,36,3.0,3,0.3,0,3
100,36,88.0,27,2.25,12,88
200,36,177.0,36,2.79,23,177
2000,36,1781.0,1199,19.55,219,1781
10000,36,8863.0,8917,118.15,1137,8863
20000,36,17764.0,18599,244.85,2236,17764
40000,36,35506.0,37851,498.12,4494,35506
60000,36,53259.0,55706,741.02,6741,53259
80000,36,71160.0,57084,817.53,8840,71160
100000,36,89089.0,58378,890.14,10911,89089
200000,36,178591.0,65169,1258.11,21409,178591
400000,36,357848.0,78474,1992.54,42152,357848
600000,36,537088.0,91692,2712.69,62912,537088
800000,36,716306.0,104940,3447.18,83694,716306
1000000,36,895681.0,118269,4180.5,104319,895681
2,37,1.0,2,0.2,1,1
3,37,2.0,3,0.3,1,2
100,37,90.0,24,1.05,10,90
200,37,179.0,30,1.47,21,179
2000,37,1768.0,157,7.78,232,1768
10000,37,8933.0,697,37.75,1067,8933
20000,37,17901.0,1410,73.59,2099,17901
40000,37,35788.0,2733,144.24,4212,35788
60000,37,53716.0,4062,215.76,6284,53716
80000,37,71571.0,5343,286.35,8429,71571
100000,37,89466.0,6684,361.68,10534,89466
200000,37,179222.0,13345,731.59,20778,179222
400000,37,358456.0,26678,1471.07,41544,358456
600000,37,537842.0,40039,2210.56,62158,537842
800000,37,716986.0,53263,2931.04,83014,716986
1000000,37,896106.0,66578,3656.75,103894,896106
2,38,1.0,1,0.1,1,1
3,38,2.0,1,0.1,1,2
100,38,86.0,96,1.5,14,86
200,38,176.0,195,2.85,24,176
2000,38,1809.0,1929,24.42,191,1809
10000,38,8926.0,5226,81.06,1074,8926
20000,38,17845.0,5847,114.63,2155,17845
40000,38,35799.0,7152,187.08,4201,35799
60000,38,53681.0,8497,260.92,6319,53681
80000,38,71552.0,9866,333.74,8448,71552
100000,38,89525.0,11247,410.91,10475,89525
200000,38,179293.0,17897,773.96,20707,179293
400000,38,358555.0,31362,1516.11,41445,358555
600000,38,537846.0,44882,2271.59,62154,537846
800000,38,717080.0,58142,3011.78,82920,717080
1000000,38,896272.0,71611,3753.07,103728,896272
2,39,1.0,2,0.2,1,1
3,39,2.0,3,0.3,1,2
100,39,91.0,45,1.35,9,91
200,39,178.0,128,2.45,22,178
2000,39,1795.0,247,8.59,205,1795
10000,39,8955.0,763,36.07,1045,8955
20000,39,17851.0,1379,68.78,2149,17851
40000,39,35821.0,2681,140.39,4179,35821
60000,39,53757.0,4012,216.34,6243,53757
80000,39,71634.0,5393,295.13,8366,71634
100000,39,89544.0,6750,369.72,10456,89544
200000,39,179135.0,13401,740.16,20865,179135
400000,39,358577.0,26735,1479.02,41423,358577
600000,39,537590.0,40167,2227.68,62410,537590
800000,39,716965.0,53440,2946.58,83035,716965
1000000,39,896196.0,66760,3685.12,103804,896196
2,40,1.0,2,0.2,1,1
3,40,2.0,3,0.3,1,2
100,40,92.0,19,1.72,8,92
200,40,177.0,27,2.16,23,177
2000,40,1786.0,146,7.76,214,1786
10000,40,8991.0,708,34.53,1009,8991
20000,40,17971.0,1361,70.22,2029,17971
40000,40,35850.0,2662,141.01,4150,35850
60000,40,53810.0,4053,215.94,6190,53810
80000,40,71701.0,5382,287.64,8299,71701
100000,40,89568.0,6705,359.55,10432,89568
200000,40,179158.0,13241,723.26,20842,179158
400000,40,358225.0,26351,1443.86,41775,358225
600000,40,537397.0,39678,2188.14,62603,537397
800000,40,716564.0,53020,2916.82,83436,716564
1000000,40,895741.0,66299,3640.01,104259,895741
2,41,2.0,0,0.0,0,2
3,41,3.0,0,0.0,0,3
100,41,87.0,62,1.07,13,87
200,41,180.0,69,1.41,20,180
2000,41,1809.0,194,7.88,191,1809
10000,41,8954.0,743,35.24,1046,8954
20000,41,17949.0,1409,71.6,2051,17949
40000,41,35885.0,2738,143.93,4115,35885
60000,41,53875.0,4126,220.63,6125,53875
80000,41,71831.0,5487,297.33,8169,71831
100000,41,89688.0,7060,373.81,10312,89688
200000,41,179309.0,17027,770.84,20691,179309
400000,41,358705.0,31471,1513.15,41295,358705
600000,41,538123.0,44592,2233.86,61877,538123
800000,41,717288.0,57635,2957.3,82712,717288
1000000,41,896624.0,70887,3685.44,103376,896624
2,42,2.0,2,0.2,0,2
3,42,3.0,3,0.3,0,3
100,42,91.0,21,1.29,9,91
200,42,177.0,28,1.54,23,177
2000,42,1760.0,1605,23.34,240,1760
10000,42,8860.0,9337,125.68,1140,8860
20000,42,17737.0,19039,255.37,2263,17737
40000,42,35445.0,38210,504.68,4555,35445
60000,42,53188.0,57571,757.15,6812,53188
80000,42,70943.0,76575,1003.26,9057,70943
100000,42,88685.0,95897,1255.88,11315,88685
200000,42,178349.0,119801,1794.89,21651,178349
400000,42,357611.0,133219,2525.14,42389,357611
600000,42,536958.0,146577,3262.8,63042,536958
800000,42,716333.0,159713,3992.03,83667,716333
1000000,42,895725.0,172853,4711.76,104275,895725
2,43,1.0,2,0.2,1,1
3,43,2.0,3,0.3,1,2
100,43,84.0,89,3.05,16,84
200,43,175.0,183,4.26,25,175
2000,43,1800.0,528,13.29,200,1800
10000,43,8978.0,1049,41.9,1022,8978
20000,43,17959.0,1721,78.05,2041,17959
40000,43,35921.0,3107,152.93,4079,35921
60000,43,53799.0,4369,220.09,6201,53799
80000,43,71777.0,5743,296.56,8223,71777
100000,43,89800.0,7089,367.8,10200,89800
200000,43,179586.0,13777,732.22,20414,179586
400000,43,358927.0,27166,1466.14,41073,358927
600000,43,538076.0,40383,2202.21,61924,538076
800000,43,717323.0,53723,2934.74,82677,717323
1000000,43,896674.0,66933,3649.14,103326,896674
2,44,2.0,2,0.2,0,2
3,44,3.0,3,0.3,0,3
100,44,79.0,91,4.15,21,79
200,44,167.0,187,5.47,33,167
2000,44,1800.0,1887,27.15,200,1800
10000,44,8955.0,6511,97.51,1045,8955
20000,44,17881.0,7180,134.26,2119,17881
40000,44,35817.0,8504,208.16,4183,35817
60000,44,53746.0,9860,282.92,6254,53746
80000,44,71741.0,11215,360.19,8259,71741
100000,44,89605.0,12553,437.38,10395,89605
200000,44,179314.0,19215,801.27,20686,179314
400000,44,358578.0,32546,1538.03,41422,358578
600000,44,537927.0,45834,2272.29,62073,537927
800000,44,717121.0,59084,3010.04,82879,717121
1000000,44,896363.0,72291,3738.99,103637,896363
2,45,2.0,1,0.1,0,2
3,45,3.0,2,0.2,0,3
100,45,92.0,9,0.54,8,92
200,45,186.0,17,0.89,14,186
2000,45,1818.0,268,9.25,182,1818
10000,45,9028.0,2063,49.97,972,9028
20000,45,17977.0,2948,89.87,2023,17977
40000,45,35908.0,4330,165.61,4092,35908
60000,45,53840.0,5667,238.02,6160,53840
80000,45,71719.0,6982,307.42,8281,71719
100000,45,89682.0,8385,384.99,10318,89682
200000,45,179291.0,14854,744.16,20709,179291
400000,45,358538.0,28154,1483.13,41462,358538
600000,45,537701.0,41614,2231.08,62299,537701
800000,45,717154.0,54917,2963.51,82846,717154
1000000,45,896590.0,68161,3694.54,103410,896590
2,46,2.0,2,0.2,0,2
3,46,3.0,3,0.3,0,3
100,46,83.0,64,6.4,17,83
200,46,173.0,153,14.67,27,173
2000,46,1736.0,1888,58.57,264,1736
10000,46,8826.0,9639,161.91,1174,8826
20000,46,17714.0,16146,256.05,2286,17714
40000,46,35627.0,17447,326.66,4373,35627
60000,46,53576.0,18792,399.69,6424,53576
80000,46,71477.0,20084,469.94,8523,71477
100000,46,89399.0,21362,540.14,10601,89399
200000,46,179014.0,28018,903.61,20986,179014
400000,46,358130.0,41434,1642.57,41870,358130
600000,46,537334.0,54687,2369.91,62666,537334
800000,46,716480.0,67961,3108.71,83520,716480
1000000,46,895606.0,81290,3851.84,104394,895606
2,47,1.0,2,0.2,1,1
3,47,2.0,3,0.3,1,2
100,47,81.0,71,2.87,19,81
200,47,172.0,80,3.59,28,172
2000,47,1800.0,199,10.09,200,1800
10000,47,8970.0,701,37.79,1030,8970
20000,47,17922.0,1358,74.42,2078,17922
40000,47,35887.0,2699,147.86,4113,35887
60000,47,53803.0,4016,223.58,6197,53803
80000,47,71721.0,5368,299.11,8279,71721
100000,47,89670.0,6723,376.2,10330,89670
200000,47,179237.0,13351,735.61,20763,179237
400000,47,358425.0,26673,1466.61,41575,358425
600000,47,537658.0,40004,2192.3,62342,537658
800000,47,717002.0,53338,2921.89,82998,717002
1000000,47,896415.0,66549,3641.79,103585,896415
2,48,2.0,2,0.02,0,2
3,48,3.0,3,0.03,0,3
100,48,88.0,27,0.81,12,88
200,48,178.0,39,1.2,22,178
2000,48,1772.0,604,11.35,228,1772
10000,48,8939.0,1120,38.29,1061,8939
20000,48,17881.0,1795,73.3,2119,17881
40000,48,35869.0,3138,149.73,4131,35869
60000,48,53739.0,4465,225.82,6261,53739
80000,48,71657.0,5827,302.35,8343,71657
100000,48,89617.0,7154,374.12,10383,89617
200000,48,179411.0,13653,738.27,20589,179411
400000,48,358768.0,27053,1469.78,41232,358768
600000,48,538264.0,40324,2195.86,61736,538264
800000,48,717713.0,53683,2927.41,82287,717713
1000000,48,897174.0,66801,3645.12,102826,897174
2,49,2.0,2,0.2,0,2
3,49,3.0,3,0.3,0,3
100,49,85.0,22,1.84,15,85
200,49,177.0,42,2.31,23,177
2000,49,1778.0,155,8.39,222,1778
10000,49,8956.0,792,38.16,1044,8956
20000,49,17882.0,1411,70.9,2118,17882
40000,49,35756.0,2769,143.07,4244,35756
60000,49,53761.0,4060,211.24,6239,53761
80000,49,71667.0,5464,290.89,8333,71667
100000,49,89618.0,6732,361.8,10382,89618
200000,49,179294.0,13559,733.55,20706,179294
400000,49,358703.0,26780,1455.08,41297,358703
600000,49,538079.0,40004,2179.61,61921,538079
800000,49,717432.0,53393,2912.54,82568,717432
1000000,49,896630.0,66703,3642.52,103370,896630
2,50,2.0,2,0.2,0,2
3,50,3.0,3,0.3,0,3
100,50,85.0,81,2.61,15,85
200,50,171.0,179,3.95,29,171
2000,50,1801.0,615,14.07,199,1801
10000,50,8967.0,1117,40.96,1033,8967
20000,50,17954.0,1740,75.63,2046,17954
40000,50,35867.0,3122,152.9,4133,35867
60000,50,53777.0,4459,224.59,6223,53777
80000,50,71723.0,5812,299.05,8277,71723
100000,50,89604.0,7162,369.34,10396,89604
200000,50,179049.0,13843,740.8,20951,179049
400000,50,358272.0,27078,1465.71,41728,358272
600000,50,537625.0,40526,2206.79,62375,537625
800000,50,717001.0,53828,2932.73,82999,717001
1000000,50,896047.0,67046,3661.43,103953,896047
2,51,0.0,2,0.2,2,0
3,51,1.0,3,0.3,2,1
100,51,82.0,98,6.65,18,82
200,51,171.0,195,7.98,29,171
2000,51,1775.0,1940,30.92,225,1775
10000,51,8917.0,9672,131.73,1083,8917
20000,51,17772.0,19341,258.93,2228,17772
40000,51,35574.0,38680,512.71,4426,35574
60000,51,53399.0,58024,767.53,6601,53399
80000,51,71257.0,67555,920.17,8743,71257
100000,51,89152.0,68926,994.54,10848,89152
200000,51,178701.0,75482,1353.59,21299,178701
400000,51,357895.0,88602,2075.64,42105,357895
600000,51,537192.0,101834,2807.45,62808,537192
800000,51,716471.0,115195,3545.59,83529,716471
1000000,51,895617.0,128662,4289.65,104383,895617
2,52,2.0,2,0.2,0,2
3,52,3.0,3,0.3,0,3
100,52,92.0,43,2.59,8,92
200,52,182.0,48,2.82,18,182
2000,52,1796.0,175,10.12,204,1796
10000,52,8951.0,815,39.56,1049,8951
20000,52,17952.0,1508,78.35,2048,17952
40000,52,35915.0,2871,146.52,4085,35915
60000,52,53855.0,4145,219.2,6145,53855
80000,52,71782.0,5552,297.8,8218,71782
100000,52,89738.0,6859,371.17,10262,89738
200000,52,179373.0,13668,747.96,20627,179373
400000,52,358638.0,26949,1480.71,41362,358638
600000,52,537822.0,40434,2216.67,62178,537822
800000,52,717188.0,53812,2948.77,82812,717188
1000000,52,896502.0,67042,3678.58,103498,896502
2,53,2.0,1,0.1,0,2
3,53,3.0,2,0.2,0,3
100,53,94.0,58,1.48,6,94
200,53,188.0,150,2.67,12,188
2000,53,1785.0,1102,18.13,215,1785
10000,53,9007.0,1697,50.45,993,9007
20000,53,18032.0,2332,84.16,1968,18032
40000,53,35941.0,3648,155.64,4059,35941
60000,53,53844.0,4981,229.09,6156,53844
80000,53,71804.0,6336,306.09,8196,71804
100000,53,89724.0,7671,377.67,10276,89724
200000,53,179276.0,14373,751.05,20724,179276
400000,53,358540.0,27715,1493.14,41460,358540
600000,53,537781.0,41035,2228.62,62219,537781
800000,53,717050.0,54271,2961.01,82950,717050
1000000,53,896455.0,67606,3698.62,103545,896455
2,54,2.0,2,0.2,0,2
3,54,3.0,3,0.3,0,3
100,54,86.0,100,4.6,14,86
200,54,174.0,193,5.8,26,174
2000,54,1781.0,1923,29.85,219,1781
10000,54,8984.0,3596,70.97,1016,8984
20000,54,17901.0,4215,103.8,2099,17901
40000,54,35851.0,5521,175.9,4149,35851
60000,54,53746.0,6884,251.72,6254,53746
80000,54,71700.0,8243,323.99,8300,71700
100000,54,89617.0,9605,395.66,10383,89617
200000,54,179253.0,16219,757.99,20747,179253
400000,54,358453.0,29568,1496.1,41547,358453
600000,54,537582.0,43024,2231.32,62418,537582
800000,54,716677.0,56412,2972.79,83323,716677
1000000,54,896055.0,69553,3692.98,103945,896055
2,55,1.0,2,0.2,1,1
3,55,2.0,3,0.3,1,2
100,55,91.0,40,4.0,9,91
200,55,182.0,65,4.61,18,182
2000,55,1805.0,176,9.86,195,1805
10000,55,8974.0,702,38.61,1026,8974
20000,55,17977.0,1374,74.94,2023,17977
40000,55,35818.0,2672,148.31,4182,35818
60000,55,53753.0,4051,222.49,6247,53753
80000,55,71660.0,5320,291.61,8340,71660
100000,55,89643.0,6705,366.21,10357,89643
200000,55,179253.0,13151,722.81,20747,179253
400000,55,358496.0,26493,1445.55,41504,358496
600000,55,537868.0,39930,2180.49,62132,537868
800000,55,717286.0,53246,2913.68,82714,717286
1000000,55,896409.0,66530,3633.95,103591,896409
2,56,1.0,2,0.2,1,1
3,56,1.0,3,0.3,2,1
100,56,81.0,73,4.87,19,81
200,56,171.0,80,5.39,29,171
2000,56,1805.0,263,13.52,195,1805
10000,56,8959.0,1018,44.47,1041,8959
20000,56,17944.0,1689,82.59,2056,17944
40000,56,35797.0,3046,157.72,4203,35797
60000,56,53718.0,4358,229.07,6282,53718
80000,56,71612.0,5726,306.11,8388,71612
100000,56,89636.0,7046,377.72,10364,89636
200000,56,179356.0,13597,740.23,20644,179356
400000,56,358888.0,26782,1468.78,41112,358888
600000,56,538226.0,40272,2218.02,61774,538226
800000,56,717626.0,53495,2944.43,82374,717626
1000000,56,896822.0,66696,3666.66,103178,896822
2,57,2.0,2,0.2,0,2
3,57,3.0,3,0.21,0,3
100,57,77.0,95,9.14,23,77
200,57,165.0,192,11.73,35,165
2000,57,1769.0,1932,35.25,231,1769
10000,57,8809.0,8771,128.66,1191,8809
20000,57,17687.0,18438,255.3,2313,17687
40000,57,35458.0,37781,508.76,4542,35458
60000,57,53211.0,57116,764.66,6789,53211
80000,57,70910.0,76441,1019.29,9090,70910
100000,57,88770.0,85686,1171.5,11230,88770
200000,57,178278.0,92513,1547.75,21722,178278
400000,57,357611.0,105713,2277.98,42389,357611
600000,57,536881.0,119149,3032.53,63119,536881
800000,57,716300.0,132554,3769.94,83700,716300
1000000,57,895558.0,145872,4497.57,104442,895558
2,58,1.0,2,0.11,1,1
3,58,1.0,3,0.12,2,1
100,58,95.0,41,0.77,5,95
200,58,185.0,52,1.06,15,185
2000,58,1784.0,371,9.65,216,1784
10000,58,8956.0,1067,39.74,1044,8956
20000,58,17948.0,1757,76.43,2052,17948
40000,58,35874.0,3125,152.03,4126,35874
60000,58,53764.0,4444,225.79,6236,53764
80000,58,71656.0,5767,303.55,8344,71656
100000,58,89593.0,7119,376.02,10407,89593
200000,58,179138.0,13848,742.74,20862,179138
400000,58,358444.0,27219,1479.18,41556,358444
600000,58,537637.0,40744,2223.37,62363,537637
800000,58,717005.0,54024,2958.63,82995,717005
1000000,58,896186.0,67408,3694.03,103814,896186
2,59,2.0,2,0.2,0,2
3,59,3.0,3,0.3,0,3
100,59,89.0,82,3.79,11,89
200,59,180.0,162,5.13,20,180
2000,59,1796.0,576,14.67,204,1796
10000,59,8998.0,3441,69.24,1002,8998
20000,59,17959.0,4135,107.68,2041,17959
40000,59,35933.0,5445,181.26,4067,35933
60000,59,53848.0,6789,254.46,6152,53848
80000,59,71710.0,8134,328.75,8290,71710
100000,59,89639.0,9455,400.55,10361,89639
200000,59,179183.0,16165,767.89,20817,179183
400000,59,358366.0,29515,1500.07,41634,358366
600000,59,537811.0,42884,2233.25,62189,537811
800000,59,717127.0,56251,2968.75,82873,717127
1000000,59,896512.0,69680,3705.77,103488,896512
2,60,1.0,2,0.2,1,1
3,60,2.0,3,0.3,1,2
100,60,81.0,97,3.13,19,81
200,60,171.0,177,4.11,29,171
2000,60,1805.0,307,11.62,195,1805
10000,60,8964.0,853,41.74,1036,8964
20000,60,17898.0,1830,82.02,2102,17898
40000,60,35805.0,3205,155.71,4195,35805
60000,60,53759.0,4515,230.55,6241,53759
80000,60,71699.0,5846,302.54,8301,71699
100000,60,89627.0,7188,377.16,10373,89627
200000,60,179198.0,13889,750.08,20802,179198
400000,60,358396.0,27249,1495.41,41604,358396
600000,60,537607.0,40522,2223.13,62393,537607
800000,60,716993.0,53938,2962.81,83007,716993
1000000,60,896353.0,67228,3690.61,103647,896353
2,61,1.0,2,0.2,1,1
3,61,2.0,3,0.3,1,2
100,61,79.0,94,8.59,21,79
200,61,166.0,192,18.12,34,166
2000,61,1758.0,460,36.01,242,1758
10000,61,8938.0,1021,67.09,1062,8938
20000,61,17905.0,1689,104.46,2095,17905
40000,61,35798.0,3037,179.68,4202,35798
60000,61,53744.0,4355,254.15,6256,53744
80000,61,71639.0,5687,326.15,8361,71639
100000,61,89560.0,7051,403.24,10440,89560
200000,61,179155.0,13862,777.62,20845,179155
400000,61,358455.0,27245,1526.51,41545,358455
600000,61,538034.0,40719,2267.22,61966,538034
800000,61,717511.0,54148,3008.38,82489,717511
1000000,61,896661.0,67590,3739.5,103339,896661
2,62,1.0,2,0.2,1,1
3,62,2.0,3,0.3,1,2
100,62,83.0,83,5.96,17,83
200,62,169.0,153,7.11,31,169
2000,62,1782.0,1895,29.75,218,1782
10000,62,8975.0,3307,69.34,1025,8975
20000,62,17971.0,3993,106.26,2029,17971
40000,62,35850.0,5288,178.7,4150,35850
60000,62,53797.0,6618,253.38,6203,53797
80000,62,71616.0,7948,326.44,8384,71616
100000,62,89577.0,9338,401.54,10423,89577
200000,62,179090.0,16102,780.58,20910,179090
400000,62,358273.0,29453,1519.34,41727,358273
600000,62,537100.0,42901,2259.25,62900,537100
800000,62,716409.0,56191,2979.49,83591,716409
1000000,62,895972.0,69300,3702.42,104028,895972
2,63,1.0,2,0.2,1,1
3,63,1.0,3,0.3,2,1
100,63,91.0,63,1.44,9,91
200,63,176.0,152,2.42,24,176
2000,63,1772.0,1763,24.38,228,1772
10000,63,8859.0,9496,125.83,1141,8859
20000,63,17752.0,16145,222.65,2248,17752
40000,63,35708.0,17448,293.37,4292,35708
60000,63,53617.0,18771,367.17,6383,53617
80000,63,71558.0,20029,436.36,8442,71558
100000,63,89481.0,21367,510.22,10519,89481
200000,63,178974.0,27921,871.68,21026,178974
400000,63,358035.0,41123,1592.48,41965,358035
600000,63,537461.0,54345,2320.05,62539,537461
800000,63,716724.0,67680,3049.02,83276,716724
1000000,63,896240.0,81088,3796.0,103760,896240
2,64,2.0,2,0.2,0,2
3,64,3.0,2,0.2,0,3
100,64,89.0,66,1.29,11,89
200,64,177.0,162,5.94,23,177
2000,64,1771.0,1892,29.99,229,1771
10000,64,8880.0,8412,117.96,1120,8880
20000,64,17866.0,9058,153.13,2134,17866
40000,64,35773.0,10389,226.83,4227,35773
60000,64,53782.0,11772,300.69,6218,53782
80000,64,71695.0,13109,371.66,8305,71695
100000,64,89618.0,14446,446.23,10382,89618
200000,64,179285.0,21154,815.98,20715,179285
400000,64,358401.0,34687,1557.28,41599,358401
600000,64,537786.0,47784,2276.94,62214,537786
800000,64,717287.0,61153,3007.96,82713,717287
1000000,64,896500.0,74559,3747.54,103500,896500
2,65,2.0,2,0.02,0,2
3,65,2.0,3,0.03,1,2
100,65,88.0,92,1.91,12,88
200,65,177.0,180,2.88,23,177
2000,65,1807.0,750,14.25,193,1807
10000,65,9001.0,1301,45.23,999,9001
20000,65,17963.0,1989,83.88,2037,17963
40000,65,35857.0,3330,158.4,4143,35857
60000,65,53818.0,4695,233.7,6182,53818
80000,65,71746.0,5997,306.21,8254,71746
100000,65,89694.0,7365,380.19,10306,89694
200000,65,179426.0,13970,744.86,20574,179426
400000,65,358700.0,27266,1485.14,41300,358700
600000,65,537698.0,40646,2218.16,62302,537698
800000,65,717153.0,53948,2947.97,82847,717153
1000000,65,896423.0,67057,3669.64,103577,896423
2,66,2.0,2,0.2,0,2
3,66,3.0,3,0.21,0,3
100,66,80.0,99,9.63,20,80
200,66,155.0,191,18.65,45,155
2000,66,1773.0,341,25.82,227,1773
10000,66,8920.0,859,53.95,1080,8920
20000,66,17871.0,1566,89.91,2129,17871
40000,66,35777.0,2851,162.7,4223,35777
60000,66,53697.0,4137,231.27,6303,53697
80000,66,71633.0,5508,308.16,8367,71633
100000,66,89490.0,6847,381.94,10510,89490
200000,66,179096.0,13483,742.51,20904,179096
400000,66,358295.0,26866,1468.45,41705,358295
600000,66,537721.0,40198,2200.45,62279,537721
800000,66,717000.0,53552,2935.91,83000,717000
1000000,66,896150.0,66939,3671.61,103850,896150
2,67,1.0,2,0.2,1,1
3,67,2.0,3,0.3,1,2
100,67,83.0,91,9.1,17,83
200,67,171.0,113,9.68,29,171
2000,67,1794.0,225,15.66,206,1794
10000,67,8986.0,754,44.62,1014,8986
20000,67,17916.0,1437,80.52,2084,17916
40000,67,35923.0,2806,155.86,4077,35923
60000,67,53902.0,4127,228.65,6098,53902
80000,67,71891.0,5514,308.58,8109,71891
100000,67,89770.0,6864,382.92,10230,89770
200000,67,179370.0,13566,753.69,20630,179370
400000,67,358671.0,26882,1495.07,41329,358671
600000,67,538050.0,40369,2230.69,61950,538050
800000,67,717445.0,53674,2961.34,82555,717445
1000000,67,896678.0,66979,3698.2,103322,896678
2,68,2.0,2,0.2,0,2
3,68,2.0,3,0.3,1,2
100,68,78.0,95,5.36,22,78
200,68,171.0,190,6.76,29,171
2000,68,1770.0,1701,26.46,230,1770
10000,68,8873.0,9379,128.17,1127,8873
20000,68,17764.0,19040,255.29,2236,17764
40000,68,35779.0,21085,336.49,4221,35779
60000,68,53697.0,22363,408.85,6303,53697
80000,68,71636.0,23725,481.06,8364,71636
100000,68,89557.0,25048,552.25,10443,89557
200000,68,179231.0,31734,915.39,20769,179231
400000,68,358434.0,44937,1635.93,41566,358434
600000,68,537787.0,58474,2377.81,62213,537787
800000,68,717025.0,71626,3107.2,82975,717025
1000000,68,896444.0,85093,3852.16,103556,896444
2,69,2.0,2,0.2,0,2
3,69,3.0,3,0.21,0,3
100,69,89.0,62,1.7,11,89
200,69,179.0,70,2.05,21,179
2000,69,1785.0,1481,21.74,215,1785
10000,69,8862.0,8308,112.51,1138,8862
20000,69,17737.0,17986,237.19,2263,17737
40000,69,35605.0,26784,386.01,4395,35605
60000,69,53594.0,28114,458.98,6406,53594
80000,69,71574.0,29499,534.84,8426,71574
100000,69,89498.0,30806,606.68,10502,89498
200000,69,179237.0,37468,973.09,20763,179237
400000,69,358539.0,50679,1699.92,41461,358539
600000,69,537682.0,64167,2444.28,62318,537682
800000,69,717107.0,77454,3181.59,82893,717107
1000000,69,896528.0,90773,3912.56,103472,896528
2,70,2.0,2,0.2,0,2
3,70,3.0,3,0.3,0,3
100,70,89.0,26,2.24,11,89
200,70,174.0,50,2.75,26,174
2000,70,1768.0,203,10.04,232,1768
10000,70,8940.0,763,40.84,1060,8940
20000,70,17858.0,1453,77.26,2142,17858
40000,70,35721.0,2718,146.79,4279,35721
60000,70,53680.0,4241,223.49,6320,53680
80000,70,71637.0,5566,296.95,8363,71637
100000,70,89604.0,6935,372.11,10396,89604
200000,70,179378.0,13608,744.75,20622,179378
400000,70,358640.0,26988,1484.97,41360,358640
600000,70,537969.0,40390,2220.1,62031,537969
800000,70,716915.0,53701,2957.74,83085,716915
1000000,70,896130.0,66979,3682.45,103870,896130
2,71,1.0,2,0.2,1,1
3,71,2.0,3,0.3,1,2
100,71,93.0,93,1.92,7,93
200,71,182.0,190,2.98,18,182
2000,71,1791.0,1439,19.88,209,1791
10000,71,8911.0,1990,52.84,1089,8911
20000,71,17877.0,2652,89.34,2123,17877
40000,71,35855.0,3971,161.12,4145,35855
60000,71,53796.0,5327,235.16,6204,53796
80000,71,71722.0,6633,306.9,8278,71722
100000,71,89642.0,8016,382.92,10358,89642
200000,71,179248.0,14747,753.44,20752,179248
400000,71,358445.0,28049,1488.38,41555,358445
600000,71,537775.0,41552,2235.86,62225,537775
800000,71,717091.0,54793,2965.24,82909,717091
1000000,71,896237.0,68158,3700.54,103763,896237
2,72,2.0,2,0.2,0,2
3,72,3.0,3,0.3,0,3
100,72,86.0,90,3.33,14,86
200,72,171.0,189,4.59,29,171
2000,72,1771.0,1933,27.52,229,1771
10000,72,8900.0,9643,127.75,1100,8900
20000,72,17806.0,19298,252.29,2194,17806
40000,72,35616.0,38637,504.54,4384,35616
60000,72,53442.0,57970,760.69,6558,53442
80000,72,71166.0,76993,1013.29,8834,71166
100000,72,88994.0,96364,1265.5,11006,88994
200000,72,178356.0,131359,1909.39,21644,178356
400000,72,357465.0,144695,2641.97,42535,357465
600000,72,536918.0,158079,3370.8,63082,536918
800000,72,716195.0,171431,4100.84,83805,716195
1000000,72,895686.0,184662,4831.38,104314,895686
2,73,2.0,2,0.2,0,2
3,73,3.0,3,0.3,0,3
100,73,73.0,35,3.5,27,73
200,73,160.0,114,4.47,40,160
2000,73,1748.0,1853,27.98,252,1748
10000,73,8841.0,9634,129.28,1159,8841
20000,73,17696.0,19307,255.17,2304,17696
40000,73,35556.0,22395,343.2,4444,35556
60000,73,53531.0,23756,418.46,6469,53531
80000,73,71496.0,25098,492.81,8504,71496
100000,73,89511.0,26432,566.27,10489,89511
200000,73,179164.0,33125,932.63,20836,179164
400000,73,358430.0,46286,1653.56,41570,358430
600000,73,537679.0,59736,2400.51,62321,537679
800000,73,717022.0,73136,3139.04,82978,717022
1000000,73,896564.0,86350,3862.93,103436,896564
2,74,2.0,2,0.2,0,2
3,74,2.0,3,0.3,1,2
100,74,76.0,97,9.52,24,76
200,74,156.0,197,15.83,44,156
2000,74,1740.0,1908,38.25,260,1740
10000,74,8865.0,8274,122.25,1135,8865
20000,74,17880.0,8921,157.52,2120,17880
40000,74,35798.0,10272,230.88,4202,35798
60000,74,53755.0,11634,305.07,6245,53755
80000,74,71719.0,12996,379.08,8281,71719
100000,74,89593.0,14390,455.48,10407,89593
200000,74,179209.0,20965,816.88,20791,179209
400000,74,358537.0,34193,1536.86,41463,358537
600000,74,538093.0,47279,2260.37,61907,538093
800000,74,717075.0,60779,3005.93,82925,717075
1000000,74,896193.0,74188,3747.97,103807,896193
2,75,2.0,1,0.1,0,2
3,75,3.0,2,0.2,0,3
100,75,78.0,95,8.69,22,78
200,75,159.0,193,18.31,41,159
2000,75,1736.0,536,46.31,264,1736
10000,75,8903.0,1043,73.52,1097,8903
20000,75,17854.0,1751,114.8,2146,17854
40000,75,35781.0,3109,187.24,4219,35781
60000,75,53701.0,4455,263.88,6299,53701
80000,75,71649.0,5861,340.49,8351,71649
100000,75,89598.0,7210,413.2,10402,89598
200000,75,179195.0,13889,778.43,20805,179195
400000,75,358543.0,27197,1503.71,41457,358543
600000,75,537756.0,40575,2240.31,62244,537756
800000,75,716981.0,53878,2969.41,83019,716981
1000000,75,896153.0,67237,3702.49,103847,896153
2,76,0.0,2,0.2,2,0
3,76,1.0,3,0.3,2,1
100,76,88.0,91,2.44,12,88
200,76,176.0,189,3.6,24,176
2000,76,1752.0,1920,28.2,248,1752
10000,76,8937.0,3053,62.12,1063,8937
20000,76,17897.0,3732,99.6,2103,17897
40000,76,35763.0,5073,171.69,4237,35763
60000,76,53672.0,6362,243.62,6328,53672
80000,76,71609.0,7671,316.83,8391,71609
100000,76,89519.0,8998,389.05,10481,89519
200000,76,179349.0,15676,762.73,20651,179349
400000,76,358918.0,29170,1493.65,41082,358918
600000,76,538494.0,42473,2218.16,61506,538494
800000,76,717854.0,55878,2956.56,82146,717854
1000000,76,897112.0,69114,3680.04,102888,897112
2,77,2.0,0,0.0,0,2
3,77,3.0,0,0.0,0,3
100,77,87.0,58,5.62,13,87
200,77,173.0,110,10.46,27,173
2000,77,1758.0,245,17.66,242,1758
10000,77,8941.0,2305,63.28,1059,8941
20000,77,17898.0,2982,99.48,2102,17898
40000,77,35857.0,4295,170.21,4143,35857
60000,77,53709.0,5655,245.01,6291,53709
80000,77,71728.0,7035,323.25,8272,71728
100000,77,89707.0,8377,395.8,10293,89707
200000,77,179363.0,15019,761.56,20637,179363
400000,77,358386.0,28269,1490.31,41614,358386
600000,77,537454.0,41448,2219.16,62546,537454
800000,77,716742.0,54822,2953.56,83258,716742
1000000,77,896192.0,68011,3674.14,103808,896192
2,78,2.0,2,0.2,0,2
3,78,3.0,3,0.3,0,3
100,78,85.0,47,3.89,15,85
200,78,168.0,98,6.2,32,168
2000,78,1758.0,1838,30.35,242,1758
10000,78,8835.0,9571,131.44,1165,8835
20000,78,17730.0,19236,256.8,2270,17730
40000,78,35573.0,38074,504.76,4427,35573
60000,78,53411.0,51857,697.85,6589,53411
80000,78,71368.0,53098,764.08,8632,71368
100000,78,89338.0,54416,837.11,10662,89338
200000,78,178844.0,60953,1202.09,21156,178844
400000,78,358232.0,74459,1945.37,41768,358232
600000,78,537402.0,87696,2677.68,62598,537402
800000,78,716566.0,100994,3406.91,83434,716566
1000000,78,895976.0,114234,4141.05,104024,895976
2,79,1.0,2,0.2,1,1
3,79,2.0,3,0.3,1,2
100,79,88.0,50,1.49,12,88
200,79,179.0,58,1.93,21,179
2000,79,1785.0,205,7.81,215,1785
10000,79,8929.0,728,37.16,1071,8929
20000,79,17905.0,1379,72.11,2095,17905
40000,79,35837.0,2800,151.3,4163,35837
60000,79,53661.0,4135,223.6,6339,53661
80000,79,71605.0,5500,300.79,8395,71605
100000,79,89457.0,6764,369.14,10543,89457
200000,79,179087.0,13462,733.3,20913,179087
400000,79,358534.0,26724,1459.83,41466,358534
600000,79,537905.0,39945,2187.21,62095,537905
800000,79,717225.0,53297,2922.56,82775,717225
1000000,79,896457.0,66653,3663.8,103543,896457
2,80,2.0,2,0.2,0,2
3,80,2.0,3,0.3,1,2
100,80,91.0,21,1.47,9,91
200,80,172.0,32,2.12,28,172
2000,80,1777.0,151,7.9,223,1777
10000,80,8969.0,752,41.27,1031,8969
20000,80,17953.0,1403,77.12,2047,17953
40000,80,35867.0,2711,151.22,4133,35867
60000,80,53747.0,4095,228.06,6253,53747
80000,80,71786.0,5370,294.27,8214,71786
100000,80,89791.0,6690,366.33,10209,89791
200000,80,179416.0,13393,730.72,20584,179416
400000,80,358875.0,26569,1452.79,41125,358875
600000,80,538116.0,39966,2196.51,61884,538116
800000,80,717402.0,53198,2924.72,82598,717402
1000000,80,896812.0,66428,3652.82,103188,896812
2,81,1.0,2,0.2,1,1
3,81,2.0,3,0.3,1,2
100,81,88.0,95,6.26,12,88
200,81,175.0,179,7.46,25,175
2000,81,1783.0,336,15.15,217,1783
10000,81,8957.0,921,48.27,1043,8957
20000,81,17947.0,1583,84.86,2053,17947
40000,81,35900.0,2976,162.15,4100,35900
60000,81,53919.0,4304,236.27,6081,53919
80000,81,71880.0,5647,310.72,8120,71880
100000,81,89836.0,6982,385.63,10164,89836
200000,81,179502.0,13706,757.97,20498,179502
400000,81,358784.0,27058,1499.71,41216,358784
600000,81,538060.0,40288,2227.72,61940,538060
800000,81,717641.0,53776,2965.24,82359,717641
1000000,81,896882.0,67178,3700.37,103118,896882
2,82,1.0,2,0.2,1,1
3,82,1.0,3,0.3,2,1
100,82,83.0,25,2.23,17,83
200,82,169.0,31,2.65,31,169
2000,82,1776.0,156,9.48,224,1776
10000,82,8934.0,679,38.56,1066,8934
20000,82,17909.0,1680,77.46,2091,17909
40000,82,35858.0,2995,151.09,4142,35858
60000,82,53779.0,4399,228.85,6221,53779
80000,82,71706.0,5743,302.41,8294,71706
100000,82,89681.0,7059,374.07,10319,89681
200000,82,179276.0,13667,736.88,20724,179276
400000,82,358648.0,27030,1471.53,41352,358648
600000,82,537867.0,40321,2205.37,62133,537867
800000,82,717135.0,54019,2948.32,82865,717135
1000000,82,896332.0,67121,3673.61,103668,896332
2,83,1.0,2,0.2,1,1
3,83,2.0,3,0.3,1,2
100,83,93.0,35,0.98,7,93
200,83,180.0,49,1.48,20,180
2000,83,1801.0,198,7.92,199,1801
10000,83,8973.0,752,37.67,1027,8973
20000,83,17915.0,1422,74.43,2085,17915
40000,83,35837.0,2747,144.2,4163,35837
60000,83,53804.0,4140,222.84,6196,53804
80000,83,71767.0,5520,297.66,8233,71767
100000,83,89680.0,6872,371.48,10320,89680
200000,83,179299.0,13552,739.96,20701,179299
400000,83,358906.0,26733,1468.02,41094,358906
600000,83,538161.0,39924,2198.07,61839,538161
800000,83,717348.0,53265,2924.58,82652,717348
1000000,83,896767.0,66622,3658.63,103233,896767
2,84,2.0,2,0.2,0,2
3,84,3.0,3,0.3,0,3
100,84,94.0,32,2.3,6,94
200,84,181.0,39,2.73,19,181
2000,84,1802.0,167,9.23,198,1802
10000,84,8997.0,733,40.09,1003,8997
20000,84,17979.0,1452,81.93,2021,17979
40000,84,35909.0,2788,156.13,4091,35909
60000,84,53815.0,4081,223.15,6185,53815
80000,84,71820.0,5407,296.53,8180,71820
100000,84,89715.0,6656,363.74,10285,89715
200000,84,179268.0,13298,729.32,20732,179268
400000,84,358459.0,26549,1453.67,41541,358459
600000,84,537478.0,39838,2198.11,62522,537478
800000,84,716811.0,53252,2937.14,83189,716811
1000000,84,896079.0,66618,3678.21,103921,896079
2,85,0.0,2,0.2,2,0
3,85,1.0,3,0.3,2,1
100,85,83.0,25,1.96,17,83
200,85,170.0,31,2.2,30,170
2000,85,1783.0,150,7.71,217,1783
10000,85,8943.0,687,36.12,1057,8943
20000,85,17936.0,1334,70.76,2064,17936
40000,85,35850.0,2677,146.92,4150,35850
60000,85,53807.0,4083,226.14,6193,53807
80000,85,71708.0,5455,304.84,8292,71708
100000,85,89637.0,6797,379.46,10363,89637
200000,85,179328.0,13426,739.69,20672,179328
400000,85,358725.0,26591,1459.31,41275,358725
600000,85,537833.0,39882,2180.46,62167,537833
800000,85,717176.0,53495,2929.85,82824,717176
1000000,85,896279.0,66943,3667.6,103721,896279
2,86,1.0,2,0.2,1,1
3,86,2.0,3,0.3,1,2
100,86,82.0,95,9.05,18,82
200,86,162.0,190,17.02,38,162
2000,86,1743.0,1509,36.42,257,1743
10000,86,8928.0,2057,65.57,1072,8928
20000,86,17926.0,2762,103.22,2074,17926
40000,86,35843.0,4052,175.16,4157,35843
60000,86,53741.0,5396,248.54,6259,53741
80000,86,71656.0,6712,317.32,8344,71656
100000,86,89534.0,7965,385.65,10466,89534
200000,86,179273.0,14514,744.54,20727,179273
400000,86,358564.0,27789,1476.42,41436,358564
600000,86,537689.0,41223,2217.99,62311,537689
800000,86,717012.0,54293,2936.93,82988,717012
1000000,86,896527.0,67603,3671.5,103473,896527
2,87,1.0,2,0.2,1,1
3,87,2.0,3,0.3,1,2
100,87,86.0,94,2.2,14,86
200,87,171.0,193,3.82,29,171
2000,87,1777.0,1830,26.04,223,1777
10000,87,8916.0,9457,124.18,1084,8916
20000,87,17811.0,19100,253.19,2189,17811
40000,87,35698.0,24290,365.66,4302,35698
60000,87,53535.0,25624,441.73,6465,53535
80000,87,71542.0,26999,517.67,8458,71542
100000,87,89492.0,28232,585.08,10508,89492
200000,87,179142.0,34961,954.68,20858,179142
400000,87,358162.0,48317,1687.73,41838,358162
600000,87,537426.0,61603,2421.79,62574,537426
800000,87,716852.0,74961,3153.87,83148,716852
1000000,87,895952.0,88451,3895.91,104048,895952
2,88,2.0,2,0.02,0,2
3,88,3.0,3,0.03,0,3
100,88,85.0,84,5.88,15,85
200,88,169.0,180,7.11,31,169
2000,88,1774.0,1907,29.33,226,1774
10000,88,8812.0,9621,131.58,1188,8812
20000,88,17739.0,19206,258.12,2261,17739
40000,88,35621.0,21303,341.82,4379,35621
60000,88,53613.0,22590,410.31,6387,53613
80000,88,71606.0,23943,482.43,8394,71606
100000,88,89547.0,25257,555.42,10453,89547
200000,88,179362.0,31996,925.03,20638,179362
400000,88,359031.0,45370,1657.27,40969,359031
600000,88,538450.0,58723,2400.37,61550,538450
800000,88,717718.0,72049,3129.16,82282,717718
1000000,88,897145.0,85198,3854.2,102855,897145
2,89,1.0,2,0.2,1,1
3,89,2.0,3,0.3,1,2
100,89,74.0,97,9.7,26,74
200,89,161.0,196,13.48,39,161
2000,89,1745.0,414,20.61,255,1745
10000,89,8932.0,951,51.09,1068,8932
20000,89,17916.0,1570,85.72,2084,17916
40000,89,35841.0,2943,160.02,4159,35841
60000,89,53789.0,4323,235.11,6211,53789
80000,89,71717.0,5693,310.28,8283,71717
100000,89,89594.0,7062,387.51,10406,89594
200000,89,179181.0,13595,748.22,20819,179181
400000,89,358447.0,26908,1476.61,41553,358447
600000,89,537798.0,40136,2204.96,62202,537798
800000,89,717145.0,53564,2949.17,82855,717145
1000000,89,896544.0,66612,3662.58,103456,896544
2,90,2.0,1,0.1,0,2
3,90,3.0,2,0.2,0,3
100,90,86.0,95,3.74,14,86
200,90,179.0,191,5.15,21,179
2000,90,1799.0,1939,27.94,201,1799
10000,90,8904.0,8638,117.88,1096,8904
20000,90,17817.0,9329,155.66,2183,17817
40000,90,35730.0,10675,227.44,4270,35730
60000,90,53708.0,12006,298.8,6292,53708
80000,90,71582.0,13340,370.37,8418,71582
100000,90,89603.0,14662,443.53,10397,89603
200000,90,179233.0,21316,810.04,20767,179233
400000,90,358422.0,34827,1547.61,41578,358422
600000,90,537693.0,48330,2293.92,62307,537693
800000,90,717258.0,61578,3024.45,82742,717258
1000000,90,896522.0,74865,3757.62,103478,896522
2,91,1.0,2,0.2,1,1
3,91,1.0,3,0.3,2,1
100,91,87.0,91,2.62,13,87
200,91,181.0,189,3.87,19,181
2000,91,1785.0,1923,26.25,215,1785
10000,91,8908.0,9563,125.06,1092,8908
20000,91,17783.0,18657,244.35,2217,17783
40000,91,35518.0,32253,435.84,4482,35518
60000,91,53434.0,33603,509.01,6566,53434
80000,91,71335.0,34901,579.14,8665,71335
100000,91,89329.0,36267,654.36,10671,89329
200000,91,179041.0,42996,1023.6,20959,179041
400000,91,358337.0,56282,1749.02,41663,358337
600000,91,537575.0,69640,2484.52,62425,537575
800000,91,716788.0,83026,3223.45,83212,716788
1000000,91,895778.0,96442,3964.3,104222,895778
2,92,2.0,1,0.1,0,2
3,92,3.0,2,0.2,0,3
100,92,89.0,16,0.79,11,89
200,92,179.0,22,0.94,21,179
2000,92,1766.0,146,8.39,234,1766
10000,92,8926.0,680,37.85,1074,8926
20000,92,17926.0,1287,69.3,2074,17926
40000,92,35892.0,2568,139.17,4108,35892
60000,92,53875.0,3923,215.18,6125,53875
80000,92,71802.0,5303,289.46,8198,71802
100000,92,89781.0,6584,358.7,10219,89781
200000,92,179420.0,13127,720.5,20580,179420
400000,92,358725.0,26564,1456.61,41275,358725
600000,92,537836.0,39890,2186.03,62164,537836
800000,92,717022.0,53074,2911.69,82978,717022
1000000,92,896360.0,66435,3653.61,103640,896360
2,93,1.0,2,0.2,1,1
3,93,2.0,3,0.3,1,2
100,93,91.0,18,1.44,9,91
200,93,181.0,28,1.99,19,181
2000,93,1792.0,142,8.26,208,1792
10000,93,8966.0,688,40.36,1034,8966
20000,93,17880.0,1372,77.89,2120,17880
40000,93,35782.0,2708,152.9,4218,35782
60000,93,53755.0,4016,226.19,6245,53755
80000,93,71675.0,5365,303.49,8325,71675
100000,93,89582.0,6705,375.39,10418,89582
200000,93,179320.0,13390,742.75,20680,179320
400000,93,358761.0,26937,1483.47,41239,358761
600000,93,538027.0,40491,2224.35,61973,538027
800000,93,717449.0,53820,2956.86,82551,717449
1000000,93,896911.0,66979,3683.62,103089,896911
2,94,2.0,2,0.2,0,2
3,94,3.0,3,0.3,0,3
100,94,84.0,92,1.73,16,84
200,94,171.0,188,3.23,29,171
2000,94,1766.0,1862,26.27,234,1766
10000,94,8933.0,2534,53.96,1067,8933
20000,94,17892.0,3128,86.18,2108,17892
40000,94,35776.0,4434,157.56,4224,35776
60000,94,53816.0,5704,225.16,6184,53816
80000,94,71721.0,7075,302.14,8279,71721
100000,94,89716.0,8366,371.3,10284,89716
200000,94,179496.0,15115,744.61,20504,179496
400000,94,358622.0,28430,1478.33,41378,358622
600000,94,537792.0,41711,2211.35,62208,537792
800000,94,717090.0,55023,2947.83,82910,717090
1000000,94,896384.0,68392,3689.74,103616,896384
2,95,2.0,2,0.11,0,2
3,95,3.0,3,0.21,0,3
100,95,85.0,97,3.04,15,85
200,95,175.0,193,4.27,25,175
2000,95,1761.0,946,16.93,239,1761
10000,95,8938.0,1476,44.64,1062,8938
20000,95,17898.0,2147,81.86,2102,17898
40000,95,35756.0,3435,152.43,4244,35756
60000,95,53728.0,4798,226.36,6272,53728
80000,95,71680.0,6116,296.87,8320,71680
100000,95,89610.0,7450,371.95,10390,89610
200000,95,179377.0,14149,742.78,20623,179377
400000,95,358540.0,27356,1469.39,41460,358540
600000,95,537884.0,40680,2201.58,62116,537884
800000,95,717225.0,53923,2933.41,82775,717225
1000000,95,896915.0,67392,3669.84,103085,896915
2,96,2.0,2,0.2,0,2
3,96,3.0,3,0.3,0,3
100,96,89.0,11,0.74,11,89
200,96,181.0,20,1.37,19,181
2000,96,1802.0,149,8.24,198,1802
10000,96,9020.0,1439,43.91,980,9020
20000,96,17977.0,2253,84.0,2023,17977
40000,96,35908.0,3620,158.78,4092,35908
60000,96,53832.0,4965,231.81,6168,53832
80000,96,71748.0,6220,301.42,8252,71748
100000,96,89585.0,7647,378.78,10415,89585
200000,96,179098.0,14193,733.41,20902,179098
400000,96,358298.0,27589,1463.62,41702,358298
600000,96,537613.0,40843,2194.21,62387,537613
800000,96,716964.0,54418,2947.27,83036,716964
1000000,96,896218.0,67569,3671.88,103782,896218
2,97,2.0,0,0.0,0,2
3,97,3.0,0,0.0,0,3
100,97,85.0,44,1.61,15,85
200,97,176.0,48,1.83,24,176
2000,97,1795.0,180,9.27,205,1795
10000,97,8965.0,760,40.27,1035,8965
20000,97,17955.0,1575,75.87,2045,17955
40000,97,35909.0,2903,148.28,4091,35909
60000,97,53766.0,4228,218.86,6234,53766
80000,97,71685.0,5537,290.54,8315,71685
100000,97,89557.0,6962,365.09,10443,89557
200000,97,179116.0,13517,725.93,20884,179116
400000,97,358541.0,26775,1453.95,41459,358541
600000,97,537934.0,40094,2187.89,62066,537934
800000,97,717061.0,53449,2924.17,82939,717061
1000000,97,896505.0,66669,3654.33,103495,896505
2,98,2.0,2,0.2,0,2
3,98,3.0,3,0.3,0,3
100,98,85.0,87,8.61,15,85
200,98,171.0,123,11.76,29,171
2000,98,1799.0,387,19.35,201,1799
10000,98,8949.0,906,46.5,1051,8949
20000,98,17896.0,1584,84.78,2104,17896
40000,98,35719.0,2946,158.97,4281,35719
60000,98,53683.0,4251,233.22,6317,53683
80000,98,71632.0,5610,308.28,8368,71632
100000,98,89487.0,7053,386.7,10513,89487
200000,98,179048.0,13784,760.64,20952,179048
400000,98,358347.0,27015,1488.93,41653,358347
600000,98,537651.0,40322,2212.31,62349,537651
800000,98,716885.0,53597,2938.97,83115,716885
1000000,98,896565.0,66903,3668.82,103435,896565
2,99,2.0,2,0.2,0,2
3,99,2.0,3,0.3,1,2
100,99,90.0,37,1.27,10,90
200,99,176.0,52,1.78,24,176
2000,99,1814.0,164,7.4,186,1814
10000,99,8941.0,719,38.42,1059,8941
20000,99,17889.0,1334,71.3,2111,17889
40000,99,35872.0,2678,145.58,4128,35872
60000,99,53806.0,3988,216.91,6194,53806
80000,99,71732.0,5405,289.49,8268,71732
100000,99,89640.0,6748,363.22,10360,89640
200000,99,179213.0,13327,738.07,20787,179213
400000,99,358398.0,26678,1466.3,41602,358398
600000,99,537655.0,40067,2205.44,62345,537655
800000,99,716901.0,53463,2946.27,83099,716901
1000000,99,896195.0,66863,3692.0,103805,896195
2,100,1.0,2,0.2,1,1
3,100,2.0,3,0.3,1,2
100,100,88.0,95,3.83,12,88
200,100,172.0,190,4.96,28,172
2000,100,1772.0,1913,27.41,228,1772
10000,100,8857.0,9231,123.63,1143,8857
20000,100,17789.0,12376,183.79,2211,17789
40000,100,35808.0,13725,258.3,4192,35808
60000,100,53728.0,15093,332.1,6272,53728
80000,100,71650.0,16439,409.64,8350,71650
100000,100,89659.0,17758,481.96,10341,89659
200000,100,179317.0,24492,847.74,20683,179317
400000,100,358547.0,37807,1580.2,41453,358547
600000,100,537942.0,51107,2312.42,62058,537942
800000,100,717042.0,64525,3053.2,82958,717042
1000000,100,896380.0,77777,3786.65,103620,896380
