Timestep,Iteration,Total Reward,Suboptimal Arms,Total Regret,Zeros Count,Ones Count
2,1,1.0,1,0.05,1,1
3,1,1.0,2,0.06,2,1
100,1,83.0,66,1.98,17,83
200,1,167.0,133,4.01,33,167
2000,1,1734.0,1333,40.01,266,1734
10000,1,8786.0,6666,199.98,1214,8786
20000,1,17608.0,13333,400.01,2392,17608
40000,1,35251.0,26666,799.98,4749,35251
60000,1,52968.0,40000,1200.0,7032,52968
80000,1,70552.0,53333,1600.01,9448,70552
100000,1,88120.0,66666,1999.98,11880,88120
200000,1,176033.0,133333,4000.01,23967,176033
400000,1,353961.0,200000,6000.0,46039,353961
600000,1,533889.0,200000,6000.0,66111,533889
800000,1,713780.0,200000,6000.0,86220,713780
1000000,1,893910.0,200000,6000.0,106090,893910
2,2,1.0,1,0.05,1,1
3,2,2.0,2,0.06,1,2
100,2,88.0,66,1.98,12,88
200,2,172.0,133,4.01,28,172
2000,2,1778.0,1333,40.01,222,1778
10000,2,8800.0,6666,199.98,1200,8800
20000,2,17625.0,13333,400.01,2375,17625
40000,2,35246.0,26666,799.98,4754,35246
60000,2,52819.0,40000,1200.0,7181,52819
80000,2,70419.0,53333,1600.01,9581,70419
100000,2,87995.0,66666,1999.98,12005,87995
200000,2,175952.0,133333,4000.01,24048,175952
400000,2,353872.0,200000,6000.0,46128,353872
600000,2,533659.0,200000,6000.0,66341,533659
800000,2,713520.0,200000,6000.0,86480,713520
1000000,2,893545.0,200000,6000.0,106455,893545
2,3,2.0,1,0.05,0,2
3,3,3.0,2,0.06,0,3
100,3,81.0,66,1.98,19,81
200,3,168.0,133,4.01,32,168
2000,3,1748.0,1333,40.01,252,1748
10000,3,8796.0,6666,199.98,1204,8796
20000,3,17539.0,13333,400.01,2461,17539
40000,3,35157.0,26666,799.98,4843,35157
60000,3,52704.0,40000,1200.0,7296,52704
80000,3,70360.0,53333,1600.01,9640,70360
100000,3,87858.0,66666,1999.98,12142,87858
200000,3,175908.0,133333,4000.01,24092,175908
400000,3,354049.0,200000,6000.0,45951,354049
600000,3,534264.0,200000,6000.0,65736,534264
800000,3,714424.0,200000,6000.0,85576,714424
1000000,3,894654.0,200000,6000.0,105346,894654
2,4,2.0,1,0.05,0,2
3,4,3.0,2,0.06,0,3
100,4,88.0,66,1.98,12,88
200,4,180.0,133,4.01,20,180
2000,4,1760.0,1333,40.01,240,1760
10000,4,8773.0,6666,199.98,1227,8773
20000,4,17581.0,13333,400.01,2419,17581
40000,4,35137.0,26666,799.98,4863,35137
60000,4,52714.0,40000,1200.0,7286,52714
80000,4,70273.0,53333,1600.01,9727,70273
100000,4,87880.0,66666,1999.98,12120,87880
200000,4,175965.0,133333,4000.01,24035,175965
400000,4,354126.0,200000,6000.0,45874,354126
600000,4,534083.0,200000,6000.0,65917,534083
800000,4,714096.0,200000,6000.0,85904,714096
1000000,4,894084.0,200000,6000.0,105916,894084
2,5,2.0,1,0.05,0,2
3,5,3.0,2,0.06,0,3
100,5,85.0,66,1.98,15,85
200,5,175.0,133,4.01,25,175
2000,5,1735.0,1333,40.01,265,1735
10000,5,8811.0,6666,199.98,1189,8811
20000,5,17664.0,13333,400.01,2336,17664
40000,5,35327.0,26666,799.98,4673,35327
60000,5,52866.0,40000,1200.0,7134,52866
80000,5,70469.0,53333,1600.01,9531,70469
100000,5,88093.0,66666,1999.98,11907,88093
200000,5,176009.0,133333,4000.01,23991,176009
400000,5,353995.0,200000,6000.0,46005,353995
600000,5,533967.0,200000,6000.0,66033,533967
800000,5,713945.0,200000,6000.0,86055,713945
1000000,5,893944.0,200000,6000.0,106056,893944
2,6,2.0,1,0.05,0,2
3,6,2.0,2,0.06,1,2
100,6,88.0,66,1.98,12,88
200,6,177.0,133,4.01,23,177
2000,6,1771.0,1333,40.01,229,1771
10000,6,8770.0,6666,199.98,1230,8770
20000,6,17536.0,13333,400.01,2464,17536
40000,6,35107.0,26666,799.98,4893,35107
60000,6,52784.0,40000,1200.0,7216,52784
80000,6,70426.0,53333,1600.01,9574,70426
100000,6,87999.0,66666,1999.98,12001,87999
200000,6,176068.0,133333,4000.01,23932,176068
400000,6,354018.0,200000,6000.0,45982,354018
600000,6,534180.0,200000,6000.0,65820,534180
800000,6,714118.0,200000,6000.0,85882,714118
1000000,6,894098.0,200000,6000.0,105902,894098
2,7,2.0,1,0.05,0,2
3,7,3.0,2,0.06,0,3
100,7,89.0,66,1.98,11,89
200,7,169.0,133,4.01,31,169
2000,7,1743.0,1333,40.01,257,1743
10000,7,8783.0,6666,199.98,1217,8783
20000,7,17627.0,13333,400.01,2373,17627
40000,7,35144.0,26666,799.98,4856,35144
60000,7,52791.0,40000,1200.0,7209,52791
80000,7,70434.0,53333,1600.01,9566,70434
100000,7,88079.0,66666,1999.98,11921,88079
200000,7,176022.0,133333,4000.01,23978,176022
400000,7,354295.0,200000,6000.0,45705,354295
600000,7,534310.0,200000,6000.0,65690,534310
800000,7,714338.0,200000,6000.0,85662,714338
1000000,7,894250.0,200000,6000.0,105750,894250
2,8,2.0,1,0.05,0,2
3,8,3.0,2,0.06,0,3
100,8,89.0,66,1.98,11,89
200,8,179.0,133,4.01,21,179
2000,8,1763.0,1333,40.01,237,1763
10000,8,8780.0,6666,199.98,1220,8780
20000,8,17560.0,13333,400.01,2440,17560
40000,8,35172.0,26666,799.98,4828,35172
60000,8,52872.0,40000,1200.0,7128,52872
80000,8,70467.0,53333,1600.01,9533,70467
100000,8,88151.0,66666,1999.98,11849,88151
200000,8,176332.0,133333,4000.01,23668,176332
400000,8,354158.0,200000,6000.0,45842,354158
600000,8,534039.0,200000,6000.0,65961,534039
800000,8,714035.0,200000,6000.0,85965,714035
1000000,8,894119.0,200000,6000.0,105881,894119
2,9,2.0,1,0.05,0,2
3,9,3.0,2,0.06,0,3
100,9,88.0,66,1.98,12,88
200,9,176.0,133,4.01,24,176
2000,9,1782.0,1333,40.01,218,1782
10000,9,8830.0,6666,199.98,1170,8830
20000,9,17642.0,13333,400.01,2358,17642
40000,9,35310.0,26666,799.98,4690,35310
60000,9,52898.0,40000,1200.0,7102,52898
80000,9,70508.0,53333,1600.01,9492,70508
100000,9,88099.0,66666,1999.98,11901,88099
200000,9,175833.0,133333,4000.01,24167,175833
400000,9,353754.0,200000,6000.0,46246,353754
600000,9,533750.0,200000,6000.0,66250,533750
800000,9,714223.0,200000,6000.0,85777,714223
1000000,9,894244.0,200000,6000.0,105756,894244
2,10,2.0,1,0.05,0,2
3,10,3.0,2,0.06,0,3
100,10,85.0,66,1.98,15,85
200,10,173.0,133,4.01,27,173
2000,10,1755.0,1333,40.01,245,1755
10000,10,8800.0,6666,199.98,1200,8800
20000,10,17603.0,13333,400.01,2397,17603
40000,10,35163.0,26666,799.98,4837,35163
60000,10,52691.0,40000,1200.0,7309,52691
80000,10,70245.0,53333,1600.01,9755,70245
100000,10,87835.0,66666,1999.98,12165,87835
200000,10,175811.0,133333,4000.01,24189,175811
400000,10,353812.0,200000,6000.0,46188,353812
600000,10,533754.0,200000,6000.0,66246,533754
800000,10,713538.0,200000,6000.0,86462,713538
1000000,10,893605.0,200000,6000.0,106395,893605
2,11,2.0,1,0.05,0,2
3,11,2.0,2,0.06,1,2
100,11,87.0,66,1.98,13,87
200,11,172.0,133,4.01,28,172
2000,11,1756.0,1333,40.01,244,1756
10000,11,8801.0,6666,199.98,1199,8801
20000,11,17595.0,13333,400.01,2405,17595
40000,11,35182.0,26666,799.98,4818,35182
60000,11,52807.0,40000,1200.0,7193,52807
80000,11,70402.0,53333,1600.01,9598,70402
100000,11,88014.0,66666,1999.98,11986,88014
200000,11,176064.0,133333,4000.01,23936,176064
400000,11,353873.0,200000,6000.0,46127,353873
600000,11,534123.0,200000,6000.0,65877,534123
800000,11,714145.0,200000,6000.0,85855,714145
1000000,11,894131.0,200000,6000.0,105869,894131
2,12,2.0,1,0.05,0,2
3,12,3.0,2,0.06,0,3
100,12,91.0,66,1.98,9,91
200,12,186.0,133,4.01,14,186
2000,12,1752.0,1333,40.01,248,1752
10000,12,8793.0,6666,199.98,1207,8793
20000,12,17606.0,13333,400.01,2394,17606
40000,12,35217.0,26666,799.98,4783,35217
60000,12,52803.0,40000,1200.0,7197,52803
80000,12,70319.0,53333,1600.01,9681,70319
100000,12,87927.0,66666,1999.98,12073,87927
200000,12,175948.0,133333,4000.01,24052,175948
400000,12,354013.0,200000,6000.0,45987,354013
600000,12,533874.0,200000,6000.0,66126,533874
800000,12,714027.0,200000,6000.0,85973,714027
1000000,12,894373.0,200000,6000.0,105627,894373
2,13,2.0,1,0.05,0,2
3,13,2.0,2,0.06,1,2
100,13,91.0,66,1.98,9,91
200,13,179.0,133,4.01,21,179
2000,13,1780.0,1333,40.01,220,1780
10000,13,8831.0,6666,199.98,1169,8831
20000,13,17680.0,13333,400.01,2320,17680
40000,13,35232.0,26666,799.98,4768,35232
60000,13,52779.0,40000,1200.0,7221,52779
80000,13,70396.0,53333,1600.01,9604,70396
100000,13,88083.0,66666,1999.98,11917,88083
200000,13,176101.0,133333,4000.01,23899,176101
400000,13,354235.0,200000,6000.0,45765,354235
600000,13,534426.0,200000,6000.0,65574,534426
800000,13,714538.0,200000,6000.0,85462,714538
1000000,13,894391.0,200000,6000.0,105609,894391
2,14,2.0,1,0.05,0,2
3,14,3.0,2,0.06,0,3
100,14,92.0,66,1.98,8,92
200,14,181.0,133,4.01,19,181
2000,14,1781.0,1333,40.01,219,1781
10000,14,8827.0,6666,199.98,1173,8827
20000,14,17681.0,13333,400.01,2319,17681
40000,14,35367.0,26666,799.98,4633,35367
60000,14,52935.0,40000,1200.0,7065,52935
80000,14,70601.0,53333,1600.01,9399,70601
100000,14,88175.0,66666,1999.98,11825,88175
200000,14,176210.0,133333,4000.01,23790,176210
400000,14,354279.0,200000,6000.0,45721,354279
600000,14,534427.0,200000,6000.0,65573,534427
800000,14,714349.0,200000,6000.0,85651,714349
1000000,14,894576.0,200000,6000.0,105424,894576
2,15,2.0,1,0.05,0,2
3,15,3.0,2,0.06,0,3
100,15,82.0,66,1.98,18,82
200,15,167.0,133,4.01,33,167
2000,15,1759.0,1333,40.01,241,1759
10000,15,8797.0,6666,199.98,1203,8797
20000,15,17617.0,13333,400.01,2383,17617
40000,15,35267.0,26666,799.98,4733,35267
60000,15,52967.0,40000,1200.0,7033,52967
80000,15,70623.0,53333,1600.01,9377,70623
100000,15,88167.0,66666,1999.98,11833,88167
200000,15,176278.0,133333,4000.01,23722,176278
400000,15,354196.0,200000,6000.0,45804,354196
600000,15,533947.0,200000,6000.0,66053,533947
800000,15,713699.0,200000,6000.0,86301,713699
1000000,15,893925.0,200000,6000.0,106075,893925
2,16,2.0,1,0.05,0,2
3,16,3.0,2,0.06,0,3
100,16,90.0,66,1.98,10,90
200,16,176.0,133,4.01,24,176
2000,16,1770.0,1333,40.01,230,1770
10000,16,8809.0,6666,199.98,1191,8809
20000,16,17566.0,13333,400.01,2434,17566
40000,16,35150.0,26666,799.98,4850,35150
60000,16,52787.0,40000,1200.0,7213,52787
80000,16,70410.0,53333,1600.01,9590,70410
100000,16,88065.0,66666,1999.98,11935,88065
200000,16,175996.0,133333,4000.01,24004,175996
400000,16,354191.0,200000,6000.0,45809,354191
600000,16,533932.0,200000,6000.0,66068,533932
800000,16,713718.0,200000,6000.0,86282,713718
1000000,16,893863.0,200000,6000.0,106137,893863
2,17,2.0,1,0.05,0,2
3,17,3.0,2,0.06,0,3
100,17,85.0,66,1.98,15,85
200,17,172.0,133,4.01,28,172
2000,17,1743.0,1333,40.01,257,1743
10000,17,8757.0,6666,199.98,1243,8757
20000,17,17568.0,13333,400.01,2432,17568
40000,17,35211.0,26666,799.98,4789,35211
60000,17,52836.0,40000,1200.0,7164,52836
80000,17,70402.0,53333,1600.01,9598,70402
100000,17,87998.0,66666,1999.98,12002,87998
200000,17,176037.0,133333,4000.01,23963,176037
400000,17,354095.0,200000,6000.0,45905,354095
600000,17,534367.0,200000,6000.0,65633,534367
800000,17,714219.0,200000,6000.0,85781,714219
1000000,17,894107.0,200000,6000.0,105893,894107
2,18,2.0,1,0.05,0,2
3,18,3.0,2,0.06,0,3
100,18,84.0,66,1.98,16,84
200,18,170.0,133,4.01,30,170
2000,18,1711.0,1333,40.01,289,1711
10000,18,8745.0,6666,199.98,1255,8745
20000,18,17491.0,13333,400.01,2509,17491
40000,18,35110.0,26666,799.98,4890,35110
60000,18,52745.0,40000,1200.0,7255,52745
80000,18,70286.0,53333,1600.01,9714,70286
100000,18,87880.0,66666,1999.98,12120,87880
200000,18,176026.0,133333,4000.01,23974,176026
400000,18,354062.0,200000,6000.0,45938,354062
600000,18,534061.0,200000,6000.0,65939,534061
800000,18,714233.0,200000,6000.0,85767,714233
1000000,18,894321.0,200000,6000.0,105679,894321
2,19,2.0,1,0.05,0,2
3,19,3.0,2,0.06,0,3
100,19,90.0,66,1.98,10,90
200,19,180.0,133,4.01,20,180
2000,19,1764.0,1333,40.01,236,1764
10000,19,8813.0,6666,199.98,1187,8813
20000,19,17571.0,13333,400.01,2429,17571
40000,19,35240.0,26666,799.98,4760,35240
60000,19,52827.0,40000,1200.0,7173,52827
80000,19,70394.0,53333,1600.01,9606,70394
100000,19,87947.0,66666,1999.98,12053,87947
200000,19,175946.0,133333,4000.01,24054,175946
400000,19,354094.0,200000,6000.0,45906,354094
600000,19,534132.0,200000,6000.0,65868,534132
800000,19,714339.0,200000,6000.0,85661,714339
1000000,19,894391.0,200000,6000.0,105609,894391
2,20,2.0,1,0.05,0,2
3,20,3.0,2,0.06,0,3
100,20,85.0,66,1.98,15,85
200,20,170.0,133,4.01,30,170
2000,20,1732.0,1333,40.01,268,1732
10000,20,8781.0,6666,199.98,1219,8781
20000,20,17549.0,13333,400.01,2451,17549
40000,20,35168.0,26666,799.98,4832,35168
60000,20,52806.0,40000,1200.0,7194,52806
80000,20,70475.0,53333,1600.01,9525,70475
100000,20,88120.0,66666,1999.98,11880,88120
200000,20,176176.0,133333,4000.01,23824,176176
400000,20,354053.0,200000,6000.0,45947,354053
600000,20,534196.0,200000,6000.0,65804,534196
800000,20,714201.0,200000,6000.0,85799,714201
1000000,20,894269.0,200000,6000.0,105731,894269
2,21,2.0,1,0.05,0,2
3,21,3.0,2,0.06,0,3
100,21,89.0,66,1.98,11,89
200,21,177.0,133,4.01,23,177
2000,21,1747.0,1333,40.01,253,1747
10000,21,8792.0,6666,199.98,1208,8792
20000,21,17595.0,13333,400.01,2405,17595
40000,21,35152.0,26666,799.98,4848,35152
60000,21,52751.0,40000,1200.0,7249,52751
80000,21,70361.0,53333,1600.01,9639,70361
100000,21,87990.0,66666,1999.98,12010,87990
200000,21,175820.0,133333,4000.01,24180,175820
400000,21,353766.0,200000,6000.0,46234,353766
600000,21,533620.0,200000,6000.0,66380,533620
800000,21,713696.0,200000,6000.0,86304,713696
1000000,21,893784.0,200000,6000.0,106216,893784
2,22,2.0,1,0.05,0,2
3,22,3.0,2,0.06,0,3
100,22,90.0,66,1.98,10,90
200,22,179.0,133,4.01,21,179
2000,22,1756.0,1333,40.01,244,1756
10000,22,8788.0,6666,199.98,1212,8788
20000,22,17576.0,13333,400.01,2424,17576
40000,22,35128.0,26666,799.98,4872,35128
60000,22,52766.0,40000,1200.0,7234,52766
80000,22,70274.0,53333,1600.01,9726,70274
100000,22,87955.0,66666,1999.98,12045,87955
200000,22,175989.0,133333,4000.01,24011,175989
400000,22,354398.0,200000,6000.0,45602,354398
600000,22,534537.0,200000,6000.0,65463,534537
800000,22,714513.0,200000,6000.0,85487,714513
1000000,22,894393.0,200000,6000.0,105607,894393
2,23,2.0,1,0.05,0,2
3,23,3.0,2,0.06,0,3
100,23,87.0,66,1.98,13,87
200,23,173.0,133,4.01,27,173
2000,23,1743.0,1333,40.01,257,1743
10000,23,8791.0,6666,199.98,1209,8791
20000,23,17599.0,13333,400.01,2401,17599
40000,23,35142.0,26666,799.98,4858,35142
60000,23,52770.0,40000,1200.0,7230,52770
80000,23,70427.0,53333,1600.01,9573,70427
100000,23,87991.0,66666,1999.98,12009,87991
200000,23,175895.0,133333,4000.01,24105,175895
400000,23,353837.0,200000,6000.0,46163,353837
600000,23,534008.0,200000,6000.0,65992,534008
800000,23,713985.0,200000,6000.0,86015,713985
1000000,23,893693.0,200000,6000.0,106307,893693
2,24,2.0,1,0.05,0,2
3,24,3.0,2,0.06,0,3
100,24,93.0,66,1.98,7,93
200,24,178.0,133,4.01,22,178
2000,24,1762.0,1333,40.01,238,1762
10000,24,8856.0,6666,199.98,1144,8856
20000,24,17627.0,13333,400.01,2373,17627
40000,24,35262.0,26666,799.98,4738,35262
60000,24,52885.0,40000,1200.0,7115,52885
80000,24,70534.0,53333,1600.01,9466,70534
100000,24,88159.0,66666,1999.98,11841,88159
200000,24,176110.0,133333,4000.01,23890,176110
400000,24,354267.0,200000,6000.0,45733,354267
600000,24,534528.0,200000,6000.0,65472,534528
800000,24,714797.0,200000,6000.0,85203,714797
1000000,24,894862.0,200000,6000.0,105138,894862
2,25,1.0,1,0.05,1,1
3,25,2.0,2,0.06,1,2
100,25,78.0,66,1.98,22,78
200,25,163.0,133,4.01,37,163
2000,25,1730.0,1333,40.01,270,1730
10000,25,8786.0,6666,199.98,1214,8786
20000,25,17543.0,13333,400.01,2457,17543
40000,25,35160.0,26666,799.98,4840,35160
60000,25,52811.0,40000,1200.0,7189,52811
80000,25,70452.0,53333,1600.01,9548,70452
100000,25,88015.0,66666,1999.98,11985,88015
200000,25,176108.0,133333,4000.01,23892,176108
400000,25,353917.0,200000,6000.0,46083,353917
600000,25,533797.0,200000,6000.0,66203,533797
800000,25,713807.0,200000,6000.0,86193,713807
1000000,25,893828.0,200000,6000.0,106172,893828
2,26,2.0,1,0.05,0,2
3,26,3.0,2,0.06,0,3
100,26,88.0,66,1.98,12,88
200,26,179.0,133,4.01,21,179
2000,26,1764.0,1333,40.01,236,1764
10000,26,8816.0,6666,199.98,1184,8816
20000,26,17593.0,13333,400.01,2407,17593
40000,26,35195.0,26666,799.98,4805,35195
60000,26,52764.0,40000,1200.0,7236,52764
80000,26,70300.0,53333,1600.01,9700,70300
100000,26,87907.0,66666,1999.98,12093,87907
200000,26,176029.0,133333,4000.01,23971,176029
400000,26,354096.0,200000,6000.0,45904,354096
600000,26,534084.0,200000,6000.0,65916,534084
800000,26,713904.0,200000,6000.0,86096,713904
1000000,26,894117.0,200000,6000.0,105883,894117
2,27,2.0,1,0.05,0,2
3,27,3.0,2,0.06,0,3
100,27,85.0,66,1.98,15,85
200,27,172.0,133,4.01,28,172
2000,27,1751.0,1333,40.01,249,1751
10000,27,8783.0,6666,199.98,1217,8783
20000,27,17580.0,13333,400.01,2420,17580
40000,27,35235.0,26666,799.98,4765,35235
60000,27,52804.0,40000,1200.0,7196,52804
80000,27,70392.0,53333,1600.01,9608,70392
100000,27,88005.0,66666,1999.98,11995,88005
200000,27,176168.0,133333,4000.01,23832,176168
400000,27,354077.0,200000,6000.0,45923,354077
600000,27,534108.0,200000,6000.0,65892,534108
800000,27,714197.0,200000,6000.0,85803,714197
1000000,27,894333.0,200000,6000.0,105667,894333
2,28,2.0,1,0.05,0,2
3,28,3.0,2,0.06,0,3
100,28,91.0,66,1.98,9,91
200,28,178.0,133,4.01,22,178
2000,28,1772.0,1333,40.01,228,1772
10000,28,8816.0,6666,199.98,1184,8816
20000,28,17629.0,13333,400.01,2371,17629
40000,28,35266.0,26666,799.98,4734,35266
60000,28,52857.0,40000,1200.0,7143,52857
80000,28,70422.0,53333,1600.01,9578,70422
100000,28,88019.0,66666,1999.98,11981,88019
200000,28,175945.0,133333,4000.01,24055,175945
400000,28,354043.0,200000,6000.0,45957,354043
600000,28,534000.0,200000,6000.0,66000,534000
800000,28,714078.0,200000,6000.0,85922,714078
1000000,28,893926.0,200000,6000.0,106074,893926
2,29,2.0,1,0.05,0,2
3,29,3.0,2,0.06,0,3
100,29,94.0,66,1.98,6,94
200,29,179.0,133,4.01,21,179
2000,29,1760.0,1333,40.01,240,1760
10000,29,8818.0,6666,199.98,1182,8818
20000,29,17624.0,13333,400.01,2376,17624
40000,29,35248.0,26666,799.98,4752,35248
60000,29,52831.0,40000,1200.0,7169,52831
80000,29,70407.0,53333,1600.01,9593,70407
100000,29,88041.0,66666,1999.98,11959,88041
200000,29,176005.0,133333,4000.01,23995,176005
400000,29,353835.0,200000,6000.0,46165,353835
600000,29,533649.0,200000,6000.0,66351,533649
800000,29,713651.0,200000,6000.0,86349,713651
1000000,29,893575.0,200000,6000.0,106425,893575
2,30,1.0,1,0.05,1,1
3,30,2.0,2,0.06,1,2
100,30,86.0,66,1.98,14,86
200,30,173.0,133,4.01,27,173
2000,30,1737.0,1333,40.01,263,1737
10000,30,8747.0,6666,199.98,1253,8747
20000,30,17578.0,13333,400.01,2422,17578
40000,30,35170.0,26666,799.98,4830,35170
60000,30,52779.0,40000,1200.0,7221,52779
80000,30,70359.0,53333,1600.01,9641,70359
100000,30,87973.0,66666,1999.98,12027,87973
200000,30,176085.0,133333,4000.01,23915,176085
400000,30,354045.0,200000,6000.0,45955,354045
600000,30,534240.0,200000,6000.0,65760,534240
800000,30,714417.0,200000,6000.0,85583,714417
1000000,30,894333.0,200000,6000.0,105667,894333
2,31,2.0,1,0.05,0,2
3,31,3.0,2,0.06,0,3
100,31,89.0,66,1.98,11,89
200,31,177.0,133,4.01,23,177
2000,31,1785.0,1333,40.01,215,1785
10000,31,8853.0,6666,199.98,1147,8853
20000,31,17674.0,13333,400.01,2326,17674
40000,31,35210.0,26666,799.98,4790,35210
60000,31,52763.0,40000,1200.0,7237,52763
80000,31,70372.0,53333,1600.01,9628,70372
100000,31,88032.0,66666,1999.98,11968,88032
200000,31,176086.0,133333,4000.01,23914,176086
400000,31,354070.0,200000,6000.0,45930,354070
600000,31,534169.0,200000,6000.0,65831,534169
800000,31,714327.0,200000,6000.0,85673,714327
1000000,31,894270.0,200000,6000.0,105730,894270
2,32,2.0,1,0.05,0,2
3,32,3.0,2,0.06,0,3
100,32,90.0,66,1.98,10,90
200,32,174.0,133,4.01,26,174
2000,32,1750.0,1333,40.01,250,1750
10000,32,8768.0,6666,199.98,1232,8768
20000,32,17512.0,13333,400.01,2488,17512
40000,32,35170.0,26666,799.98,4830,35170
60000,32,52768.0,40000,1200.0,7232,52768
80000,32,70386.0,53333,1600.01,9614,70386
100000,32,87990.0,66666,1999.98,12010,87990
200000,32,175969.0,133333,4000.01,24031,175969
400000,32,354018.0,200000,6000.0,45982,354018
600000,32,533970.0,200000,6000.0,66030,533970
800000,32,714175.0,200000,6000.0,85825,714175
1000000,32,894277.0,200000,6000.0,105723,894277
2,33,2.0,1,0.05,0,2
3,33,3.0,2,0.06,0,3
100,33,89.0,66,1.98,11,89
200,33,174.0,133,4.01,26,174
2000,33,1761.0,1333,40.01,239,1761
10000,33,8810.0,6666,199.98,1190,8810
20000,33,17582.0,13333,400.01,2418,17582
40000,33,35209.0,26666,799.98,4791,35209
60000,33,52738.0,40000,1200.0,7262,52738
80000,33,70323.0,53333,1600.01,9677,70323
100000,33,87954.0,66666,1999.98,12046,87954
200000,33,176071.0,133333,4000.01,23929,176071
400000,33,353990.0,200000,6000.0,46010,353990
600000,33,533646.0,200000,6000.0,66354,533646
800000,33,713630.0,200000,6000.0,86370,713630
1000000,33,893627.0,200000,6000.0,106373,893627
2,34,1.0,1,0.05,1,1
3,34,2.0,2,0.06,1,2
100,34,89.0,66,1.98,11,89
200,34,178.0,133,4.01,22,178
2000,34,1789.0,1333,40.01,211,1789
10000,34,8827.0,6666,199.98,1173,8827
20000,34,17705.0,13333,400.01,2295,17705
40000,34,35294.0,26666,799.98,4706,35294
60000,34,52843.0,40000,1200.0,7157,52843
80000,34,70394.0,53333,1600.01,9606,70394
100000,34,88068.0,66666,1999.98,11932,88068
200000,34,176267.0,133333,4000.01,23733,176267
400000,34,354196.0,200000,6000.0,45804,354196
600000,34,534425.0,200000,6000.0,65575,534425
800000,34,714500.0,200000,6000.0,85500,714500
1000000,34,894291.0,200000,6000.0,105709,894291
2,35,2.0,1,0.05,0,2
3,35,2.0,2,0.06,1,2
100,35,86.0,66,1.98,14,86
200,35,173.0,133,4.01,27,173
2000,35,1772.0,1333,40.01,228,1772
10000,35,8831.0,6666,199.98,1169,8831
20000,35,17669.0,13333,400.01,2331,17669
40000,35,35264.0,26666,799.98,4736,35264
60000,35,52861.0,40000,1200.0,7139,52861
80000,35,70426.0,53333,1600.01,9574,70426
100000,35,87991.0,66666,1999.98,12009,87991
200000,35,176113.0,133333,4000.01,23887,176113
400000,35,354095.0,200000,6000.0,45905,354095
600000,35,533872.0,200000,6000.0,66128,533872
800000,35,713999.0,200000,6000.0,86001,713999
1000000,35,893872.0,200000,6000.0,106128,893872
2,36,2.0,1,0.05,0,2
3,36,3.0,2,0.06,0,3
100,36,88.0,66,1.98,12,88
200,36,180.0,133,4.01,20,180
2000,36,1743.0,1333,40.01,257,1743
10000,36,8752.0,6666,199.98,1248,8752
20000,36,17597.0,13333,400.01,2403,17597
40000,36,35187.0,26666,799.98,4813,35187
60000,36,52835.0,40000,1200.0,7165,52835
80000,36,70415.0,53333,1600.01,9585,70415
100000,36,88056.0,66666,1999.98,11944,88056
200000,36,175943.0,133333,4000.01,24057,175943
400000,36,354008.0,200000,6000.0,45992,354008
600000,36,533777.0,200000,6000.0,66223,533777
800000,36,713544.0,200000,6000.0,86456,713544
1000000,36,893582.0,200000,6000.0,106418,893582
2,37,2.0,1,0.05,0,2
3,37,3.0,2,0.06,0,3
100,37,86.0,66,1.98,14,86
200,37,176.0,133,4.01,24,176
2000,37,1763.0,1333,40.01,237,1763
10000,37,8771.0,6666,199.98,1229,8771
20000,37,17575.0,13333,400.01,2425,17575
40000,37,35200.0,26666,799.98,4800,35200
60000,37,52714.0,40000,1200.0,7286,52714
80000,37,70283.0,53333,1600.01,9717,70283
100000,37,87911.0,66666,1999.98,12089,87911
200000,37,176099.0,133333,4000.01,23901,176099
400000,37,353836.0,200000,6000.0,46164,353836
600000,37,534043.0,200000,6000.0,65957,534043
800000,37,714054.0,200000,6000.0,85946,714054
1000000,37,894009.0,200000,6000.0,105991,894009
2,38,2.0,1,0.05,0,2
3,38,3.0,2,0.06,0,3
100,38,91.0,66,1.98,9,91
200,38,178.0,133,4.01,22,178
2000,38,1778.0,1333,40.01,222,1778
10000,38,8806.0,6666,199.98,1194,8806
20000,38,17681.0,13333,400.01,2319,17681
40000,38,35248.0,26666,799.98,4752,35248
60000,38,52918.0,40000,1200.0,7082,52918
80000,38,70462.0,53333,1600.01,9538,70462
100000,38,88028.0,66666,1999.98,11972,88028
200000,38,176144.0,133333,4000.01,23856,176144
400000,38,354258.0,200000,6000.0,45742,354258
600000,38,534088.0,200000,6000.0,65912,534088
800000,38,714018.0,200000,6000.0,85982,714018
1000000,38,893919.0,200000,6000.0,106081,893919
2,39,1.0,1,0.05,1,1
3,39,2.0,2,0.06,1,2
100,39,86.0,66,1.98,14,86
200,39,167.0,133,4.01,33,167
2000,39,1747.0,1333,40.01,253,1747
10000,39,8786.0,6666,199.98,1214,8786
20000,39,17523.0,13333,400.01,2477,17523
40000,39,35071.0,26666,799.98,4929,35071
60000,39,52669.0,40000,1200.0,7331,52669
80000,39,70269.0,53333,1600.01,9731,70269
100000,39,87923.0,66666,1999.98,12077,87923
200000,39,175954.0,133333,4000.01,24046,175954
400000,39,353888.0,200000,6000.0,46112,353888
600000,39,534074.0,200000,6000.0,65926,534074
800000,39,714148.0,200000,6000.0,85852,714148
1000000,39,894118.0,200000,6000.0,105882,894118
2,40,2.0,1,0.05,0,2
3,40,2.0,2,0.06,1,2
100,40,89.0,66,1.98,11,89
200,40,175.0,133,4.01,25,175
2000,40,1763.0,1333,40.01,237,1763
10000,40,8865.0,6666,199.98,1135,8865
20000,40,17666.0,13333,400.01,2334,17666
40000,40,35123.0,26666,799.98,4877,35123
60000,40,52761.0,40000,1200.0,7239,52761
80000,40,70287.0,53333,1600.01,9713,70287
100000,40,87929.0,66666,1999.98,12071,87929
200000,40,175960.0,133333,4000.01,24040,175960
400000,40,353959.0,200000,6000.0,46041,353959
600000,40,534094.0,200000,6000.0,65906,534094
800000,40,713850.0,200000,6000.0,86150,713850
1000000,40,893943.0,200000,6000.0,106057,893943
2,41,2.0,1,0.05,0,2
3,41,3.0,2,0.06,0,3
100,41,89.0,66,1.98,11,89
200,41,175.0,133,4.01,25,175
2000,41,1749.0,1333,40.01,251,1749
10000,41,8767.0,6666,199.98,1233,8767
20000,41,17615.0,13333,400.01,2385,17615
40000,41,35179.0,26666,799.98,4821,35179
60000,41,52749.0,40000,1200.0,7251,52749
80000,41,70305.0,53333,1600.01,9695,70305
100000,41,87879.0,66666,1999.98,12121,87879
200000,41,175998.0,133333,4000.01,24002,175998
400000,41,354087.0,200000,6000.0,45913,354087
600000,41,534057.0,200000,6000.0,65943,534057
800000,41,714119.0,200000,6000.0,85881,714119
1000000,41,893991.0,200000,6000.0,106009,893991
2,42,2.0,1,0.05,0,2
3,42,3.0,2,0.06,0,3
100,42,88.0,66,1.98,12,88
200,42,179.0,133,4.01,21,179
2000,42,1766.0,1333,40.01,234,1766
10000,42,8753.0,6666,199.98,1247,8753
20000,42,17564.0,13333,400.01,2436,17564
40000,42,35112.0,26666,799.98,4888,35112
60000,42,52683.0,40000,1200.0,7317,52683
80000,42,70291.0,53333,1600.01,9709,70291
100000,42,87828.0,66666,1999.98,12172,87828
200000,42,175733.0,133333,4000.01,24267,175733
400000,42,353888.0,200000,6000.0,46112,353888
600000,42,533874.0,200000,6000.0,66126,533874
800000,42,714149.0,200000,6000.0,85851,714149
1000000,42,894037.0,200000,6000.0,105963,894037
2,43,2.0,1,0.05,0,2
3,43,3.0,2,0.06,0,3
100,43,88.0,66,1.98,12,88
200,43,171.0,133,4.01,29,171
2000,43,1743.0,1333,40.01,257,1743
10000,43,8777.0,6666,199.98,1223,8777
20000,43,17499.0,13333,400.01,2501,17499
40000,43,35108.0,26666,799.98,4892,35108
60000,43,52705.0,40000,1200.0,7295,52705
80000,43,70283.0,53333,1600.01,9717,70283
100000,43,87914.0,66666,1999.98,12086,87914
200000,43,175741.0,133333,4000.01,24259,175741
400000,43,353600.0,200000,6000.0,46400,353600
600000,43,533608.0,200000,6000.0,66392,533608
800000,43,713476.0,200000,6000.0,86524,713476
1000000,43,893623.0,200000,6000.0,106377,893623
2,44,2.0,1,0.05,0,2
3,44,2.0,2,0.06,1,2
100,44,90.0,66,1.98,10,90
200,44,178.0,133,4.01,22,178
2000,44,1748.0,1333,40.01,252,1748
10000,44,8787.0,6666,199.98,1213,8787
20000,44,17552.0,13333,400.01,2448,17552
40000,44,35127.0,26666,799.98,4873,35127
60000,44,52701.0,40000,1200.0,7299,52701
80000,44,70316.0,53333,1600.01,9684,70316
100000,44,87943.0,66666,1999.98,12057,87943
200000,44,175893.0,133333,4000.01,24107,175893
400000,44,353826.0,200000,6000.0,46174,353826
600000,44,533960.0,200000,6000.0,66040,533960
800000,44,713948.0,200000,6000.0,86052,713948
1000000,44,894007.0,200000,6000.0,105993,894007
2,45,2.0,1,0.05,0,2
3,45,3.0,2,0.06,0,3
100,45,90.0,66,1.98,10,90
200,45,179.0,133,4.01,21,179
2000,45,1766.0,1333,40.01,234,1766
10000,45,8800.0,6666,199.98,1200,8800
20000,45,17601.0,13333,400.01,2399,17601
40000,45,35168.0,26666,799.98,4832,35168
60000,45,52707.0,40000,1200.0,7293,52707
80000,45,70358.0,53333,1600.01,9642,70358
100000,45,87950.0,66666,1999.98,12050,87950
200000,45,176096.0,133333,4000.01,23904,176096
400000,45,354039.0,200000,6000.0,45961,354039
600000,45,534025.0,200000,6000.0,65975,534025
800000,45,714138.0,200000,6000.0,85862,714138
1000000,45,894024.0,200000,6000.0,105976,894024
2,46,2.0,1,0.05,0,2
3,46,3.0,2,0.06,0,3
100,46,96.0,66,1.98,4,96
200,46,179.0,133,4.01,21,179
2000,46,1747.0,1333,40.01,253,1747
10000,46,8816.0,6666,199.98,1184,8816
20000,46,17581.0,13333,400.01,2419,17581
40000,46,35195.0,26666,799.98,4805,35195
60000,46,52821.0,40000,1200.0,7179,52821
80000,46,70439.0,53333,1600.01,9561,70439
100000,46,88005.0,66666,1999.98,11995,88005
200000,46,176076.0,133333,4000.01,23924,176076
400000,46,354223.0,200000,6000.0,45777,354223
600000,46,534399.0,200000,6000.0,65601,534399
800000,46,714429.0,200000,6000.0,85571,714429
1000000,46,894386.0,200000,6000.0,105614,894386
2,47,2.0,1,0.05,0,2
3,47,3.0,2,0.06,0,3
100,47,90.0,66,1.98,10,90
200,47,177.0,133,4.01,23,177
2000,47,1764.0,1333,40.01,236,1764
10000,47,8829.0,6666,199.98,1171,8829
20000,47,17642.0,13333,400.01,2358,17642
40000,47,35256.0,26666,799.98,4744,35256
60000,47,52857.0,40000,1200.0,7143,52857
80000,47,70467.0,53333,1600.01,9533,70467
100000,47,88141.0,66666,1999.98,11859,88141
200000,47,176157.0,133333,4000.01,23843,176157
400000,47,354198.0,200000,6000.0,45802,354198
600000,47,534241.0,200000,6000.0,65759,534241
800000,47,714131.0,200000,6000.0,85869,714131
1000000,47,894233.0,200000,6000.0,105767,894233
2,48,2.0,1,0.05,0,2
3,48,3.0,2,0.06,0,3
100,48,85.0,66,1.98,15,85
200,48,180.0,133,4.01,20,180
2000,48,1762.0,1333,40.01,238,1762
10000,48,8831.0,6666,199.98,1169,8831
20000,48,17639.0,13333,400.01,2361,17639
40000,48,35203.0,26666,799.98,4797,35203
60000,48,52901.0,40000,1200.0,7099,52901
80000,48,70457.0,53333,1600.01,9543,70457
100000,48,88025.0,66666,1999.98,11975,88025
200000,48,175952.0,133333,4000.01,24048,175952
400000,48,353941.0,200000,6000.0,46059,353941
600000,48,533794.0,200000,6000.0,66206,533794
800000,48,713599.0,200000,6000.0,86401,713599
1000000,48,893435.0,200000,6000.0,106565,893435
2,49,2.0,1,0.05,0,2
3,49,3.0,2,0.06,0,3
100,49,88.0,66,1.98,12,88
200,49,175.0,133,4.01,25,175
2000,49,1747.0,1333,40.01,253,1747
10000,49,8806.0,6666,199.98,1194,8806
20000,49,17570.0,13333,400.01,2430,17570
40000,49,35195.0,26666,799.98,4805,35195
60000,49,52827.0,40000,1200.0,7173,52827
80000,49,70383.0,53333,1600.01,9617,70383
100000,49,87944.0,66666,1999.98,12056,87944
200000,49,176010.0,133333,4000.01,23990,176010
400000,49,353779.0,200000,6000.0,46221,353779
600000,49,533983.0,200000,6000.0,66017,533983
800000,49,714182.0,200000,6000.0,85818,714182
1000000,49,894285.0,200000,6000.0,105715,894285
2,50,2.0,1,0.05,0,2
3,50,2.0,2,0.06,1,2
100,50,88.0,66,1.98,12,88
200,50,178.0,133,4.01,22,178
2000,50,1766.0,1333,40.01,234,1766
10000,50,8843.0,6666,199.98,1157,8843
20000,50,17625.0,13333,400.01,2375,17625
40000,50,35246.0,26666,799.98,4754,35246
60000,50,52794.0,40000,1200.0,7206,52794
80000,50,70394.0,53333,1600.01,9606,70394
100000,50,88053.0,66666,1999.98,11947,88053
200000,50,176000.0,133333,4000.01,24000,176000
400000,50,354049.0,200000,6000.0,45951,354049
600000,50,533880.0,200000,6000.0,66120,533880
800000,50,713868.0,200000,6000.0,86132,713868
1000000,50,894111.0,200000,6000.0,105889,894111
2,51,2.0,1,0.05,0,2
3,51,3.0,2,0.06,0,3
100,51,90.0,66,1.98,10,90
200,51,175.0,133,4.01,25,175
2000,51,1754.0,1333,40.01,246,1754
10000,51,8775.0,6666,199.98,1225,8775
20000,51,17563.0,13333,400.01,2437,17563
40000,51,35153.0,26666,799.98,4847,35153
60000,51,52830.0,40000,1200.0,7170,52830
80000,51,70421.0,53333,1600.01,9579,70421
100000,51,87991.0,66666,1999.98,12009,87991
200000,51,176020.0,133333,4000.01,23980,176020
400000,51,354142.0,200000,6000.0,45858,354142
600000,51,534278.0,200000,6000.0,65722,534278
800000,51,714215.0,200000,6000.0,85785,714215
1000000,51,894317.0,200000,6000.0,105683,894317
2,52,2.0,1,0.05,0,2
3,52,3.0,2,0.06,0,3
100,52,90.0,66,1.98,10,90
200,52,174.0,133,4.01,26,174
2000,52,1760.0,1333,40.01,240,1760
10000,52,8845.0,6666,199.98,1155,8845
20000,52,17662.0,13333,400.01,2338,17662
40000,52,35246.0,26666,799.98,4754,35246
60000,52,52856.0,40000,1200.0,7144,52856
80000,52,70538.0,53333,1600.01,9462,70538
100000,52,88108.0,66666,1999.98,11892,88108
200000,52,176146.0,133333,4000.01,23854,176146
400000,52,354373.0,200000,6000.0,45627,354373
600000,52,534261.0,200000,6000.0,65739,534261
800000,52,714196.0,200000,6000.0,85804,714196
1000000,52,894006.0,200000,6000.0,105994,894006
2,53,1.0,1,0.05,1,1
3,53,2.0,2,0.06,1,2
100,53,89.0,66,1.98,11,89
200,53,172.0,133,4.01,28,172
2000,53,1769.0,1333,40.01,231,1769
10000,53,8802.0,6666,199.98,1198,8802
20000,53,17634.0,13333,400.01,2366,17634
40000,53,35276.0,26666,799.98,4724,35276
60000,53,52852.0,40000,1200.0,7148,52852
80000,53,70442.0,53333,1600.01,9558,70442
100000,53,88025.0,66666,1999.98,11975,88025
200000,53,176052.0,133333,4000.01,23948,176052
400000,53,354073.0,200000,6000.0,45927,354073
600000,53,534198.0,200000,6000.0,65802,534198
800000,53,714009.0,200000,6000.0,85991,714009
1000000,53,894140.0,200000,6000.0,105860,894140
2,54,2.0,1,0.05,0,2
3,54,3.0,2,0.06,0,3
100,54,85.0,66,1.98,15,85
200,54,172.0,133,4.01,28,172
2000,54,1778.0,1333,40.01,222,1778
10000,54,8843.0,6666,199.98,1157,8843
20000,54,17648.0,13333,400.01,2352,17648
40000,54,35249.0,26666,799.98,4751,35249
60000,54,52930.0,40000,1200.0,7070,52930
80000,54,70498.0,53333,1600.01,9502,70498
100000,54,88131.0,66666,1999.98,11869,88131
200000,54,176005.0,133333,4000.01,23995,176005
400000,54,353947.0,200000,6000.0,46053,353947
600000,54,533971.0,200000,6000.0,66029,533971
800000,54,714025.0,200000,6000.0,85975,714025
1000000,54,894161.0,200000,6000.0,105839,894161
2,55,2.0,1,0.05,0,2
3,55,3.0,2,0.06,0,3
100,55,91.0,66,1.98,9,91
200,55,182.0,133,4.01,18,182
2000,55,1757.0,1333,40.01,243,1757
10000,55,8797.0,6666,199.98,1203,8797
20000,55,17639.0,13333,400.01,2361,17639
40000,55,35225.0,26666,799.98,4775,35225
60000,55,52815.0,40000,1200.0,7185,52815
80000,55,70419.0,53333,1600.01,9581,70419
100000,55,87999.0,66666,1999.98,12001,87999
200000,55,176007.0,133333,4000.01,23993,176007
400000,55,353763.0,200000,6000.0,46237,353763
600000,55,533806.0,200000,6000.0,66194,533806
800000,55,713703.0,200000,6000.0,86297,713703
1000000,55,893753.0,200000,6000.0,106247,893753
2,56,1.0,1,0.05,1,1
3,56,2.0,2,0.06,1,2
100,56,93.0,66,1.98,7,93
200,56,181.0,133,4.01,19,181
2000,56,1754.0,1333,40.01,246,1754
10000,56,8725.0,6666,199.98,1275,8725
20000,56,17516.0,13333,400.01,2484,17516
40000,56,35133.0,26666,799.98,4867,35133
60000,56,52732.0,40000,1200.0,7268,52732
80000,56,70361.0,53333,1600.01,9639,70361
100000,56,87945.0,66666,1999.98,12055,87945
200000,56,175819.0,133333,4000.01,24181,175819
400000,56,353773.0,200000,6000.0,46227,353773
600000,56,533857.0,200000,6000.0,66143,533857
800000,56,713953.0,200000,6000.0,86047,713953
1000000,56,894002.0,200000,6000.0,105998,894002
2,57,2.0,1,0.05,0,2
3,57,3.0,2,0.06,0,3
100,57,87.0,66,1.98,13,87
200,57,171.0,133,4.01,29,171
2000,57,1752.0,1333,40.01,248,1752
10000,57,8795.0,6666,199.98,1205,8795
20000,57,17600.0,13333,400.01,2400,17600
40000,57,35267.0,26666,799.98,4733,35267
60000,57,52837.0,40000,1200.0,7163,52837
80000,57,70391.0,53333,1600.01,9609,70391
100000,57,87927.0,66666,1999.98,12073,87927
200000,57,175945.0,133333,4000.01,24055,175945
400000,57,353954.0,200000,6000.0,46046,353954
600000,57,534009.0,200000,6000.0,65991,534009
800000,57,714006.0,200000,6000.0,85994,714006
1000000,57,894022.0,200000,6000.0,105978,894022
2,58,2.0,1,0.05,0,2
3,58,3.0,2,0.06,0,3
100,58,90.0,66,1.98,10,90
200,58,180.0,133,4.01,20,180
2000,58,1786.0,1333,40.01,214,1786
10000,58,8803.0,6666,199.98,1197,8803
20000,58,17585.0,13333,400.01,2415,17585
40000,58,35220.0,26666,799.98,4780,35220
60000,58,52844.0,40000,1200.0,7156,52844
80000,58,70462.0,53333,1600.01,9538,70462
100000,58,88013.0,66666,1999.98,11987,88013
200000,58,175991.0,133333,4000.01,24009,175991
400000,58,353578.0,200000,6000.0,46422,353578
600000,58,533651.0,200000,6000.0,66349,533651
800000,58,713900.0,200000,6000.0,86100,713900
1000000,58,893948.0,200000,6000.0,106052,893948
2,59,1.0,1,0.05,1,1
3,59,2.0,2,0.06,1,2
100,59,87.0,66,1.98,13,87
200,59,166.0,133,4.01,34,166
2000,59,1736.0,1333,40.01,264,1736
10000,59,8759.0,6666,199.98,1241,8759
20000,59,17532.0,13333,400.01,2468,17532
40000,59,35134.0,26666,799.98,4866,35134
60000,59,52841.0,40000,1200.0,7159,52841
80000,59,70581.0,53333,1600.01,9419,70581
100000,59,88214.0,66666,1999.98,11786,88214
200000,59,176189.0,133333,4000.01,23811,176189
400000,59,354136.0,200000,6000.0,45864,354136
600000,59,534009.0,200000,6000.0,65991,534009
800000,59,714093.0,200000,6000.0,85907,714093
1000000,59,894047.0,200000,6000.0,105953,894047
2,60,2.0,1,0.05,0,2
3,60,3.0,2,0.06,0,3
100,60,89.0,66,1.98,11,89
200,60,180.0,133,4.01,20,180
2000,60,1778.0,1333,40.01,222,1778
10000,60,8828.0,6666,199.98,1172,8828
20000,60,17641.0,13333,400.01,2359,17641
40000,60,35165.0,26666,799.98,4835,35165
60000,60,52727.0,40000,1200.0,7273,52727
80000,60,70299.0,53333,1600.01,9701,70299
100000,60,87944.0,66666,1999.98,12056,87944
200000,60,176110.0,133333,4000.01,23890,176110
400000,60,354290.0,200000,6000.0,45710,354290
600000,60,534214.0,200000,6000.0,65786,534214
800000,60,714361.0,200000,6000.0,85639,714361
1000000,60,894137.0,200000,6000.0,105863,894137
2,61,2.0,1,0.05,0,2
3,61,3.0,2,0.06,0,3
100,61,86.0,66,1.98,14,86
200,61,176.0,133,4.01,24,176
2000,61,1752.0,1333,40.01,248,1752
10000,61,8804.0,6666,199.98,1196,8804
20000,61,17586.0,13333,400.01,2414,17586
40000,61,35252.0,26666,799.98,4748,35252
60000,61,52810.0,40000,1200.0,7190,52810
80000,61,70390.0,53333,1600.01,9610,70390
100000,61,88039.0,66666,1999.98,11961,88039
200000,61,176064.0,133333,4000.01,23936,176064
400000,61,354248.0,200000,6000.0,45752,354248
600000,61,534202.0,200000,6000.0,65798,534202
800000,61,714230.0,200000,6000.0,85770,714230
1000000,61,894348.0,200000,6000.0,105652,894348
2,62,1.0,1,0.05,1,1
3,62,2.0,2,0.06,1,2
100,62,89.0,66,1.98,11,89
200,62,181.0,133,4.01,19,181
2000,62,1746.0,1333,40.01,254,1746
10000,62,8801.0,6666,199.98,1199,8801
20000,62,17563.0,13333,400.01,2437,17563
40000,62,35085.0,26666,799.98,4915,35085
60000,62,52655.0,40000,1200.0,7345,52655
80000,62,70262.0,53333,1600.01,9738,70262
100000,62,87861.0,66666,1999.98,12139,87861
200000,62,175862.0,133333,4000.01,24138,175862
400000,62,353786.0,200000,6000.0,46214,353786
600000,62,533811.0,200000,6000.0,66189,533811
800000,62,713820.0,200000,6000.0,86180,713820
1000000,62,893839.0,200000,6000.0,106161,893839
2,63,1.0,1,0.05,1,1
3,63,2.0,2,0.06,1,2
100,63,84.0,66,1.98,16,84
200,63,172.0,133,4.01,28,172
2000,63,1765.0,1333,40.01,235,1765
10000,63,8819.0,6666,199.98,1181,8819
20000,63,17597.0,13333,400.01,2403,17597
40000,63,35186.0,26666,799.98,4814,35186
60000,63,52816.0,40000,1200.0,7184,52816
80000,63,70423.0,53333,1600.01,9577,70423
100000,63,88031.0,66666,1999.98,11969,88031
200000,63,175947.0,133333,4000.01,24053,175947
400000,63,353918.0,200000,6000.0,46082,353918
600000,63,533733.0,200000,6000.0,66267,533733
800000,63,713787.0,200000,6000.0,86213,713787
1000000,63,893955.0,200000,6000.0,106045,893955
2,64,0.0,1,0.05,2,0
3,64,1.0,2,0.06,2,1
100,64,87.0,66,1.98,13,87
200,64,175.0,133,4.01,25,175
2000,64,1746.0,1333,40.01,254,1746
10000,64,8791.0,6666,199.98,1209,8791
20000,64,17602.0,13333,400.01,2398,17602
40000,64,35254.0,26666,799.98,4746,35254
60000,64,52825.0,40000,1200.0,7175,52825
80000,64,70317.0,53333,1600.01,9683,70317
100000,64,87919.0,66666,1999.98,12081,87919
200000,64,175904.0,133333,4000.01,24096,175904
400000,64,353734.0,200000,6000.0,46266,353734
600000,64,533747.0,200000,6000.0,66253,533747
800000,64,713788.0,200000,6000.0,86212,713788
1000000,64,893973.0,200000,6000.0,106027,893973
2,65,2.0,1,0.05,0,2
3,65,3.0,2,0.06,0,3
100,65,91.0,66,1.98,9,91
200,65,179.0,133,4.01,21,179
2000,65,1735.0,1333,40.01,265,1735
10000,65,8736.0,6666,199.98,1264,8736
20000,65,17549.0,13333,400.01,2451,17549
40000,65,35145.0,26666,799.98,4855,35145
60000,65,52738.0,40000,1200.0,7262,52738
80000,65,70398.0,53333,1600.01,9602,70398
100000,65,88015.0,66666,1999.98,11985,88015
200000,65,176032.0,133333,4000.01,23968,176032
400000,65,353901.0,200000,6000.0,46099,353901
600000,65,533778.0,200000,6000.0,66222,533778
800000,65,713599.0,200000,6000.0,86401,713599
1000000,65,893557.0,200000,6000.0,106443,893557
2,66,2.0,1,0.05,0,2
3,66,3.0,2,0.06,0,3
100,66,85.0,66,1.98,15,85
200,66,176.0,133,4.01,24,176
2000,66,1749.0,1333,40.01,251,1749
10000,66,8758.0,6666,199.98,1242,8758
20000,66,17512.0,13333,400.01,2488,17512
40000,66,35089.0,26666,799.98,4911,35089
60000,66,52645.0,40000,1200.0,7355,52645
80000,66,70270.0,53333,1600.01,9730,70270
100000,66,87847.0,66666,1999.98,12153,87847
200000,66,175880.0,133333,4000.01,24120,175880
400000,66,353973.0,200000,6000.0,46027,353973
600000,66,533881.0,200000,6000.0,66119,533881
800000,66,713973.0,200000,6000.0,86027,713973
1000000,66,893910.0,200000,6000.0,106090,893910
2,67,1.0,1,0.05,1,1
3,67,2.0,2,0.06,1,2
100,67,80.0,66,1.98,20,80
200,67,163.0,133,4.01,37,163
2000,67,1750.0,1333,40.01,250,1750
10000,67,8801.0,6666,199.98,1199,8801
20000,67,17562.0,13333,400.01,2438,17562
40000,67,35126.0,26666,799.98,4874,35126
60000,67,52720.0,40000,1200.0,7280,52720
80000,67,70302.0,53333,1600.01,9698,70302
100000,67,87938.0,66666,1999.98,12062,87938
200000,67,176013.0,133333,4000.01,23987,176013
400000,67,354175.0,200000,6000.0,45825,354175
600000,67,534160.0,200000,6000.0,65840,534160
800000,67,713989.0,200000,6000.0,86011,713989
1000000,67,893859.0,200000,6000.0,106141,893859
2,68,2.0,1,0.05,0,2
3,68,3.0,2,0.06,0,3
100,68,93.0,66,1.98,7,93
200,68,183.0,133,4.01,17,183
2000,68,1773.0,1333,40.01,227,1773
10000,68,8786.0,6666,199.98,1214,8786
20000,68,17583.0,13333,400.01,2417,17583
40000,68,35214.0,26666,799.98,4786,35214
60000,68,52805.0,40000,1200.0,7195,52805
80000,68,70338.0,53333,1600.01,9662,70338
100000,68,88000.0,66666,1999.98,12000,88000
200000,68,176137.0,133333,4000.01,23863,176137
400000,68,354208.0,200000,6000.0,45792,354208
600000,68,533878.0,200000,6000.0,66122,533878
800000,68,713954.0,200000,6000.0,86046,713954
1000000,68,893746.0,200000,6000.0,106254,893746
2,69,2.0,1,0.05,0,2
3,69,3.0,2,0.06,0,3
100,69,91.0,66,1.98,9,91
200,69,185.0,133,4.01,15,185
2000,69,1770.0,1333,40.01,230,1770
10000,69,8802.0,6666,199.98,1198,8802
20000,69,17556.0,13333,400.01,2444,17556
40000,69,35189.0,26666,799.98,4811,35189
60000,69,52786.0,40000,1200.0,7214,52786
80000,69,70402.0,53333,1600.01,9598,70402
100000,69,88054.0,66666,1999.98,11946,88054
200000,69,175964.0,133333,4000.01,24036,175964
400000,69,354012.0,200000,6000.0,45988,354012
600000,69,534120.0,200000,6000.0,65880,534120
800000,69,714064.0,200000,6000.0,85936,714064
1000000,69,894238.0,200000,6000.0,105762,894238
2,70,2.0,1,0.05,0,2
3,70,2.0,2,0.06,1,2
100,70,88.0,66,1.98,12,88
200,70,182.0,133,4.01,18,182
2000,70,1758.0,1333,40.01,242,1758
10000,70,8791.0,6666,199.98,1209,8791
20000,70,17566.0,13333,400.01,2434,17566
40000,70,35207.0,26666,799.98,4793,35207
60000,70,52771.0,40000,1200.0,7229,52771
80000,70,70418.0,53333,1600.01,9582,70418
100000,70,88050.0,66666,1999.98,11950,88050
200000,70,175933.0,133333,4000.01,24067,175933
400000,70,353895.0,200000,6000.0,46105,353895
600000,70,533805.0,200000,6000.0,66195,533805
800000,70,713940.0,200000,6000.0,86060,713940
1000000,70,893806.0,200000,6000.0,106194,893806
2,71,1.0,1,0.05,1,1
3,71,2.0,2,0.06,1,2
100,71,89.0,66,1.98,11,89
200,71,177.0,133,4.01,23,177
2000,71,1761.0,1333,40.01,239,1761
10000,71,8833.0,6666,199.98,1167,8833
20000,71,17613.0,13333,400.01,2387,17613
40000,71,35178.0,26666,799.98,4822,35178
60000,71,52808.0,40000,1200.0,7192,52808
80000,71,70433.0,53333,1600.01,9567,70433
100000,71,88035.0,66666,1999.98,11965,88035
200000,71,175931.0,133333,4000.01,24069,175931
400000,71,353982.0,200000,6000.0,46018,353982
600000,71,534267.0,200000,6000.0,65733,534267
800000,71,714231.0,200000,6000.0,85769,714231
1000000,71,894189.0,200000,6000.0,105811,894189
2,72,2.0,1,0.05,0,2
3,72,3.0,2,0.06,0,3
100,72,92.0,66,1.98,8,92
200,72,184.0,133,4.01,16,184
2000,72,1749.0,1333,40.01,251,1749
10000,72,8798.0,6666,199.98,1202,8798
20000,72,17631.0,13333,400.01,2369,17631
40000,72,35264.0,26666,799.98,4736,35264
60000,72,52841.0,40000,1200.0,7159,52841
80000,72,70422.0,53333,1600.01,9578,70422
100000,72,88051.0,66666,1999.98,11949,88051
200000,72,175973.0,133333,4000.01,24027,175973
400000,72,354115.0,200000,6000.0,45885,354115
600000,72,534326.0,200000,6000.0,65674,534326
800000,72,714544.0,200000,6000.0,85456,714544
1000000,72,894605.0,200000,6000.0,105395,894605
2,73,2.0,1,0.05,0,2
3,73,2.0,2,0.06,1,2
100,73,92.0,66,1.98,8,92
200,73,179.0,133,4.01,21,179
2000,73,1770.0,1333,40.01,230,1770
10000,73,8816.0,6666,199.98,1184,8816
20000,73,17650.0,13333,400.01,2350,17650
40000,73,35259.0,26666,799.98,4741,35259
60000,73,52871.0,40000,1200.0,7129,52871
80000,73,70390.0,53333,1600.01,9610,70390
100000,73,87947.0,66666,1999.98,12053,87947
200000,73,175839.0,133333,4000.01,24161,175839
400000,73,353812.0,200000,6000.0,46188,353812
600000,73,533618.0,200000,6000.0,66382,533618
800000,73,713374.0,200000,6000.0,86626,713374
1000000,73,893360.0,200000,6000.0,106640,893360
2,74,2.0,1,0.05,0,2
3,74,3.0,2,0.06,0,3
100,74,88.0,66,1.98,12,88
200,74,171.0,133,4.01,29,171
2000,74,1739.0,1333,40.01,261,1739
10000,74,8707.0,6666,199.98,1293,8707
20000,74,17560.0,13333,400.01,2440,17560
40000,74,35235.0,26666,799.98,4765,35235
60000,74,52821.0,40000,1200.0,7179,52821
80000,74,70418.0,53333,1600.01,9582,70418
100000,74,87991.0,66666,1999.98,12009,87991
200000,74,176042.0,133333,4000.01,23958,176042
400000,74,354211.0,200000,6000.0,45789,354211
600000,74,534246.0,200000,6000.0,65754,534246
800000,74,714250.0,200000,6000.0,85750,714250
1000000,74,894464.0,200000,6000.0,105536,894464
2,75,2.0,1,0.05,0,2
3,75,3.0,2,0.06,0,3
100,75,91.0,66,1.98,9,91
200,75,179.0,133,4.01,21,179
2000,75,1750.0,1333,40.01,250,1750
10000,75,8741.0,6666,199.98,1259,8741
20000,75,17560.0,13333,400.01,2440,17560
40000,75,35159.0,26666,799.98,4841,35159
60000,75,52846.0,40000,1200.0,7154,52846
80000,75,70482.0,53333,1600.01,9518,70482
100000,75,88088.0,66666,1999.98,11912,88088
200000,75,176141.0,133333,4000.01,23859,176141
400000,75,354467.0,200000,6000.0,45533,354467
600000,75,534389.0,200000,6000.0,65611,534389
800000,75,714429.0,200000,6000.0,85571,714429
1000000,75,894449.0,200000,6000.0,105551,894449
2,76,2.0,1,0.05,0,2
3,76,3.0,2,0.06,0,3
100,76,83.0,66,1.98,17,83
200,76,172.0,133,4.01,28,172
2000,76,1768.0,1333,40.01,232,1768
10000,76,8808.0,6666,199.98,1192,8808
20000,76,17635.0,13333,400.01,2365,17635
40000,76,35270.0,26666,799.98,4730,35270
60000,76,52883.0,40000,1200.0,7117,52883
80000,76,70476.0,53333,1600.01,9524,70476
100000,76,88037.0,66666,1999.98,11963,88037
200000,76,175984.0,133333,4000.01,24016,175984
400000,76,353924.0,200000,6000.0,46076,353924
600000,76,533972.0,200000,6000.0,66028,533972
800000,76,714003.0,200000,6000.0,85997,714003
1000000,76,894029.0,200000,6000.0,105971,894029
2,77,1.0,1,0.05,1,1
3,77,2.0,2,0.06,1,2
100,77,91.0,66,1.98,9,91
200,77,172.0,133,4.01,28,172
2000,77,1761.0,1333,40.01,239,1761
10000,77,8799.0,6666,199.98,1201,8799
20000,77,17557.0,13333,400.01,2443,17557
40000,77,35118.0,26666,799.98,4882,35118
60000,77,52723.0,40000,1200.0,7277,52723
80000,77,70359.0,53333,1600.01,9641,70359
100000,77,87972.0,66666,1999.98,12028,87972
200000,77,175936.0,133333,4000.01,24064,175936
400000,77,353842.0,200000,6000.0,46158,353842
600000,77,534047.0,200000,6000.0,65953,534047
800000,77,714218.0,200000,6000.0,85782,714218
1000000,77,894239.0,200000,6000.0,105761,894239
2,78,1.0,1,0.05,1,1
3,78,2.0,2,0.06,1,2
100,78,87.0,66,1.98,13,87
200,78,177.0,133,4.01,23,177
2000,78,1774.0,1333,40.01,226,1774
10000,78,8794.0,6666,199.98,1206,8794
20000,78,17616.0,13333,400.01,2384,17616
40000,78,35256.0,26666,799.98,4744,35256
60000,78,52840.0,40000,1200.0,7160,52840
80000,78,70452.0,53333,1600.01,9548,70452
100000,78,88040.0,66666,1999.98,11960,88040
200000,78,176075.0,133333,4000.01,23925,176075
400000,78,353885.0,200000,6000.0,46115,353885
600000,78,533721.0,200000,6000.0,66279,533721
800000,78,713796.0,200000,6000.0,86204,713796
1000000,78,893768.0,200000,6000.0,106232,893768
2,79,2.0,1,0.05,0,2
3,79,3.0,2,0.06,0,3
100,79,85.0,66,1.98,15,85
200,79,172.0,133,4.01,28,172
2000,79,1759.0,1333,40.01,241,1759
10000,79,8833.0,6666,199.98,1167,8833
20000,79,17653.0,13333,400.01,2347,17653
40000,79,35193.0,26666,799.98,4807,35193
60000,79,52828.0,40000,1200.0,7172,52828
80000,79,70394.0,53333,1600.01,9606,70394
100000,79,88007.0,66666,1999.98,11993,88007
200000,79,175816.0,133333,4000.01,24184,175816
400000,79,353735.0,200000,6000.0,46265,353735
600000,79,533676.0,200000,6000.0,66324,533676
800000,79,713612.0,200000,6000.0,86388,713612
1000000,79,893783.0,200000,6000.0,106217,893783
2,80,2.0,1,0.05,0,2
3,80,3.0,2,0.06,0,3
100,80,83.0,66,1.98,17,83
200,80,170.0,133,4.01,30,170
2000,80,1766.0,1333,40.01,234,1766
10000,80,8789.0,6666,199.98,1211,8789
20000,80,17608.0,13333,400.01,2392,17608
40000,80,35304.0,26666,799.98,4696,35304
60000,80,52913.0,40000,1200.0,7087,52913
80000,80,70471.0,53333,1600.01,9529,70471
100000,80,88062.0,66666,1999.98,11938,88062
200000,80,176030.0,133333,4000.01,23970,176030
400000,80,354172.0,200000,6000.0,45828,354172
600000,80,534094.0,200000,6000.0,65906,534094
800000,80,714078.0,200000,6000.0,85922,714078
1000000,80,894091.0,200000,6000.0,105909,894091
2,81,2.0,1,0.05,0,2
3,81,3.0,2,0.06,0,3
100,81,87.0,66,1.98,13,87
200,81,179.0,133,4.01,21,179
2000,81,1750.0,1333,40.01,250,1750
10000,81,8800.0,6666,199.98,1200,8800
20000,81,17590.0,13333,400.01,2410,17590
40000,81,35223.0,26666,799.98,4777,35223
60000,81,52809.0,40000,1200.0,7191,52809
80000,81,70291.0,53333,1600.01,9709,70291
100000,81,87979.0,66666,1999.98,12021,87979
200000,81,176184.0,133333,4000.01,23816,176184
400000,81,354095.0,200000,6000.0,45905,354095
600000,81,534279.0,200000,6000.0,65721,534279
800000,81,714363.0,200000,6000.0,85637,714363
1000000,81,894379.0,200000,6000.0,105621,894379
2,82,2.0,1,0.05,0,2
3,82,3.0,2,0.06,0,3
100,82,88.0,66,1.98,12,88
200,82,174.0,133,4.01,26,174
2000,82,1771.0,1333,40.01,229,1771
10000,82,8823.0,6666,199.98,1177,8823
20000,82,17658.0,13333,400.01,2342,17658
40000,82,35201.0,26666,799.98,4799,35201
60000,82,52807.0,40000,1200.0,7193,52807
80000,82,70367.0,53333,1600.01,9633,70367
100000,82,87981.0,66666,1999.98,12019,87981
200000,82,175915.0,133333,4000.01,24085,175915
400000,82,353841.0,200000,6000.0,46159,353841
600000,82,533887.0,200000,6000.0,66113,533887
800000,82,714039.0,200000,6000.0,85961,714039
1000000,82,893870.0,200000,6000.0,106130,893870
2,83,2.0,1,0.05,0,2
3,83,2.0,2,0.06,1,2
100,83,88.0,66,1.98,12,88
200,83,179.0,133,4.01,21,179
2000,83,1757.0,1333,40.01,243,1757
10000,83,8805.0,6666,199.98,1195,8805
20000,83,17598.0,13333,400.01,2402,17598
40000,83,35198.0,26666,799.98,4802,35198
60000,83,52787.0,40000,1200.0,7213,52787
80000,83,70398.0,53333,1600.01,9602,70398
100000,83,88002.0,66666,1999.98,11998,88002
200000,83,176049.0,133333,4000.01,23951,176049
400000,83,354172.0,200000,6000.0,45828,354172
600000,83,534065.0,200000,6000.0,65935,534065
800000,83,714223.0,200000,6000.0,85777,714223
1000000,83,894351.0,200000,6000.0,105649,894351
2,84,2.0,1,0.05,0,2
3,84,3.0,2,0.06,0,3
100,84,93.0,66,1.98,7,93
200,84,179.0,133,4.01,21,179
2000,84,1751.0,1333,40.01,249,1751
10000,84,8805.0,6666,199.98,1195,8805
20000,84,17620.0,13333,400.01,2380,17620
40000,84,35211.0,26666,799.98,4789,35211
60000,84,52816.0,40000,1200.0,7184,52816
80000,84,70431.0,53333,1600.01,9569,70431
100000,84,88016.0,66666,1999.98,11984,88016
200000,84,176010.0,133333,4000.01,23990,176010
400000,84,354033.0,200000,6000.0,45967,354033
600000,84,534225.0,200000,6000.0,65775,534225
800000,84,714293.0,200000,6000.0,85707,714293
1000000,84,894576.0,200000,6000.0,105424,894576
2,85,2.0,1,0.05,0,2
3,85,3.0,2,0.06,0,3
100,85,88.0,66,1.98,12,88
200,85,176.0,133,4.01,24,176
2000,85,1740.0,1333,40.01,260,1740
10000,85,8806.0,6666,199.98,1194,8806
20000,85,17640.0,13333,400.01,2360,17640
40000,85,35301.0,26666,799.98,4699,35301
60000,85,52868.0,40000,1200.0,7132,52868
80000,85,70483.0,53333,1600.01,9517,70483
100000,85,88136.0,66666,1999.98,11864,88136
200000,85,176264.0,133333,4000.01,23736,176264
400000,85,354113.0,200000,6000.0,45887,354113
600000,85,533968.0,200000,6000.0,66032,533968
800000,85,713939.0,200000,6000.0,86061,713939
1000000,85,894121.0,200000,6000.0,105879,894121
2,86,2.0,1,0.05,0,2
3,86,2.0,2,0.06,1,2
100,86,90.0,66,1.98,10,90
200,86,174.0,133,4.01,26,174
2000,86,1760.0,1333,40.01,240,1760
10000,86,8794.0,6666,199.98,1206,8794
20000,86,17555.0,13333,400.01,2445,17555
40000,86,35123.0,26666,799.98,4877,35123
60000,86,52684.0,40000,1200.0,7316,52684
80000,86,70250.0,53333,1600.01,9750,70250
100000,86,87788.0,66666,1999.98,12212,87788
200000,86,175645.0,133333,4000.01,24355,175645
400000,86,353718.0,200000,6000.0,46282,353718
600000,86,533689.0,200000,6000.0,66311,533689
800000,86,713734.0,200000,6000.0,86266,713734
1000000,86,893563.0,200000,6000.0,106437,893563
2,87,2.0,1,0.05,0,2
3,87,3.0,2,0.06,0,3
100,87,88.0,66,1.98,12,88
200,87,178.0,133,4.01,22,178
2000,87,1736.0,1333,40.01,264,1736
10000,87,8701.0,6666,199.98,1299,8701
20000,87,17484.0,13333,400.01,2516,17484
40000,87,35125.0,26666,799.98,4875,35125
60000,87,52651.0,40000,1200.0,7349,52651
80000,87,70252.0,53333,1600.01,9748,70252
100000,87,87840.0,66666,1999.98,12160,87840
200000,87,175794.0,133333,4000.01,24206,175794
400000,87,353730.0,200000,6000.0,46270,353730
600000,87,533713.0,200000,6000.0,66287,533713
800000,87,713806.0,200000,6000.0,86194,713806
1000000,87,893937.0,200000,6000.0,106063,893937
2,88,1.0,1,0.05,1,1
3,88,2.0,2,0.06,1,2
100,88,85.0,66,1.98,15,85
200,88,171.0,133,4.01,29,171
2000,88,1748.0,1333,40.01,252,1748
10000,88,8845.0,6666,199.98,1155,8845
20000,88,17665.0,13333,400.01,2335,17665
40000,88,35251.0,26666,799.98,4749,35251
60000,88,52954.0,40000,1200.0,7046,52954
80000,88,70571.0,53333,1600.01,9429,70571
100000,88,88214.0,66666,1999.98,11786,88214
200000,88,176240.0,133333,4000.01,23760,176240
400000,88,354361.0,200000,6000.0,45639,354361
600000,88,534227.0,200000,6000.0,65773,534227
800000,88,714335.0,200000,6000.0,85665,714335
1000000,88,894462.0,200000,6000.0,105538,894462
2,89,2.0,1,0.05,0,2
3,89,3.0,2,0.06,0,3
100,89,87.0,66,1.98,13,87
200,89,170.0,133,4.01,30,170
2000,89,1754.0,1333,40.01,246,1754
10000,89,8792.0,6666,199.98,1208,8792
20000,89,17624.0,13333,400.01,2376,17624
40000,89,35220.0,26666,799.98,4780,35220
60000,89,52808.0,40000,1200.0,7192,52808
80000,89,70413.0,53333,1600.01,9587,70413
100000,89,88045.0,66666,1999.98,11955,88045
200000,89,176076.0,133333,4000.01,23924,176076
400000,89,354095.0,200000,6000.0,45905,354095
600000,89,534188.0,200000,6000.0,65812,534188
800000,89,714280.0,200000,6000.0,85720,714280
1000000,89,894299.0,200000,6000.0,105701,894299
2,90,2.0,1,0.05,0,2
3,90,3.0,2,0.06,0,3
100,90,85.0,66,1.98,15,85
200,90,172.0,133,4.01,28,172
2000,90,1754.0,1333,40.01,246,1754
10000,90,8782.0,6666,199.98,1218,8782
20000,90,17594.0,13333,400.01,2406,17594
40000,90,35283.0,26666,799.98,4717,35283
60000,90,52869.0,40000,1200.0,7131,52869
80000,90,70503.0,53333,1600.01,9497,70503
100000,90,88119.0,66666,1999.98,11881,88119
200000,90,176221.0,133333,4000.01,23779,176221
400000,90,354296.0,200000,6000.0,45704,354296
600000,90,534291.0,200000,6000.0,65709,534291
800000,90,714503.0,200000,6000.0,85497,714503
1000000,90,894384.0,200000,6000.0,105616,894384
2,91,2.0,1,0.05,0,2
3,91,3.0,2,0.06,0,3
100,91,90.0,66,1.98,10,90
200,91,173.0,133,4.01,27,173
2000,91,1779.0,1333,40.01,221,1779
10000,91,8824.0,6666,199.98,1176,8824
20000,91,17659.0,13333,400.01,2341,17659
40000,91,35209.0,26666,799.98,4791,35209
60000,91,52778.0,40000,1200.0,7222,52778
80000,91,70490.0,53333,1600.01,9510,70490
100000,91,88096.0,66666,1999.98,11904,88096
200000,91,176106.0,133333,4000.01,23894,176106
400000,91,353991.0,200000,6000.0,46009,353991
600000,91,533850.0,200000,6000.0,66150,533850
800000,91,713673.0,200000,6000.0,86327,713673
1000000,91,893616.0,200000,6000.0,106384,893616
2,92,1.0,1,0.05,1,1
3,92,2.0,2,0.06,1,2
100,92,83.0,66,1.98,17,83
200,92,173.0,133,4.01,27,173
2000,92,1769.0,1333,40.01,231,1769
10000,92,8772.0,6666,199.98,1228,8772
20000,92,17553.0,13333,400.01,2447,17553
40000,92,35113.0,26666,799.98,4887,35113
60000,92,52740.0,40000,1200.0,7260,52740
80000,92,70445.0,53333,1600.01,9555,70445
100000,92,88031.0,66666,1999.98,11969,88031
200000,92,176131.0,133333,4000.01,23869,176131
400000,92,354217.0,200000,6000.0,45783,354217
600000,92,534193.0,200000,6000.0,65807,534193
800000,92,714211.0,200000,6000.0,85789,714211
1000000,92,894447.0,200000,6000.0,105553,894447
2,93,2.0,1,0.05,0,2
3,93,2.0,2,0.06,1,2
100,93,86.0,66,1.98,14,86
200,93,173.0,133,4.01,27,173
2000,93,1774.0,1333,40.01,226,1774
10000,93,8823.0,6666,199.98,1177,8823
20000,93,17643.0,13333,400.01,2357,17643
40000,93,35233.0,26666,799.98,4767,35233
60000,93,52804.0,40000,1200.0,7196,52804
80000,93,70343.0,53333,1600.01,9657,70343
100000,93,87897.0,66666,1999.98,12103,87897
200000,93,175854.0,133333,4000.01,24146,175854
400000,93,353734.0,200000,6000.0,46266,353734
600000,93,533840.0,200000,6000.0,66160,533840
800000,93,713921.0,200000,6000.0,86079,713921
1000000,93,893868.0,200000,6000.0,106132,893868
2,94,2.0,1,0.05,0,2
3,94,3.0,2,0.06,0,3
100,94,84.0,66,1.98,16,84
200,94,171.0,133,4.01,29,171
2000,94,1773.0,1333,40.01,227,1773
10000,94,8805.0,6666,199.98,1195,8805
20000,94,17651.0,13333,400.01,2349,17651
40000,94,35315.0,26666,799.98,4685,35315
60000,94,52921.0,40000,1200.0,7079,52921
80000,94,70468.0,53333,1600.01,9532,70468
100000,94,87995.0,66666,1999.98,12005,87995
200000,94,176063.0,133333,4000.01,23937,176063
400000,94,354232.0,200000,6000.0,45768,354232
600000,94,534238.0,200000,6000.0,65762,534238
800000,94,714337.0,200000,6000.0,85663,714337
1000000,94,894173.0,200000,6000.0,105827,894173
2,95,2.0,1,0.05,0,2
3,95,3.0,2,0.06,0,3
100,95,89.0,66,1.98,11,89
200,95,178.0,133,4.01,22,178
2000,95,1760.0,1333,40.01,240,1760
10000,95,8763.0,6666,199.98,1237,8763
20000,95,17548.0,13333,400.01,2452,17548
40000,95,35147.0,26666,799.98,4853,35147
60000,95,52675.0,40000,1200.0,7325,52675
80000,95,70252.0,53333,1600.01,9748,70252
100000,95,87838.0,66666,1999.98,12162,87838
200000,95,175727.0,133333,4000.01,24273,175727
400000,95,353706.0,200000,6000.0,46294,353706
600000,95,533791.0,200000,6000.0,66209,533791
800000,95,713860.0,200000,6000.0,86140,713860
1000000,95,893905.0,200000,6000.0,106095,893905
2,96,2.0,1,0.05,0,2
3,96,3.0,2,0.06,0,3
100,96,94.0,66,1.98,6,94
200,96,180.0,133,4.01,20,180
2000,96,1764.0,1333,40.01,236,1764
10000,96,8809.0,6666,199.98,1191,8809
20000,96,17619.0,13333,400.01,2381,17619
40000,96,35154.0,26666,799.98,4846,35154
60000,96,52725.0,40000,1200.0,7275,52725
80000,96,70215.0,53333,1600.01,9785,70215
100000,96,87814.0,66666,1999.98,12186,87814
200000,96,175824.0,133333,4000.01,24176,175824
400000,96,353815.0,200000,6000.0,46185,353815
600000,96,533597.0,200000,6000.0,66403,533597
800000,96,713329.0,200000,6000.0,86671,713329
1000000,96,893183.0,200000,6000.0,106817,893183
2,97,2.0,1,0.05,0,2
3,97,3.0,2,0.06,0,3
100,97,88.0,66,1.98,12,88
200,97,169.0,133,4.01,31,169
2000,97,1755.0,1333,40.01,245,1755
10000,97,8772.0,6666,199.98,1228,8772
20000,97,17550.0,13333,400.01,2450,17550
40000,97,35151.0,26666,799.98,4849,35151
60000,97,52708.0,40000,1200.0,7292,52708
80000,97,70347.0,53333,1600.01,9653,70347
100000,97,87928.0,66666,1999.98,12072,87928
200000,97,175913.0,133333,4000.01,24087,175913
400000,97,354133.0,200000,6000.0,45867,354133
600000,97,534039.0,200000,6000.0,65961,534039
800000,97,714265.0,200000,6000.0,85735,714265
1000000,97,894207.0,200000,6000.0,105793,894207
2,98,2.0,1,0.05,0,2
3,98,3.0,2,0.06,0,3
100,98,89.0,66,1.98,11,89
200,98,172.0,133,4.01,28,172
2000,98,1742.0,1333,40.01,258,1742
10000,98,8782.0,6666,199.98,1218,8782
20000,98,17640.0,13333,400.01,2360,17640
40000,98,35267.0,26666,799.98,4733,35267
60000,98,52871.0,40000,1200.0,7129,52871
80000,98,70507.0,53333,1600.01,9493,70507
100000,98,88107.0,66666,1999.98,11893,88107
200000,98,176335.0,133333,4000.01,23665,176335
400000,98,354255.0,200000,6000.0,45745,354255
600000,98,534195.0,200000,6000.0,65805,534195
800000,98,714358.0,200000,6000.0,85642,714358
1000000,98,894277.0,200000,6000.0,105723,894277
2,99,2.0,1,0.05,0,2
3,99,3.0,2,0.06,0,3
100,99,86.0,66,1.98,14,86
200,99,177.0,133,4.01,23,177
2000,99,1749.0,1333,40.01,251,1749
10000,99,8767.0,6666,199.98,1233,8767
20000,99,17573.0,13333,400.01,2427,17573
40000,99,35241.0,26666,799.98,4759,35241
60000,99,52883.0,40000,1200.0,7117,52883
80000,99,70494.0,53333,1600.01,9506,70494
100000,99,88103.0,66666,1999.98,11897,88103
200000,99,176027.0,133333,4000.01,23973,176027
400000,99,353961.0,200000,6000.0,46039,353961
600000,99,533813.0,200000,6000.0,66187,533813
800000,99,713897.0,200000,6000.0,86103,713897
1000000,99,893986.0,200000,6000.0,106014,893986
2,100,2.0,1,0.05,0,2
3,100,3.0,2,0.06,0,3
100,100,93.0,66,1.98,7,93
200,100,178.0,133,4.01,22,178
2000,100,1769.0,1333,40.01,231,1769
10000,100,8817.0,6666,199.98,1183,8817
20000,100,17597.0,13333,400.01,2403,17597
40000,100,35155.0,26666,799.98,4845,35155
60000,100,52831.0,40000,1200.0,7169,52831
80000,100,70453.0,53333,1600.01,9547,70453
100000,100,88000.0,66666,1999.98,12000,88000
200000,100,176080.0,133333,4000.01,23920,176080
400000,100,354070.0,200000,6000.0,45930,354070
600000,100,534137.0,200000,6000.0,65863,534137
800000,100,714043.0,200000,6000.0,85957,714043
1000000,100,894020.0,200000,6000.0,105980,894020
