Timestep,Iteration,Total Reward,Suboptimal Arms,Total Regret,Zeros Count,Ones Count
2,1,2.0,1,0.01,0,2
3,1,3.0,2,0.01,0,3
100,1,82.0,66,0.33,18,82
200,1,176.0,133,0.67,24,176
2000,1,1802.0,1333,6.66,198,1802
10000,1,8961.0,6666,33.33,1039,8961
20000,1,17943.0,13333,66.67,2057,17943
40000,1,35945.0,26666,133.33,4055,35945
60000,1,53813.0,40000,200.0,6187,53813
80000,1,71827.0,53333,266.66,8173,71827
100000,1,89748.0,66666,333.33,10252,89748
200000,1,179391.0,133333,666.66,20609,179391
400000,1,358869.0,200000,1000.0,41131,358869
600000,1,538726.0,200000,1000.0,61274,538726
800000,1,718655.0,200000,1000.0,81345,718655
1000000,1,898725.0,200000,1000.0,101275,898725
2,2,2.0,1,0.01,0,2
3,2,2.0,2,0.01,1,2
100,2,88.0,66,0.33,12,88
200,2,179.0,133,0.67,21,179
2000,2,1809.0,1333,6.66,191,1809
10000,2,8970.0,6666,33.33,1030,8970
20000,2,17885.0,13333,66.67,2115,17885
40000,2,35745.0,26666,133.33,4255,35745
60000,2,53729.0,40000,200.0,6271,53729
80000,2,71599.0,53333,266.66,8401,71599
100000,2,89500.0,66666,333.33,10500,89500
200000,2,178942.0,133333,666.66,21058,178942
400000,2,358512.0,200000,1000.0,41488,358512
600000,2,538674.0,200000,1000.0,61326,538674
800000,2,718566.0,200000,1000.0,81434,718566
1000000,2,898659.0,200000,1000.0,101341,898659
2,3,2.0,1,0.01,0,2
3,3,3.0,2,0.01,0,3
100,3,88.0,66,0.33,12,88
200,3,174.0,133,0.67,26,174
2000,3,1792.0,1333,6.66,208,1792
10000,3,8977.0,6666,33.33,1023,8977
20000,3,17970.0,13333,66.67,2030,17970
40000,3,35845.0,26666,133.33,4155,35845
60000,3,53837.0,40000,200.0,6163,53837
80000,3,71803.0,53333,266.66,8197,71803
100000,3,89746.0,66666,333.33,10254,89746
200000,3,179464.0,133333,666.66,20536,179464
400000,3,359001.0,200000,1000.0,40999,359001
600000,3,539042.0,200000,1000.0,60958,539042
800000,3,719173.0,200000,1000.0,80827,719173
1000000,3,899124.0,200000,1000.0,100876,899124
2,4,2.0,1,0.01,0,2
3,4,3.0,2,0.01,0,3
100,4,92.0,66,0.33,8,92
200,4,185.0,133,0.67,15,185
2000,4,1819.0,1333,6.66,181,1819
10000,4,9013.0,6666,33.33,987,9013
20000,4,17961.0,13333,66.67,2039,17961
40000,4,35980.0,26666,133.33,4020,35980
60000,4,53883.0,40000,200.0,6117,53883
80000,4,71837.0,53333,266.66,8163,71837
100000,4,89806.0,66666,333.33,10194,89806
200000,4,179459.0,133333,666.66,20541,179459
400000,4,359065.0,200000,1000.0,40935,359065
600000,4,539120.0,200000,1000.0,60880,539120
800000,4,719178.0,200000,1000.0,80822,719178
1000000,4,899456.0,200000,1000.0,100544,899456
2,5,2.0,1,0.01,0,2
3,5,3.0,2,0.01,0,3
100,5,92.0,66,0.33,8,92
200,5,179.0,133,0.67,21,179
2000,5,1807.0,1333,6.66,193,1807
10000,5,8977.0,6666,33.33,1023,8977
20000,5,17946.0,13333,66.67,2054,17946
40000,5,35851.0,26666,133.33,4149,35851
60000,5,53824.0,40000,200.0,6176,53824
80000,5,71724.0,53333,266.66,8276,71724
100000,5,89666.0,66666,333.33,10334,89666
200000,5,179297.0,133333,666.66,20703,179297
400000,5,358877.0,200000,1000.0,41123,358877
600000,5,538971.0,200000,1000.0,61029,538971
800000,5,718841.0,200000,1000.0,81159,718841
1000000,5,898530.0,200000,1000.0,101470,898530
2,6,1.0,1,0.01,1,1
3,6,2.0,2,0.01,1,2
100,6,87.0,66,0.33,13,87
200,6,173.0,133,0.67,27,173
2000,6,1778.0,1333,6.66,222,1778
10000,6,8960.0,6666,33.33,1040,8960
20000,6,17911.0,13333,66.67,2089,17911
40000,6,35826.0,26666,133.33,4174,35826
60000,6,53853.0,40000,200.0,6147,53853
80000,6,71787.0,53333,266.66,8213,71787
100000,6,89736.0,66666,333.33,10264,89736
200000,6,179310.0,133333,666.66,20690,179310
400000,6,359053.0,200000,1000.0,40947,359053
600000,6,539053.0,200000,1000.0,60947,539053
800000,6,719047.0,200000,1000.0,80953,719047
1000000,6,899145.0,200000,1000.0,100855,899145
2,7,2.0,1,0.01,0,2
3,7,3.0,2,0.01,0,3
100,7,84.0,66,0.33,16,84
200,7,175.0,133,0.67,25,175
2000,7,1790.0,1333,6.66,210,1790
10000,7,8949.0,6666,33.33,1051,8949
20000,7,17946.0,13333,66.67,2054,17946
40000,7,35841.0,26666,133.33,4159,35841
60000,7,53753.0,40000,200.0,6247,53753
80000,7,71679.0,53333,266.66,8321,71679
100000,7,89617.0,66666,333.33,10383,89617
200000,7,179271.0,133333,666.66,20729,179271
400000,7,358999.0,200000,1000.0,41001,358999
600000,7,538883.0,200000,1000.0,61117,538883
800000,7,719121.0,200000,1000.0,80879,719121
1000000,7,899304.0,200000,1000.0,100696,899304
2,8,2.0,1,0.01,0,2
3,8,3.0,2,0.01,0,3
100,8,86.0,66,0.33,14,86
200,8,171.0,133,0.67,29,171
2000,8,1798.0,1333,6.66,202,1798
10000,8,8937.0,6666,33.33,1063,8937
20000,8,17872.0,13333,66.67,2128,17872
40000,8,35818.0,26666,133.33,4182,35818
60000,8,53718.0,40000,200.0,6282,53718
80000,8,71675.0,53333,266.66,8325,71675
100000,8,89624.0,66666,333.33,10376,89624
200000,8,179300.0,133333,666.66,20700,179300
400000,8,358934.0,200000,1000.0,41066,358934
600000,8,538997.0,200000,1000.0,61003,538997
800000,8,719004.0,200000,1000.0,80996,719004
1000000,8,899301.0,200000,1000.0,100699,899301
2,9,2.0,1,0.01,0,2
3,9,3.0,2,0.01,0,3
100,9,91.0,66,0.33,9,91
200,9,182.0,133,0.67,18,182
2000,9,1785.0,1333,6.66,215,1785
10000,9,8985.0,6666,33.33,1015,8985
20000,9,17967.0,13333,66.67,2033,17967
40000,9,35896.0,26666,133.33,4104,35896
60000,9,53761.0,40000,200.0,6239,53761
80000,9,71688.0,53333,266.66,8312,71688
100000,9,89594.0,66666,333.33,10406,89594
200000,9,179381.0,133333,666.66,20619,179381
400000,9,359185.0,200000,1000.0,40815,359185
600000,9,539397.0,200000,1000.0,60603,539397
800000,9,719320.0,200000,1000.0,80680,719320
1000000,9,899505.0,200000,1000.0,100495,899505
2,10,2.0,1,0.01,0,2
3,10,3.0,2,0.01,0,3
100,10,89.0,66,0.33,11,89
200,10,179.0,133,0.67,21,179
2000,10,1777.0,1333,6.66,223,1777
10000,10,8950.0,6666,33.33,1050,8950
20000,10,17926.0,13333,66.67,2074,17926
40000,10,35863.0,26666,133.33,4137,35863
60000,10,53782.0,40000,200.0,6218,53782
80000,10,71708.0,53333,266.66,8292,71708
100000,10,89700.0,66666,333.33,10300,89700
200000,10,179494.0,133333,666.66,20506,179494
400000,10,359193.0,200000,1000.0,40807,359193
600000,10,539056.0,200000,1000.0,60944,539056
800000,10,718947.0,200000,1000.0,81053,718947
1000000,10,899177.0,200000,1000.0,100823,899177
2,11,2.0,1,0.01,0,2
3,11,3.0,2,0.01,0,3
100,11,87.0,66,0.33,13,87
200,11,178.0,133,0.67,22,178
2000,11,1805.0,1333,6.66,195,1805
10000,11,8997.0,6666,33.33,1003,8997
20000,11,17959.0,13333,66.67,2041,17959
40000,11,35790.0,26666,133.33,4210,35790
60000,11,53689.0,40000,200.0,6311,53689
80000,11,71591.0,53333,266.66,8409,71591
100000,11,89499.0,66666,333.33,10501,89499
200000,11,179223.0,133333,666.66,20777,179223
400000,11,358651.0,200000,1000.0,41349,358651
600000,11,538585.0,200000,1000.0,61415,538585
800000,11,718376.0,200000,1000.0,81624,718376
1000000,11,898600.0,200000,1000.0,101400,898600
2,12,0.0,1,0.01,2,0
3,12,1.0,2,0.01,2,1
100,12,93.0,66,0.33,7,93
200,12,182.0,133,0.67,18,182
2000,12,1801.0,1333,6.66,199,1801
10000,12,8950.0,6666,33.33,1050,8950
20000,12,17924.0,13333,66.67,2076,17924
40000,12,35867.0,26666,133.33,4133,35867
60000,12,53837.0,40000,200.0,6163,53837
80000,12,71818.0,53333,266.66,8182,71818
100000,12,89808.0,66666,333.33,10192,89808
200000,12,179586.0,133333,666.66,20414,179586
400000,12,359236.0,200000,1000.0,40764,359236
600000,12,539479.0,200000,1000.0,60521,539479
800000,12,719442.0,200000,1000.0,80558,719442
1000000,12,899323.0,200000,1000.0,100677,899323
2,13,1.0,1,0.01,1,1
3,13,2.0,2,0.01,1,2
100,13,91.0,66,0.33,9,91
200,13,182.0,133,0.67,18,182
2000,13,1769.0,1333,6.66,231,1769
10000,13,8976.0,6666,33.33,1024,8976
20000,13,17958.0,13333,66.67,2042,17958
40000,13,35956.0,26666,133.33,4044,35956
60000,13,53915.0,40000,200.0,6085,53915
80000,13,71845.0,53333,266.66,8155,71845
100000,13,89778.0,66666,333.33,10222,89778
200000,13,179261.0,133333,666.66,20739,179261
400000,13,358822.0,200000,1000.0,41178,358822
600000,13,538640.0,200000,1000.0,61360,538640
800000,13,718733.0,200000,1000.0,81267,718733
1000000,13,898644.0,200000,1000.0,101356,898644
2,14,2.0,1,0.01,0,2
3,14,3.0,2,0.01,0,3
100,14,91.0,66,0.33,9,91
200,14,180.0,133,0.67,20,180
2000,14,1815.0,1333,6.66,185,1815
10000,14,8945.0,6666,33.33,1055,8945
20000,14,17843.0,13333,66.67,2157,17843
40000,14,35711.0,26666,133.33,4289,35711
60000,14,53628.0,40000,200.0,6372,53628
80000,14,71596.0,53333,266.66,8404,71596
100000,14,89506.0,66666,333.33,10494,89506
200000,14,179173.0,133333,666.66,20827,179173
400000,14,358760.0,200000,1000.0,41240,358760
600000,14,538772.0,200000,1000.0,61228,538772
800000,14,718965.0,200000,1000.0,81035,718965
1000000,14,899057.0,200000,1000.0,100943,899057
2,15,2.0,1,0.01,0,2
3,15,3.0,2,0.01,0,3
100,15,95.0,66,0.33,5,95
200,15,187.0,133,0.67,13,187
2000,15,1818.0,1333,6.66,182,1818
10000,15,8989.0,6666,33.33,1011,8989
20000,15,18004.0,13333,66.67,1996,18004
40000,15,35897.0,26666,133.33,4103,35897
60000,15,53756.0,40000,200.0,6244,53756
80000,15,71702.0,53333,266.66,8298,71702
100000,15,89684.0,66666,333.33,10316,89684
200000,15,179254.0,133333,666.66,20746,179254
400000,15,359092.0,200000,1000.0,40908,359092
600000,15,539263.0,200000,1000.0,60737,539263
800000,15,719259.0,200000,1000.0,80741,719259
1000000,15,899189.0,200000,1000.0,100811,899189
2,16,2.0,1,0.01,0,2
3,16,3.0,2,0.01,0,3
100,16,89.0,66,0.33,11,89
200,16,182.0,133,0.67,18,182
2000,16,1794.0,1333,6.66,206,1794
10000,16,8984.0,6666,33.33,1016,8984
20000,16,17982.0,13333,66.67,2018,17982
40000,16,35902.0,26666,133.33,4098,35902
60000,16,53889.0,40000,200.0,6111,53889
80000,16,71825.0,53333,266.66,8175,71825
100000,16,89782.0,66666,333.33,10218,89782
200000,16,179413.0,133333,666.66,20587,179413
400000,16,359046.0,200000,1000.0,40954,359046
600000,16,539388.0,200000,1000.0,60612,539388
800000,16,719274.0,200000,1000.0,80726,719274
1000000,16,899392.0,200000,1000.0,100608,899392
2,17,1.0,1,0.01,1,1
3,17,2.0,2,0.01,1,2
100,17,90.0,66,0.33,10,90
200,17,185.0,133,0.67,15,185
2000,17,1797.0,1333,6.66,203,1797
10000,17,8997.0,6666,33.33,1003,8997
20000,17,17938.0,13333,66.67,2062,17938
40000,17,35905.0,26666,133.33,4095,35905
60000,17,53798.0,40000,200.0,6202,53798
80000,17,71725.0,53333,266.66,8275,71725
100000,17,89649.0,66666,333.33,10351,89649
200000,17,179387.0,133333,666.66,20613,179387
400000,17,359120.0,200000,1000.0,40880,359120
600000,17,539148.0,200000,1000.0,60852,539148
800000,17,719304.0,200000,1000.0,80696,719304
1000000,17,899470.0,200000,1000.0,100530,899470
2,18,2.0,1,0.01,0,2
3,18,3.0,2,0.01,0,3
100,18,87.0,66,0.33,13,87
200,18,182.0,133,0.67,18,182
2000,18,1798.0,1333,6.66,202,1798
10000,18,8934.0,6666,33.33,1066,8934
20000,18,17898.0,13333,66.67,2102,17898
40000,18,35824.0,26666,133.33,4176,35824
60000,18,53714.0,40000,200.0,6286,53714
80000,18,71642.0,53333,266.66,8358,71642
100000,18,89602.0,66666,333.33,10398,89602
200000,18,179267.0,133333,666.66,20733,179267
400000,18,359025.0,200000,1000.0,40975,359025
600000,18,538991.0,200000,1000.0,61009,538991
800000,18,718916.0,200000,1000.0,81084,718916
1000000,18,898997.0,200000,1000.0,101003,898997
2,19,2.0,1,0.01,0,2
3,19,3.0,2,0.01,0,3
100,19,86.0,66,0.33,14,86
200,19,171.0,133,0.67,29,171
2000,19,1788.0,1333,6.66,212,1788
10000,19,9008.0,6666,33.33,992,9008
20000,19,17975.0,13333,66.67,2025,17975
40000,19,35887.0,26666,133.33,4113,35887
60000,19,53855.0,40000,200.0,6145,53855
80000,19,71768.0,53333,266.66,8232,71768
100000,19,89695.0,66666,333.33,10305,89695
200000,19,179221.0,133333,666.66,20779,179221
400000,19,358986.0,200000,1000.0,41014,358986
600000,19,539032.0,200000,1000.0,60968,539032
800000,19,719157.0,200000,1000.0,80843,719157
1000000,19,899296.0,200000,1000.0,100704,899296
2,20,2.0,1,0.01,0,2
3,20,3.0,2,0.01,0,3
100,20,87.0,66,0.33,13,87
200,20,180.0,133,0.67,20,180
2000,20,1806.0,1333,6.66,194,1806
10000,20,8913.0,6666,33.33,1087,8913
20000,20,17882.0,13333,66.67,2118,17882
40000,20,35801.0,26666,133.33,4199,35801
60000,20,53745.0,40000,200.0,6255,53745
80000,20,71690.0,53333,266.66,8310,71690
100000,20,89652.0,66666,333.33,10348,89652
200000,20,179421.0,133333,666.66,20579,179421
400000,20,359196.0,200000,1000.0,40804,359196
600000,20,538936.0,200000,1000.0,61064,538936
800000,20,718865.0,200000,1000.0,81135,718865
1000000,20,898980.0,200000,1000.0,101020,898980
2,21,2.0,1,0.01,0,2
3,21,3.0,2,0.01,0,3
100,21,92.0,66,0.33,8,92
200,21,182.0,133,0.67,18,182
2000,21,1822.0,1333,6.66,178,1822
10000,21,8962.0,6666,33.33,1038,8962
20000,21,17946.0,13333,66.67,2054,17946
40000,21,35812.0,26666,133.33,4188,35812
60000,21,53792.0,40000,200.0,6208,53792
80000,21,71722.0,53333,266.66,8278,71722
100000,21,89734.0,66666,333.33,10266,89734
200000,21,179324.0,133333,666.66,20676,179324
400000,21,358863.0,200000,1000.0,41137,358863
600000,21,539002.0,200000,1000.0,60998,539002
800000,21,719039.0,200000,1000.0,80961,719039
1000000,21,899207.0,200000,1000.0,100793,899207
2,22,2.0,1,0.01,0,2
3,22,3.0,2,0.01,0,3
100,22,86.0,66,0.33,14,86
200,22,176.0,133,0.67,24,176
2000,22,1785.0,1333,6.66,215,1785
10000,22,8931.0,6666,33.33,1069,8931
20000,22,17872.0,13333,66.67,2128,17872
40000,22,35755.0,26666,133.33,4245,35755
60000,22,53636.0,40000,200.0,6364,53636
80000,22,71632.0,53333,266.66,8368,71632
100000,22,89572.0,66666,333.33,10428,89572
200000,22,179323.0,133333,666.66,20677,179323
400000,22,359152.0,200000,1000.0,40848,359152
600000,22,539320.0,200000,1000.0,60680,539320
800000,22,719666.0,200000,1000.0,80334,719666
1000000,22,899593.0,200000,1000.0,100407,899593
2,23,2.0,1,0.01,0,2
3,23,3.0,2,0.01,0,3
100,23,89.0,66,0.33,11,89
200,23,181.0,133,0.67,19,181
2000,23,1789.0,1333,6.66,211,1789
10000,23,8912.0,6666,33.33,1088,8912
20000,23,17902.0,13333,66.67,2098,17902
40000,23,35824.0,26666,133.33,4176,35824
60000,23,53735.0,40000,200.0,6265,53735
80000,23,71622.0,53333,266.66,8378,71622
100000,23,89465.0,66666,333.33,10535,89465
200000,23,178999.0,133333,666.66,21001,178999
400000,23,358617.0,200000,1000.0,41383,358617
600000,23,538770.0,200000,1000.0,61230,538770
800000,23,718685.0,200000,1000.0,81315,718685
1000000,23,898721.0,200000,1000.0,101279,898721
2,24,2.0,1,0.01,0,2
3,24,3.0,2,0.01,0,3
100,24,94.0,66,0.33,6,94
200,24,184.0,133,0.67,16,184
2000,24,1799.0,1333,6.66,201,1799
10000,24,8934.0,6666,33.33,1066,8934
20000,24,17896.0,13333,66.67,2104,17896
40000,24,35751.0,26666,133.33,4249,35751
60000,24,53686.0,40000,200.0,6314,53686
80000,24,71586.0,53333,266.66,8414,71586
100000,24,89463.0,66666,333.33,10537,89463
200000,24,179076.0,133333,666.66,20924,179076
400000,24,358687.0,200000,1000.0,41313,358687
600000,24,538942.0,200000,1000.0,61058,538942
800000,24,718821.0,200000,1000.0,81179,718821
1000000,24,898852.0,200000,1000.0,101148,898852
2,25,1.0,1,0.01,1,1
3,25,2.0,2,0.01,1,2
100,25,87.0,66,0.33,13,87
200,25,170.0,133,0.67,30,170
2000,25,1784.0,1333,6.66,216,1784
10000,25,8965.0,6666,33.33,1035,8965
20000,25,17895.0,13333,66.67,2105,17895
40000,25,35778.0,26666,133.33,4222,35778
60000,25,53823.0,40000,200.0,6177,53823
80000,25,71826.0,53333,266.66,8174,71826
100000,25,89816.0,66666,333.33,10184,89816
200000,25,179439.0,133333,666.66,20561,179439
400000,25,358931.0,200000,1000.0,41069,358931
600000,25,539031.0,200000,1000.0,60969,539031
800000,25,718844.0,200000,1000.0,81156,718844
1000000,25,899033.0,200000,1000.0,100967,899033
2,26,2.0,1,0.01,0,2
3,26,3.0,2,0.01,0,3
100,26,93.0,66,0.33,7,93
200,26,182.0,133,0.67,18,182
2000,26,1803.0,1333,6.66,197,1803
10000,26,8994.0,6666,33.33,1006,8994
20000,26,17986.0,13333,66.67,2014,17986
40000,26,35923.0,26666,133.33,4077,35923
60000,26,53889.0,40000,200.0,6111,53889
80000,26,71825.0,53333,266.66,8175,71825
100000,26,89757.0,66666,333.33,10243,89757
200000,26,179470.0,133333,666.66,20530,179470
400000,26,358957.0,200000,1000.0,41043,358957
600000,26,539088.0,200000,1000.0,60912,539088
800000,26,718933.0,200000,1000.0,81067,718933
1000000,26,899092.0,200000,1000.0,100908,899092
2,27,2.0,1,0.01,0,2
3,27,3.0,2,0.01,0,3
100,27,89.0,66,0.33,11,89
200,27,178.0,133,0.67,22,178
2000,27,1781.0,1333,6.66,219,1781
10000,27,8953.0,6666,33.33,1047,8953
20000,27,17902.0,13333,66.67,2098,17902
40000,27,35879.0,26666,133.33,4121,35879
60000,27,53817.0,40000,200.0,6183,53817
80000,27,71784.0,53333,266.66,8216,71784
100000,27,89665.0,66666,333.33,10335,89665
200000,27,179328.0,133333,666.66,20672,179328
400000,27,358886.0,200000,1000.0,41114,358886
600000,27,538927.0,200000,1000.0,61073,538927
800000,27,718844.0,200000,1000.0,81156,718844
1000000,27,898689.0,200000,1000.0,101311,898689
2,28,2.0,1,0.01,0,2
3,28,3.0,2,0.01,0,3
100,28,82.0,66,0.33,18,82
200,28,173.0,133,0.67,27,173
2000,28,1795.0,1333,6.66,205,1795
10000,28,8942.0,6666,33.33,1058,8942
20000,28,17857.0,13333,66.67,2143,17857
40000,28,35797.0,26666,133.33,4203,35797
60000,28,53671.0,40000,200.0,6329,53671
80000,28,71650.0,53333,266.66,8350,71650
100000,28,89593.0,66666,333.33,10407,89593
200000,28,179286.0,133333,666.66,20714,179286
400000,28,359117.0,200000,1000.0,40883,359117
600000,28,539335.0,200000,1000.0,60665,539335
800000,28,719523.0,200000,1000.0,80477,719523
1000000,28,899607.0,200000,1000.0,100393,899607
2,29,1.0,1,0.01,1,1
3,29,2.0,2,0.01,1,2
100,29,92.0,66,0.33,8,92
200,29,186.0,133,0.67,14,186
2000,29,1801.0,1333,6.66,199,1801
10000,29,8990.0,6666,33.33,1010,8990
20000,29,17964.0,13333,66.67,2036,17964
40000,29,35904.0,26666,133.33,4096,35904
60000,29,53835.0,40000,200.0,6165,53835
80000,29,71833.0,53333,266.66,8167,71833
100000,29,89747.0,66666,333.33,10253,89747
200000,29,179387.0,133333,666.66,20613,179387
400000,29,359058.0,200000,1000.0,40942,359058
600000,29,539017.0,200000,1000.0,60983,539017
800000,29,719056.0,200000,1000.0,80944,719056
1000000,29,898672.0,200000,1000.0,101328,898672
2,30,2.0,1,0.01,0,2
3,30,3.0,2,0.01,0,3
100,30,91.0,66,0.33,9,91
200,30,177.0,133,0.67,23,177
2000,30,1795.0,1333,6.66,205,1795
10000,30,8984.0,6666,33.33,1016,8984
20000,30,17936.0,13333,66.67,2064,17936
40000,30,35855.0,26666,133.33,4145,35855
60000,30,53781.0,40000,200.0,6219,53781
80000,30,71727.0,53333,266.66,8273,71727
100000,30,89686.0,66666,333.33,10314,89686
200000,30,179300.0,133333,666.66,20700,179300
400000,30,358830.0,200000,1000.0,41170,358830
600000,30,538585.0,200000,1000.0,61415,538585
800000,30,718440.0,200000,1000.0,81560,718440
1000000,30,898310.0,200000,1000.0,101690,898310
2,31,2.0,1,0.01,0,2
3,31,2.0,2,0.01,1,2
100,31,88.0,66,0.33,12,88
200,31,176.0,133,0.67,24,176
2000,31,1791.0,1333,6.66,209,1791
10000,31,8897.0,6666,33.33,1103,8897
20000,31,17830.0,13333,66.67,2170,17830
40000,31,35774.0,26666,133.33,4226,35774
60000,31,53713.0,40000,200.0,6287,53713
80000,31,71640.0,53333,266.66,8360,71640
100000,31,89600.0,66666,333.33,10400,89600
200000,31,179310.0,133333,666.66,20690,179310
400000,31,359088.0,200000,1000.0,40912,359088
600000,31,538915.0,200000,1000.0,61085,538915
800000,31,718796.0,200000,1000.0,81204,718796
1000000,31,898521.0,200000,1000.0,101479,898521
2,32,2.0,1,0.01,0,2
3,32,2.0,2,0.01,1,2
100,32,91.0,66,0.33,9,91
200,32,180.0,133,0.67,20,180
2000,32,1786.0,1333,6.66,214,1786
10000,32,8990.0,6666,33.33,1010,8990
20000,32,17914.0,13333,66.67,2086,17914
40000,32,35905.0,26666,133.33,4095,35905
60000,32,53935.0,40000,200.0,6065,53935
80000,32,71943.0,53333,266.66,8057,71943
100000,32,89948.0,66666,333.33,10052,89948
200000,32,179544.0,133333,666.66,20456,179544
400000,32,359145.0,200000,1000.0,40855,359145
600000,32,539162.0,200000,1000.0,60838,539162
800000,32,719047.0,200000,1000.0,80953,719047
1000000,32,899075.0,200000,1000.0,100925,899075
2,33,2.0,1,0.01,0,2
3,33,3.0,2,0.01,0,3
100,33,84.0,66,0.33,16,84
200,33,169.0,133,0.67,31,169
2000,33,1781.0,1333,6.66,219,1781
10000,33,8908.0,6666,33.33,1092,8908
20000,33,17875.0,13333,66.67,2125,17875
40000,33,35822.0,26666,133.33,4178,35822
60000,33,53772.0,40000,200.0,6228,53772
80000,33,71662.0,53333,266.66,8338,71662
100000,33,89563.0,66666,333.33,10437,89563
200000,33,179154.0,133333,666.66,20846,179154
400000,33,358601.0,200000,1000.0,41399,358601
600000,33,538588.0,200000,1000.0,61412,538588
800000,33,718746.0,200000,1000.0,81254,718746
1000000,33,898810.0,200000,1000.0,101190,898810
2,34,2.0,1,0.01,0,2
3,34,3.0,2,0.01,0,3
100,34,93.0,66,0.33,7,93
200,34,179.0,133,0.67,21,179
2000,34,1800.0,1333,6.66,200,1800
10000,34,8999.0,6666,33.33,1001,8999
20000,34,18008.0,13333,66.67,1992,18008
40000,34,35926.0,26666,133.33,4074,35926
60000,34,53822.0,40000,200.0,6178,53822
80000,34,71756.0,53333,266.66,8244,71756
100000,34,89566.0,66666,333.33,10434,89566
200000,34,179146.0,133333,666.66,20854,179146
400000,34,359091.0,200000,1000.0,40909,359091
600000,34,539030.0,200000,1000.0,60970,539030
800000,34,718931.0,200000,1000.0,81069,718931
1000000,34,898756.0,200000,1000.0,101244,898756
2,35,2.0,1,0.01,0,2
3,35,3.0,2,0.01,0,3
100,35,91.0,66,0.33,9,91
200,35,181.0,133,0.67,19,181
2000,35,1805.0,1333,6.66,195,1805
10000,35,8937.0,6666,33.33,1063,8937
20000,35,17919.0,13333,66.67,2081,17919
40000,35,35818.0,26666,133.33,4182,35818
60000,35,53771.0,40000,200.0,6229,53771
80000,35,71676.0,53333,266.66,8324,71676
100000,35,89617.0,66666,333.33,10383,89617
200000,35,179292.0,133333,666.66,20708,179292
400000,35,358683.0,200000,1000.0,41317,358683
600000,35,538857.0,200000,1000.0,61143,538857
800000,35,718861.0,200000,1000.0,81139,718861
1000000,35,898701.0,200000,1000.0,101299,898701
2,36,2.0,1,0.01,0,2
3,36,3.0,2,0.01,0,3
100,36,86.0,66,0.33,14,86
200,36,173.0,133,0.67,27,173
2000,36,1803.0,1333,6.66,197,1803
10000,36,8970.0,6666,33.33,1030,8970
20000,36,17938.0,13333,66.67,2062,17938
40000,36,35863.0,26666,133.33,4137,35863
60000,36,53741.0,40000,200.0,6259,53741
80000,36,71701.0,53333,266.66,8299,71701
100000,36,89612.0,66666,333.33,10388,89612
200000,36,179232.0,133333,666.66,20768,179232
400000,36,358947.0,200000,1000.0,41053,358947
600000,36,538906.0,200000,1000.0,61094,538906
800000,36,718942.0,200000,1000.0,81058,718942
1000000,36,899061.0,200000,1000.0,100939,899061
2,37,1.0,1,0.01,1,1
3,37,2.0,2,0.01,1,2
100,37,89.0,66,0.33,11,89
200,37,177.0,133,0.67,23,177
2000,37,1814.0,1333,6.66,186,1814
10000,37,8982.0,6666,33.33,1018,8982
20000,37,17900.0,13333,66.67,2100,17900
40000,37,35812.0,26666,133.33,4188,35812
60000,37,53790.0,40000,200.0,6210,53790
80000,37,71735.0,53333,266.66,8265,71735
100000,37,89691.0,66666,333.33,10309,89691
200000,37,179323.0,133333,666.66,20677,179323
400000,37,358780.0,200000,1000.0,41220,358780
600000,37,538717.0,200000,1000.0,61283,538717
800000,37,718694.0,200000,1000.0,81306,718694
1000000,37,898500.0,200000,1000.0,101500,898500
2,38,2.0,1,0.01,0,2
3,38,3.0,2,0.01,0,3
100,38,90.0,66,0.33,10,90
200,38,182.0,133,0.67,18,182
2000,38,1793.0,1333,6.66,207,1793
10000,38,8926.0,6666,33.33,1074,8926
20000,38,17885.0,13333,66.67,2115,17885
40000,38,35859.0,26666,133.33,4141,35859
60000,38,53848.0,40000,200.0,6152,53848
80000,38,71727.0,53333,266.66,8273,71727
100000,38,89604.0,66666,333.33,10396,89604
200000,38,179359.0,133333,666.66,20641,179359
400000,38,359090.0,200000,1000.0,40910,359090
600000,38,539203.0,200000,1000.0,60797,539203
800000,38,718955.0,200000,1000.0,81045,718955
1000000,38,898844.0,200000,1000.0,101156,898844
2,39,1.0,1,0.01,1,1
3,39,2.0,2,0.01,1,2
100,39,90.0,66,0.33,10,90
200,39,181.0,133,0.67,19,181
2000,39,1793.0,1333,6.66,207,1793
10000,39,8975.0,6666,33.33,1025,8975
20000,39,17898.0,13333,66.67,2102,17898
40000,39,35797.0,26666,133.33,4203,35797
60000,39,53745.0,40000,200.0,6255,53745
80000,39,71681.0,53333,266.66,8319,71681
100000,39,89623.0,66666,333.33,10377,89623
200000,39,179363.0,133333,666.66,20637,179363
400000,39,359023.0,200000,1000.0,40977,359023
600000,39,538943.0,200000,1000.0,61057,538943
800000,39,718888.0,200000,1000.0,81112,718888
1000000,39,898967.0,200000,1000.0,101033,898967
2,40,2.0,1,0.01,0,2
3,40,3.0,2,0.01,0,3
100,40,84.0,66,0.33,16,84
200,40,171.0,133,0.67,29,171
2000,40,1788.0,1333,6.66,212,1788
10000,40,8932.0,6666,33.33,1068,8932
20000,40,17881.0,13333,66.67,2119,17881
40000,40,35804.0,26666,133.33,4196,35804
60000,40,53695.0,40000,200.0,6305,53695
80000,40,71635.0,53333,266.66,8365,71635
100000,40,89507.0,66666,333.33,10493,89507
200000,40,179199.0,133333,666.66,20801,179199
400000,40,358765.0,200000,1000.0,41235,358765
600000,40,538693.0,200000,1000.0,61307,538693
800000,40,718665.0,200000,1000.0,81335,718665
1000000,40,898474.0,200000,1000.0,101526,898474
2,41,2.0,1,0.01,0,2
3,41,3.0,2,0.01,0,3
100,41,89.0,66,0.33,11,89
200,41,176.0,133,0.67,24,176
2000,41,1771.0,1333,6.66,229,1771
10000,41,8958.0,6666,33.33,1042,8958
20000,41,17926.0,13333,66.67,2074,17926
40000,41,35878.0,26666,133.33,4122,35878
60000,41,53765.0,40000,200.0,6235,53765
80000,41,71717.0,53333,266.66,8283,71717
100000,41,89612.0,66666,333.33,10388,89612
200000,41,179264.0,133333,666.66,20736,179264
400000,41,358741.0,200000,1000.0,41259,358741
600000,41,538674.0,200000,1000.0,61326,538674
800000,41,718803.0,200000,1000.0,81197,718803
1000000,41,898766.0,200000,1000.0,101234,898766
2,42,2.0,1,0.01,0,2
3,42,3.0,2,0.01,0,3
100,42,90.0,66,0.33,10,90
200,42,179.0,133,0.67,21,179
2000,42,1805.0,1333,6.66,195,1805
10000,42,8964.0,6666,33.33,1036,8964
20000,42,17886.0,13333,66.67,2114,17886
40000,42,35746.0,26666,133.33,4254,35746
60000,42,53659.0,40000,200.0,6341,53659
80000,42,71626.0,53333,266.66,8374,71626
100000,42,89494.0,66666,333.33,10506,89494
200000,42,179083.0,133333,666.66,20917,179083
400000,42,358778.0,200000,1000.0,41222,358778
600000,42,538765.0,200000,1000.0,61235,538765
800000,42,718718.0,200000,1000.0,81282,718718
1000000,42,898731.0,200000,1000.0,101269,898731
2,43,2.0,1,0.01,0,2
3,43,3.0,2,0.01,0,3
100,43,92.0,66,0.33,8,92
200,43,183.0,133,0.67,17,183
2000,43,1803.0,1333,6.66,197,1803
10000,43,8981.0,6666,33.33,1019,8981
20000,43,17996.0,13333,66.67,2004,17996
40000,43,35870.0,26666,133.33,4130,35870
60000,43,53843.0,40000,200.0,6157,53843
80000,43,71800.0,53333,266.66,8200,71800
100000,43,89831.0,66666,333.33,10169,89831
200000,43,179337.0,133333,666.66,20663,179337
400000,43,359042.0,200000,1000.0,40958,359042
600000,43,539023.0,200000,1000.0,60977,539023
800000,43,718739.0,200000,1000.0,81261,718739
1000000,43,898723.0,200000,1000.0,101277,898723
2,44,2.0,1,0.01,0,2
3,44,3.0,2,0.01,0,3
100,44,92.0,66,0.33,8,92
200,44,184.0,133,0.67,16,184
2000,44,1813.0,1333,6.66,187,1813
10000,44,8987.0,6666,33.33,1013,8987
20000,44,17955.0,13333,66.67,2045,17955
40000,44,35944.0,26666,133.33,4056,35944
60000,44,53890.0,40000,200.0,6110,53890
80000,44,71752.0,53333,266.66,8248,71752
100000,44,89643.0,66666,333.33,10357,89643
200000,44,179298.0,133333,666.66,20702,179298
400000,44,359185.0,200000,1000.0,40815,359185
600000,44,539199.0,200000,1000.0,60801,539199
800000,44,719239.0,200000,1000.0,80761,719239
1000000,44,899086.0,200000,1000.0,100914,899086
2,45,2.0,1,0.01,0,2
3,45,3.0,2,0.01,0,3
100,45,87.0,66,0.33,13,87
200,45,179.0,133,0.67,21,179
2000,45,1803.0,1333,6.66,197,1803
10000,45,8959.0,6666,33.33,1041,8959
20000,45,17929.0,13333,66.67,2071,17929
40000,45,35832.0,26666,133.33,4168,35832
60000,45,53731.0,40000,200.0,6269,53731
80000,45,71676.0,53333,266.66,8324,71676
100000,45,89586.0,66666,333.33,10414,89586
200000,45,179238.0,133333,666.66,20762,179238
400000,45,358876.0,200000,1000.0,41124,358876
600000,45,538851.0,200000,1000.0,61149,538851
800000,45,718976.0,200000,1000.0,81024,718976
1000000,45,899116.0,200000,1000.0,100884,899116
2,46,2.0,1,0.01,0,2
3,46,3.0,2,0.01,0,3
100,46,92.0,66,0.33,8,92
200,46,185.0,133,0.67,15,185
2000,46,1809.0,1333,6.66,191,1809
10000,46,8977.0,6666,33.33,1023,8977
20000,46,17939.0,13333,66.67,2061,17939
40000,46,35858.0,26666,133.33,4142,35858
60000,46,53717.0,40000,200.0,6283,53717
80000,46,71688.0,53333,266.66,8312,71688
100000,46,89619.0,66666,333.33,10381,89619
200000,46,179472.0,133333,666.66,20528,179472
400000,46,359351.0,200000,1000.0,40649,359351
600000,46,539254.0,200000,1000.0,60746,539254
800000,46,719300.0,200000,1000.0,80700,719300
1000000,46,899177.0,200000,1000.0,100823,899177
2,47,2.0,1,0.01,0,2
3,47,2.0,2,0.01,1,2
100,47,90.0,66,0.33,10,90
200,47,178.0,133,0.67,22,178
2000,47,1771.0,1333,6.66,229,1771
10000,47,8906.0,6666,33.33,1094,8906
20000,47,17913.0,13333,66.67,2087,17913
40000,47,35750.0,26666,133.33,4250,35750
60000,47,53707.0,40000,200.0,6293,53707
80000,47,71621.0,53333,266.66,8379,71621
100000,47,89533.0,66666,333.33,10467,89533
200000,47,179343.0,133333,666.66,20657,179343
400000,47,358958.0,200000,1000.0,41042,358958
600000,47,538659.0,200000,1000.0,61341,538659
800000,47,718811.0,200000,1000.0,81189,718811
1000000,47,898451.0,200000,1000.0,101549,898451
2,48,2.0,1,0.01,0,2
3,48,3.0,2,0.01,0,3
100,48,92.0,66,0.33,8,92
200,48,181.0,133,0.67,19,181
2000,48,1804.0,1333,6.66,196,1804
10000,48,8936.0,6666,33.33,1064,8936
20000,48,17937.0,13333,66.67,2063,17937
40000,48,35851.0,26666,133.33,4149,35851
60000,48,53816.0,40000,200.0,6184,53816
80000,48,71642.0,53333,266.66,8358,71642
100000,48,89567.0,66666,333.33,10433,89567
200000,48,179199.0,133333,666.66,20801,179199
400000,48,358883.0,200000,1000.0,41117,358883
600000,48,538864.0,200000,1000.0,61136,538864
800000,48,718940.0,200000,1000.0,81060,718940
1000000,48,898929.0,200000,1000.0,101071,898929
2,49,1.0,1,0.01,1,1
3,49,2.0,2,0.01,1,2
100,49,85.0,66,0.33,15,85
200,49,172.0,133,0.67,28,172
2000,49,1786.0,1333,6.66,214,1786
10000,49,8959.0,6666,33.33,1041,8959
20000,49,17972.0,13333,66.67,2028,17972
40000,49,35873.0,26666,133.33,4127,35873
60000,49,53835.0,40000,200.0,6165,53835
80000,49,71788.0,53333,266.66,8212,71788
100000,49,89726.0,66666,333.33,10274,89726
200000,49,179431.0,133333,666.66,20569,179431
400000,49,359142.0,200000,1000.0,40858,359142
600000,49,539005.0,200000,1000.0,60995,539005
800000,49,719420.0,200000,1000.0,80580,719420
1000000,49,899620.0,200000,1000.0,100380,899620
2,50,1.0,1,0.01,1,1
3,50,1.0,2,0.01,2,1
100,50,92.0,66,0.33,8,92
200,50,184.0,133,0.67,16,184
2000,50,1803.0,1333,6.66,197,1803
10000,50,9001.0,6666,33.33,999,9001
20000,50,17972.0,13333,66.67,2028,17972
40000,50,35886.0,26666,133.33,4114,35886
60000,50,53822.0,40000,200.0,6178,53822
80000,50,71811.0,53333,266.66,8189,71811
100000,50,89738.0,66666,333.33,10262,89738
200000,50,179308.0,133333,666.66,20692,179308
400000,50,358925.0,200000,1000.0,41075,358925
600000,50,538881.0,200000,1000.0,61119,538881
800000,50,719152.0,200000,1000.0,80848,719152
1000000,50,899310.0,200000,1000.0,100690,899310
2,51,2.0,1,0.01,0,2
3,51,3.0,2,0.01,0,3
100,51,82.0,66,0.33,18,82
200,51,175.0,133,0.67,25,175
2000,51,1793.0,1333,6.66,207,1793
10000,51,8994.0,6666,33.33,1006,8994
20000,51,17936.0,13333,66.67,2064,17936
40000,51,35883.0,26666,133.33,4117,35883
60000,51,53756.0,40000,200.0,6244,53756
80000,51,71696.0,53333,266.66,8304,71696
100000,51,89699.0,66666,333.33,10301,89699
200000,51,179282.0,133333,666.66,20718,179282
400000,51,358897.0,200000,1000.0,41103,358897
600000,51,538617.0,200000,1000.0,61383,538617
800000,51,718366.0,200000,1000.0,81634,718366
1000000,51,898495.0,200000,1000.0,101505,898495
2,52,2.0,1,0.01,0,2
3,52,3.0,2,0.01,0,3
100,52,87.0,66,0.33,13,87
200,52,177.0,133,0.67,23,177
2000,52,1782.0,1333,6.66,218,1782
10000,52,8984.0,6666,33.33,1016,8984
20000,52,17922.0,13333,66.67,2078,17922
40000,52,35799.0,26666,133.33,4201,35799
60000,52,53649.0,40000,200.0,6351,53649
80000,52,71514.0,53333,266.66,8486,71514
100000,52,89475.0,66666,333.33,10525,89475
200000,52,179207.0,133333,666.66,20793,179207
400000,52,358933.0,200000,1000.0,41067,358933
600000,52,538611.0,200000,1000.0,61389,538611
800000,52,718497.0,200000,1000.0,81503,718497
1000000,52,898399.0,200000,1000.0,101601,898399
2,53,1.0,1,0.01,1,1
3,53,2.0,2,0.01,1,2
100,53,93.0,66,0.33,7,93
200,53,184.0,133,0.67,16,184
2000,53,1789.0,1333,6.66,211,1789
10000,53,8944.0,6666,33.33,1056,8944
20000,53,17928.0,13333,66.67,2072,17928
40000,53,35847.0,26666,133.33,4153,35847
60000,53,53794.0,40000,200.0,6206,53794
80000,53,71645.0,53333,266.66,8355,71645
100000,53,89571.0,66666,333.33,10429,89571
200000,53,179358.0,133333,666.66,20642,179358
400000,53,359140.0,200000,1000.0,40860,359140
600000,53,539238.0,200000,1000.0,60762,539238
800000,53,719279.0,200000,1000.0,80721,719279
1000000,53,899418.0,200000,1000.0,100582,899418
2,54,2.0,1,0.01,0,2
3,54,3.0,2,0.01,0,3
100,54,91.0,66,0.33,9,91
200,54,182.0,133,0.67,18,182
2000,54,1806.0,1333,6.66,194,1806
10000,54,8976.0,6666,33.33,1024,8976
20000,54,17908.0,13333,66.67,2092,17908
40000,54,35822.0,26666,133.33,4178,35822
60000,54,53774.0,40000,200.0,6226,53774
80000,54,71761.0,53333,266.66,8239,71761
100000,54,89730.0,66666,333.33,10270,89730
200000,54,179475.0,133333,666.66,20525,179475
400000,54,358961.0,200000,1000.0,41039,358961
600000,54,539014.0,200000,1000.0,60986,539014
800000,54,719144.0,200000,1000.0,80856,719144
1000000,54,899175.0,200000,1000.0,100825,899175
2,55,2.0,1,0.01,0,2
3,55,3.0,2,0.01,0,3
100,55,86.0,66,0.33,14,86
200,55,178.0,133,0.67,22,178
2000,55,1805.0,1333,6.66,195,1805
10000,55,8933.0,6666,33.33,1067,8933
20000,55,17922.0,13333,66.67,2078,17922
40000,55,35938.0,26666,133.33,4062,35938
60000,55,53900.0,40000,200.0,6100,53900
80000,55,71802.0,53333,266.66,8198,71802
100000,55,89719.0,66666,333.33,10281,89719
200000,55,179469.0,133333,666.66,20531,179469
400000,55,359273.0,200000,1000.0,40727,359273
600000,55,539368.0,200000,1000.0,60632,539368
800000,55,719196.0,200000,1000.0,80804,719196
1000000,55,899238.0,200000,1000.0,100762,899238
2,56,2.0,1,0.01,0,2
3,56,3.0,2,0.01,0,3
100,56,89.0,66,0.33,11,89
200,56,175.0,133,0.67,25,175
2000,56,1779.0,1333,6.66,221,1779
10000,56,8950.0,6666,33.33,1050,8950
20000,56,17909.0,13333,66.67,2091,17909
40000,56,35711.0,26666,133.33,4289,35711
60000,56,53655.0,40000,200.0,6345,53655
80000,56,71551.0,53333,266.66,8449,71551
100000,56,89462.0,66666,333.33,10538,89462
200000,56,179095.0,133333,666.66,20905,179095
400000,56,358737.0,200000,1000.0,41263,358737
600000,56,538685.0,200000,1000.0,61315,538685
800000,56,718777.0,200000,1000.0,81223,718777
1000000,56,898711.0,200000,1000.0,101289,898711
2,57,2.0,1,0.01,0,2
3,57,3.0,2,0.01,0,3
100,57,89.0,66,0.33,11,89
200,57,180.0,133,0.67,20,180
2000,57,1787.0,1333,6.66,213,1787
10000,57,8979.0,6666,33.33,1021,8979
20000,57,17949.0,13333,66.67,2051,17949
40000,57,35830.0,26666,133.33,4170,35830
60000,57,53719.0,40000,200.0,6281,53719
80000,57,71601.0,53333,266.66,8399,71601
100000,57,89523.0,66666,333.33,10477,89523
200000,57,179327.0,133333,666.66,20673,179327
400000,57,358918.0,200000,1000.0,41082,358918
600000,57,538734.0,200000,1000.0,61266,538734
800000,57,718677.0,200000,1000.0,81323,718677
1000000,57,898586.0,200000,1000.0,101414,898586
2,58,1.0,1,0.01,1,1
3,58,2.0,2,0.01,1,2
100,58,88.0,66,0.33,12,88
200,58,179.0,133,0.67,21,179
2000,58,1787.0,1333,6.66,213,1787
10000,58,8978.0,6666,33.33,1022,8978
20000,58,17945.0,13333,66.67,2055,17945
40000,58,35805.0,26666,133.33,4195,35805
60000,58,53790.0,40000,200.0,6210,53790
80000,58,71681.0,53333,266.66,8319,71681
100000,58,89576.0,66666,333.33,10424,89576
200000,58,179410.0,133333,666.66,20590,179410
400000,58,359175.0,200000,1000.0,40825,359175
600000,58,539240.0,200000,1000.0,60760,539240
800000,58,719239.0,200000,1000.0,80761,719239
1000000,58,899208.0,200000,1000.0,100792,899208
2,59,2.0,1,0.01,0,2
3,59,3.0,2,0.01,0,3
100,59,93.0,66,0.33,7,93
200,59,183.0,133,0.67,17,183
2000,59,1792.0,1333,6.66,208,1792
10000,59,8941.0,6666,33.33,1059,8941
20000,59,17939.0,13333,66.67,2061,17939
40000,59,35879.0,26666,133.33,4121,35879
60000,59,53723.0,40000,200.0,6277,53723
80000,59,71693.0,53333,266.66,8307,71693
100000,59,89589.0,66666,333.33,10411,89589
200000,59,179254.0,133333,666.66,20746,179254
400000,59,359127.0,200000,1000.0,40873,359127
600000,59,538996.0,200000,1000.0,61004,538996
800000,59,718727.0,200000,1000.0,81273,718727
1000000,59,898711.0,200000,1000.0,101289,898711
2,60,1.0,1,0.01,1,1
3,60,2.0,2,0.01,1,2
100,60,89.0,66,0.33,11,89
200,60,179.0,133,0.67,21,179
2000,60,1812.0,1333,6.66,188,1812
10000,60,8980.0,6666,33.33,1020,8980
20000,60,17907.0,13333,66.67,2093,17907
40000,60,35874.0,26666,133.33,4126,35874
60000,60,53805.0,40000,200.0,6195,53805
80000,60,71764.0,53333,266.66,8236,71764
100000,60,89642.0,66666,333.33,10358,89642
200000,60,179412.0,133333,666.66,20588,179412
400000,60,359158.0,200000,1000.0,40842,359158
600000,60,539450.0,200000,1000.0,60550,539450
800000,60,719576.0,200000,1000.0,80424,719576
1000000,60,899652.0,200000,1000.0,100348,899652
2,61,2.0,1,0.01,0,2
3,61,3.0,2,0.01,0,3
100,61,92.0,66,0.33,8,92
200,61,183.0,133,0.67,17,183
2000,61,1793.0,1333,6.66,207,1793
10000,61,8937.0,6666,33.33,1063,8937
20000,61,17914.0,13333,66.67,2086,17914
40000,61,35816.0,26666,133.33,4184,35816
60000,61,53779.0,40000,200.0,6221,53779
80000,61,71683.0,53333,266.66,8317,71683
100000,61,89589.0,66666,333.33,10411,89589
200000,61,179308.0,133333,666.66,20692,179308
400000,61,359109.0,200000,1000.0,40891,359109
600000,61,539106.0,200000,1000.0,60894,539106
800000,61,718854.0,200000,1000.0,81146,718854
1000000,61,898848.0,200000,1000.0,101152,898848
2,62,1.0,1,0.01,1,1
3,62,2.0,2,0.01,1,2
100,62,87.0,66,0.33,13,87
200,62,179.0,133,0.67,21,179
2000,62,1785.0,1333,6.66,215,1785
10000,62,8957.0,6666,33.33,1043,8957
20000,62,17981.0,13333,66.67,2019,17981
40000,62,35864.0,26666,133.33,4136,35864
60000,62,53749.0,40000,200.0,6251,53749
80000,62,71746.0,53333,266.66,8254,71746
100000,62,89742.0,66666,333.33,10258,89742
200000,62,179432.0,133333,666.66,20568,179432
400000,62,359179.0,200000,1000.0,40821,359179
600000,62,539088.0,200000,1000.0,60912,539088
800000,62,718979.0,200000,1000.0,81021,718979
1000000,62,899100.0,200000,1000.0,100900,899100
2,63,1.0,1,0.01,1,1
3,63,2.0,2,0.01,1,2
100,63,89.0,66,0.33,11,89
200,63,182.0,133,0.67,18,182
2000,63,1803.0,1333,6.66,197,1803
10000,63,8953.0,6666,33.33,1047,8953
20000,63,17923.0,13333,66.67,2077,17923
40000,63,35823.0,26666,133.33,4177,35823
60000,63,53806.0,40000,200.0,6194,53806
80000,63,71663.0,53333,266.66,8337,71663
100000,63,89628.0,66666,333.33,10372,89628
200000,63,179289.0,133333,666.66,20711,179289
400000,63,358896.0,200000,1000.0,41104,358896
600000,63,538810.0,200000,1000.0,61190,538810
800000,63,718617.0,200000,1000.0,81383,718617
1000000,63,898588.0,200000,1000.0,101412,898588
2,64,2.0,1,0.01,0,2
3,64,3.0,2,0.01,0,3
100,64,88.0,66,0.33,12,88
200,64,183.0,133,0.67,17,183
2000,64,1787.0,1333,6.66,213,1787
10000,64,8967.0,6666,33.33,1033,8967
20000,64,17918.0,13333,66.67,2082,17918
40000,64,35825.0,26666,133.33,4175,35825
60000,64,53714.0,40000,200.0,6286,53714
80000,64,71681.0,53333,266.66,8319,71681
100000,64,89570.0,66666,333.33,10430,89570
200000,64,179212.0,133333,666.66,20788,179212
400000,64,358954.0,200000,1000.0,41046,358954
600000,64,539064.0,200000,1000.0,60936,539064
800000,64,718947.0,200000,1000.0,81053,718947
1000000,64,898869.0,200000,1000.0,101131,898869
2,65,2.0,1,0.01,0,2
3,65,3.0,2,0.01,0,3
100,65,93.0,66,0.33,7,93
200,65,182.0,133,0.67,18,182
2000,65,1814.0,1333,6.66,186,1814
10000,65,9044.0,6666,33.33,956,9044
20000,65,17972.0,13333,66.67,2028,17972
40000,65,35875.0,26666,133.33,4125,35875
60000,65,53835.0,40000,200.0,6165,53835
80000,65,71691.0,53333,266.66,8309,71691
100000,65,89559.0,66666,333.33,10441,89559
200000,65,179076.0,133333,666.66,20924,179076
400000,65,358635.0,200000,1000.0,41365,358635
600000,65,538648.0,200000,1000.0,61352,538648
800000,65,718596.0,200000,1000.0,81404,718596
1000000,65,898658.0,200000,1000.0,101342,898658
2,66,2.0,1,0.01,0,2
3,66,3.0,2,0.01,0,3
100,66,87.0,66,0.33,13,87
200,66,174.0,133,0.67,26,174
2000,66,1789.0,1333,6.66,211,1789
10000,66,8939.0,6666,33.33,1061,8939
20000,66,17897.0,13333,66.67,2103,17897
40000,66,35807.0,26666,133.33,4193,35807
60000,66,53755.0,40000,200.0,6245,53755
80000,66,71661.0,53333,266.66,8339,71661
100000,66,89633.0,66666,333.33,10367,89633
200000,66,179134.0,133333,666.66,20866,179134
400000,66,358915.0,200000,1000.0,41085,358915
600000,66,539028.0,200000,1000.0,60972,539028
800000,66,718865.0,200000,1000.0,81135,718865
1000000,66,898797.0,200000,1000.0,101203,898797
2,67,1.0,1,0.01,1,1
3,67,2.0,2,0.01,1,2
100,67,91.0,66,0.33,9,91
200,67,180.0,133,0.67,20,180
2000,67,1782.0,1333,6.66,218,1782
10000,67,8954.0,6666,33.33,1046,8954
20000,67,17973.0,13333,66.67,2027,17973
40000,67,35958.0,26666,133.33,4042,35958
60000,67,53831.0,40000,200.0,6169,53831
80000,67,71690.0,53333,266.66,8310,71690
100000,67,89616.0,66666,333.33,10384,89616
200000,67,179241.0,133333,666.66,20759,179241
400000,67,358795.0,200000,1000.0,41205,358795
600000,67,539089.0,200000,1000.0,60911,539089
800000,67,718645.0,200000,1000.0,81355,718645
1000000,67,898667.0,200000,1000.0,101333,898667
2,68,2.0,1,0.01,0,2
3,68,3.0,2,0.01,0,3
100,68,90.0,66,0.33,10,90
200,68,174.0,133,0.67,26,174
2000,68,1782.0,1333,6.66,218,1782
10000,68,8977.0,6666,33.33,1023,8977
20000,68,17917.0,13333,66.67,2083,17917
40000,68,35743.0,26666,133.33,4257,35743
60000,68,53651.0,40000,200.0,6349,53651
80000,68,71567.0,53333,266.66,8433,71567
100000,68,89563.0,66666,333.33,10437,89563
200000,68,179121.0,133333,666.66,20879,179121
400000,68,358817.0,200000,1000.0,41183,358817
600000,68,538795.0,200000,1000.0,61205,538795
800000,68,718888.0,200000,1000.0,81112,718888
1000000,68,898924.0,200000,1000.0,101076,898924
2,69,2.0,1,0.01,0,2
3,69,3.0,2,0.01,0,3
100,69,89.0,66,0.33,11,89
200,69,175.0,133,0.67,25,175
2000,69,1801.0,1333,6.66,199,1801
10000,69,8978.0,6666,33.33,1022,8978
20000,69,17910.0,13333,66.67,2090,17910
40000,69,35933.0,26666,133.33,4067,35933
60000,69,53908.0,40000,200.0,6092,53908
80000,69,71835.0,53333,266.66,8165,71835
100000,69,89827.0,66666,333.33,10173,89827
200000,69,179643.0,133333,666.66,20357,179643
400000,69,359160.0,200000,1000.0,40840,359160
600000,69,539080.0,200000,1000.0,60920,539080
800000,69,718909.0,200000,1000.0,81091,718909
1000000,69,898859.0,200000,1000.0,101141,898859
2,70,2.0,1,0.01,0,2
3,70,3.0,2,0.01,0,3
100,70,93.0,66,0.33,7,93
200,70,182.0,133,0.67,18,182
2000,70,1798.0,1333,6.66,202,1798
10000,70,8987.0,6666,33.33,1013,8987
20000,70,17952.0,13333,66.67,2048,17952
40000,70,35969.0,26666,133.33,4031,35969
60000,70,53952.0,40000,200.0,6048,53952
80000,70,71918.0,53333,266.66,8082,71918
100000,70,89843.0,66666,333.33,10157,89843
200000,70,179703.0,133333,666.66,20297,179703
400000,70,359557.0,200000,1000.0,40443,359557
600000,70,539421.0,200000,1000.0,60579,539421
800000,70,719399.0,200000,1000.0,80601,719399
1000000,70,899354.0,200000,1000.0,100646,899354
2,71,2.0,1,0.01,0,2
3,71,3.0,2,0.01,0,3
100,71,85.0,66,0.33,15,85
200,71,178.0,133,0.67,22,178
2000,71,1812.0,1333,6.66,188,1812
10000,71,8982.0,6666,33.33,1018,8982
20000,71,17919.0,13333,66.67,2081,17919
40000,71,35824.0,26666,133.33,4176,35824
60000,71,53780.0,40000,200.0,6220,53780
80000,71,71703.0,53333,266.66,8297,71703
100000,71,89611.0,66666,333.33,10389,89611
200000,71,179231.0,133333,666.66,20769,179231
400000,71,359179.0,200000,1000.0,40821,359179
600000,71,539185.0,200000,1000.0,60815,539185
800000,71,719094.0,200000,1000.0,80906,719094
1000000,71,898989.0,200000,1000.0,101011,898989
2,72,2.0,1,0.01,0,2
3,72,3.0,2,0.01,0,3
100,72,90.0,66,0.33,10,90
200,72,179.0,133,0.67,21,179
2000,72,1765.0,1333,6.66,235,1765
10000,72,8948.0,6666,33.33,1052,8948
20000,72,17935.0,13333,66.67,2065,17935
40000,72,35908.0,26666,133.33,4092,35908
60000,72,53906.0,40000,200.0,6094,53906
80000,72,71866.0,53333,266.66,8134,71866
100000,72,89743.0,66666,333.33,10257,89743
200000,72,179388.0,133333,666.66,20612,179388
400000,72,358796.0,200000,1000.0,41204,358796
600000,72,538660.0,200000,1000.0,61340,538660
800000,72,718684.0,200000,1000.0,81316,718684
1000000,72,898688.0,200000,1000.0,101312,898688
2,73,2.0,1,0.01,0,2
3,73,3.0,2,0.01,0,3
100,73,90.0,66,0.33,10,90
200,73,180.0,133,0.67,20,180
2000,73,1797.0,1333,6.66,203,1797
10000,73,8957.0,6666,33.33,1043,8957
20000,73,17956.0,13333,66.67,2044,17956
40000,73,35882.0,26666,133.33,4118,35882
60000,73,53803.0,40000,200.0,6197,53803
80000,73,71742.0,53333,266.66,8258,71742
100000,73,89691.0,66666,333.33,10309,89691
200000,73,179393.0,133333,666.66,20607,179393
400000,73,359057.0,200000,1000.0,40943,359057
600000,73,538886.0,200000,1000.0,61114,538886
800000,73,718927.0,200000,1000.0,81073,718927
1000000,73,899150.0,200000,1000.0,100850,899150
2,74,2.0,1,0.01,0,2
3,74,3.0,2,0.01,0,3
100,74,91.0,66,0.33,9,91
200,74,181.0,133,0.67,19,181
2000,74,1770.0,1333,6.66,230,1770
10000,74,8963.0,6666,33.33,1037,8963
20000,74,17984.0,13333,66.67,2016,17984
40000,74,35890.0,26666,133.33,4110,35890
60000,74,53851.0,40000,200.0,6149,53851
80000,74,71806.0,53333,266.66,8194,71806
100000,74,89765.0,66666,333.33,10235,89765
200000,74,179463.0,133333,666.66,20537,179463
400000,74,358933.0,200000,1000.0,41067,358933
600000,74,538665.0,200000,1000.0,61335,538665
800000,74,718774.0,200000,1000.0,81226,718774
1000000,74,898788.0,200000,1000.0,101212,898788
2,75,2.0,1,0.01,0,2
3,75,3.0,2,0.01,0,3
100,75,91.0,66,0.33,9,91
200,75,181.0,133,0.67,19,181
2000,75,1820.0,1333,6.66,180,1820
10000,75,8989.0,6666,33.33,1011,8989
20000,75,18000.0,13333,66.67,2000,18000
40000,75,35863.0,26666,133.33,4137,35863
60000,75,53805.0,40000,200.0,6195,53805
80000,75,71729.0,53333,266.66,8271,71729
100000,75,89698.0,66666,333.33,10302,89698
200000,75,179328.0,133333,666.66,20672,179328
400000,75,358691.0,200000,1000.0,41309,358691
600000,75,538794.0,200000,1000.0,61206,538794
800000,75,718641.0,200000,1000.0,81359,718641
1000000,75,899056.0,200000,1000.0,100944,899056
2,76,2.0,1,0.01,0,2
3,76,3.0,2,0.01,0,3
100,76,90.0,66,0.33,10,90
200,76,177.0,133,0.67,23,177
2000,76,1790.0,1333,6.66,210,1790
10000,76,8957.0,6666,33.33,1043,8957
20000,76,17950.0,13333,66.67,2050,17950
40000,76,35898.0,26666,133.33,4102,35898
60000,76,53867.0,40000,200.0,6133,53867
80000,76,71810.0,53333,266.66,8190,71810
100000,76,89713.0,66666,333.33,10287,89713
200000,76,179311.0,133333,666.66,20689,179311
400000,76,359019.0,200000,1000.0,40981,359019
600000,76,538915.0,200000,1000.0,61085,538915
800000,76,718953.0,200000,1000.0,81047,718953
1000000,76,898856.0,200000,1000.0,101144,898856
2,77,1.0,1,0.01,1,1
3,77,2.0,2,0.01,1,2
100,77,89.0,66,0.33,11,89
200,77,177.0,133,0.67,23,177
2000,77,1772.0,1333,6.66,228,1772
10000,77,8951.0,6666,33.33,1049,8951
20000,77,18008.0,13333,66.67,1992,18008
40000,77,35924.0,26666,133.33,4076,35924
60000,77,53770.0,40000,200.0,6230,53770
80000,77,71761.0,53333,266.66,8239,71761
100000,77,89711.0,66666,333.33,10289,89711
200000,77,179444.0,133333,666.66,20556,179444
400000,77,359184.0,200000,1000.0,40816,359184
600000,77,539307.0,200000,1000.0,60693,539307
800000,77,719231.0,200000,1000.0,80769,719231
1000000,77,899189.0,200000,1000.0,100811,899189
2,78,2.0,1,0.01,0,2
3,78,2.0,2,0.01,1,2
100,78,92.0,66,0.33,8,92
200,78,184.0,133,0.67,16,184
2000,78,1800.0,1333,6.66,200,1800
10000,78,8961.0,6666,33.33,1039,8961
20000,78,17997.0,13333,66.67,2003,17997
40000,78,35907.0,26666,133.33,4093,35907
60000,78,53855.0,40000,200.0,6145,53855
80000,78,71770.0,53333,266.66,8230,71770
100000,78,89722.0,66666,333.33,10278,89722
200000,78,179418.0,133333,666.66,20582,179418
400000,78,359245.0,200000,1000.0,40755,359245
600000,78,539281.0,200000,1000.0,60719,539281
800000,78,719006.0,200000,1000.0,80994,719006
1000000,78,898770.0,200000,1000.0,101230,898770
2,79,2.0,1,0.01,0,2
3,79,3.0,2,0.01,0,3
100,79,90.0,66,0.33,10,90
200,79,181.0,133,0.67,19,181
2000,79,1800.0,1333,6.66,200,1800
10000,79,8935.0,6666,33.33,1065,8935
20000,79,17937.0,13333,66.67,2063,17937
40000,79,35817.0,26666,133.33,4183,35817
60000,79,53738.0,40000,200.0,6262,53738
80000,79,71676.0,53333,266.66,8324,71676
100000,79,89632.0,66666,333.33,10368,89632
200000,79,179217.0,133333,666.66,20783,179217
400000,79,358998.0,200000,1000.0,41002,358998
600000,79,538792.0,200000,1000.0,61208,538792
800000,79,718757.0,200000,1000.0,81243,718757
1000000,79,898846.0,200000,1000.0,101154,898846
2,80,2.0,1,0.01,0,2
3,80,3.0,2,0.01,0,3
100,80,94.0,66,0.33,6,94
200,80,183.0,133,0.67,17,183
2000,80,1789.0,1333,6.66,211,1789
10000,80,8961.0,6666,33.33,1039,8961
20000,80,17917.0,13333,66.67,2083,17917
40000,80,35825.0,26666,133.33,4175,35825
60000,80,53733.0,40000,200.0,6267,53733
80000,80,71583.0,53333,266.66,8417,71583
100000,80,89549.0,66666,333.33,10451,89549
200000,80,179312.0,133333,666.66,20688,179312
400000,80,359015.0,200000,1000.0,40985,359015
600000,80,538947.0,200000,1000.0,61053,538947
800000,80,719039.0,200000,1000.0,80961,719039
1000000,80,898900.0,200000,1000.0,101100,898900
2,81,2.0,1,0.01,0,2
3,81,3.0,2,0.01,0,3
100,81,89.0,66,0.33,11,89
200,81,182.0,133,0.67,18,182
2000,81,1810.0,1333,6.66,190,1810
10000,81,8929.0,6666,33.33,1071,8929
20000,81,17853.0,13333,66.67,2147,17853
40000,81,35750.0,26666,133.33,4250,35750
60000,81,53683.0,40000,200.0,6317,53683
80000,81,71596.0,53333,266.66,8404,71596
100000,81,89448.0,66666,333.33,10552,89448
200000,81,179015.0,133333,666.66,20985,179015
400000,81,358813.0,200000,1000.0,41187,358813
600000,81,538728.0,200000,1000.0,61272,538728
800000,81,718663.0,200000,1000.0,81337,718663
1000000,81,898354.0,200000,1000.0,101646,898354
2,82,2.0,1,0.01,0,2
3,82,3.0,2,0.01,0,3
100,82,88.0,66,0.33,12,88
200,82,180.0,133,0.67,20,180
2000,82,1823.0,1333,6.66,177,1823
10000,82,8996.0,6666,33.33,1004,8996
20000,82,17957.0,13333,66.67,2043,17957
40000,82,35894.0,26666,133.33,4106,35894
60000,82,53843.0,40000,200.0,6157,53843
80000,82,71790.0,53333,266.66,8210,71790
100000,82,89725.0,66666,333.33,10275,89725
200000,82,179440.0,133333,666.66,20560,179440
400000,82,359063.0,200000,1000.0,40937,359063
600000,82,538889.0,200000,1000.0,61111,538889
800000,82,718850.0,200000,1000.0,81150,718850
1000000,82,899116.0,200000,1000.0,100884,899116
2,83,2.0,1,0.01,0,2
3,83,3.0,2,0.01,0,3
100,83,90.0,66,0.33,10,90
200,83,182.0,133,0.67,18,182
2000,83,1794.0,1333,6.66,206,1794
10000,83,8941.0,6666,33.33,1059,8941
20000,83,17908.0,13333,66.67,2092,17908
40000,83,35857.0,26666,133.33,4143,35857
60000,83,53820.0,40000,200.0,6180,53820
80000,83,71854.0,53333,266.66,8146,71854
100000,83,89786.0,66666,333.33,10214,89786
200000,83,179651.0,133333,666.66,20349,179651
400000,83,359276.0,200000,1000.0,40724,359276
600000,83,539491.0,200000,1000.0,60509,539491
800000,83,719644.0,200000,1000.0,80356,719644
1000000,83,899893.0,200000,1000.0,100107,899893
2,84,2.0,1,0.01,0,2
3,84,3.0,2,0.01,0,3
100,84,93.0,66,0.33,7,93
200,84,183.0,133,0.67,17,183
2000,84,1784.0,1333,6.66,216,1784
10000,84,8930.0,6666,33.33,1070,8930
20000,84,17892.0,13333,66.67,2108,17892
40000,84,35885.0,26666,133.33,4115,35885
60000,84,53869.0,40000,200.0,6131,53869
80000,84,71766.0,53333,266.66,8234,71766
100000,84,89630.0,66666,333.33,10370,89630
200000,84,179180.0,133333,666.66,20820,179180
400000,84,358641.0,200000,1000.0,41359,358641
600000,84,538693.0,200000,1000.0,61307,538693
800000,84,718595.0,200000,1000.0,81405,718595
1000000,84,898811.0,200000,1000.0,101189,898811
2,85,2.0,1,0.01,0,2
3,85,2.0,2,0.01,1,2
100,85,89.0,66,0.33,11,89
200,85,177.0,133,0.67,23,177
2000,85,1811.0,1333,6.66,189,1811
10000,85,8978.0,6666,33.33,1022,8978
20000,85,17987.0,13333,66.67,2013,17987
40000,85,35923.0,26666,133.33,4077,35923
60000,85,53819.0,40000,200.0,6181,53819
80000,85,71827.0,53333,266.66,8173,71827
100000,85,89794.0,66666,333.33,10206,89794
200000,85,179323.0,133333,666.66,20677,179323
400000,85,359031.0,200000,1000.0,40969,359031
600000,85,538799.0,200000,1000.0,61201,538799
800000,85,718745.0,200000,1000.0,81255,718745
1000000,85,898955.0,200000,1000.0,101045,898955
2,86,2.0,1,0.01,0,2
3,86,3.0,2,0.01,0,3
100,86,91.0,66,0.33,9,91
200,86,181.0,133,0.67,19,181
2000,86,1795.0,1333,6.66,205,1795
10000,86,8938.0,6666,33.33,1062,8938
20000,86,17848.0,13333,66.67,2152,17848
40000,86,35795.0,26666,133.33,4205,35795
60000,86,53769.0,40000,200.0,6231,53769
80000,86,71599.0,53333,266.66,8401,71599
100000,86,89586.0,66666,333.33,10414,89586
200000,86,179221.0,133333,666.66,20779,179221
400000,86,358637.0,200000,1000.0,41363,358637
600000,86,538639.0,200000,1000.0,61361,538639
800000,86,718630.0,200000,1000.0,81370,718630
1000000,86,898684.0,200000,1000.0,101316,898684
2,87,2.0,1,0.01,0,2
3,87,3.0,2,0.01,0,3
100,87,86.0,66,0.33,14,86
200,87,172.0,133,0.67,28,172
2000,87,1781.0,1333,6.66,219,1781
10000,87,8926.0,6666,33.33,1074,8926
20000,87,17841.0,13333,66.67,2159,17841
40000,87,35758.0,26666,133.33,4242,35758
60000,87,53694.0,40000,200.0,6306,53694
80000,87,71595.0,53333,266.66,8405,71595
100000,87,89566.0,66666,333.33,10434,89566
200000,87,179314.0,133333,666.66,20686,179314
400000,87,359048.0,200000,1000.0,40952,359048
600000,87,539233.0,200000,1000.0,60767,539233
800000,87,719304.0,200000,1000.0,80696,719304
1000000,87,899088.0,200000,1000.0,100912,899088
2,88,2.0,1,0.01,0,2
3,88,3.0,2,0.01,0,3
100,88,96.0,66,0.33,4,96
200,88,192.0,133,0.67,8,192
2000,88,1804.0,1333,6.66,196,1804
10000,88,8982.0,6666,33.33,1018,8982
20000,88,18000.0,13333,66.67,2000,18000
40000,88,35909.0,26666,133.33,4091,35909
60000,88,53803.0,40000,200.0,6197,53803
80000,88,71782.0,53333,266.66,8218,71782
100000,88,89664.0,66666,333.33,10336,89664
200000,88,179290.0,133333,666.66,20710,179290
400000,88,358893.0,200000,1000.0,41107,358893
600000,88,538690.0,200000,1000.0,61310,538690
800000,88,718660.0,200000,1000.0,81340,718660
1000000,88,898730.0,200000,1000.0,101270,898730
2,89,2.0,1,0.01,0,2
3,89,3.0,2,0.01,0,3
100,89,91.0,66,0.33,9,91
200,89,180.0,133,0.67,20,180
2000,89,1795.0,1333,6.66,205,1795
10000,89,8955.0,6666,33.33,1045,8955
20000,89,17933.0,13333,66.67,2067,17933
40000,89,35884.0,26666,133.33,4116,35884
60000,89,53786.0,40000,200.0,6214,53786
80000,89,71743.0,53333,266.66,8257,71743
100000,89,89632.0,66666,333.33,10368,89632
200000,89,179283.0,133333,666.66,20717,179283
400000,89,358994.0,200000,1000.0,41006,358994
600000,89,539056.0,200000,1000.0,60944,539056
800000,89,719073.0,200000,1000.0,80927,719073
1000000,89,898998.0,200000,1000.0,101002,898998
2,90,2.0,1,0.01,0,2
3,90,2.0,2,0.01,1,2
100,90,92.0,66,0.33,8,92
200,90,181.0,133,0.67,19,181
2000,90,1793.0,1333,6.66,207,1793
10000,90,8925.0,6666,33.33,1075,8925
20000,90,17936.0,13333,66.67,2064,17936
40000,90,35955.0,26666,133.33,4045,35955
60000,90,53908.0,40000,200.0,6092,53908
80000,90,71815.0,53333,266.66,8185,71815
100000,90,89748.0,66666,333.33,10252,89748
200000,90,179603.0,133333,666.66,20397,179603
400000,90,359361.0,200000,1000.0,40639,359361
600000,90,539456.0,200000,1000.0,60544,539456
800000,90,719576.0,200000,1000.0,80424,719576
1000000,90,899658.0,200000,1000.0,100342,899658
2,91,2.0,1,0.01,0,2
3,91,3.0,2,0.01,0,3
100,91,91.0,66,0.33,9,91
200,91,178.0,133,0.67,22,178
2000,91,1778.0,1333,6.66,222,1778
10000,91,8946.0,6666,33.33,1054,8946
20000,91,17939.0,13333,66.67,2061,17939
40000,91,35908.0,26666,133.33,4092,35908
60000,91,53897.0,40000,200.0,6103,53897
80000,91,71740.0,53333,266.66,8260,71740
100000,91,89644.0,66666,333.33,10356,89644
200000,91,179308.0,133333,666.66,20692,179308
400000,91,358856.0,200000,1000.0,41144,358856
600000,91,538983.0,200000,1000.0,61017,538983
800000,91,718874.0,200000,1000.0,81126,718874
1000000,91,898784.0,200000,1000.0,101216,898784
2,92,2.0,1,0.01,0,2
3,92,3.0,2,0.01,0,3
100,92,92.0,66,0.33,8,92
200,92,180.0,133,0.67,20,180
2000,92,1792.0,1333,6.66,208,1792
10000,92,8974.0,6666,33.33,1026,8974
20000,92,17921.0,13333,66.67,2079,17921
40000,92,35832.0,26666,133.33,4168,35832
60000,92,53803.0,40000,200.0,6197,53803
80000,92,71722.0,53333,266.66,8278,71722
100000,92,89644.0,66666,333.33,10356,89644
200000,92,179195.0,133333,666.66,20805,179195
400000,92,358800.0,200000,1000.0,41200,358800
600000,92,538955.0,200000,1000.0,61045,538955
800000,92,719032.0,200000,1000.0,80968,719032
1000000,92,898924.0,200000,1000.0,101076,898924
2,93,1.0,1,0.01,1,1
3,93,2.0,2,0.01,1,2
100,93,93.0,66,0.33,7,93
200,93,185.0,133,0.67,15,185
2000,93,1809.0,1333,6.66,191,1809
10000,93,8970.0,6666,33.33,1030,8970
20000,93,17995.0,13333,66.67,2005,17995
40000,93,35917.0,26666,133.33,4083,35917
60000,93,53817.0,40000,200.0,6183,53817
80000,93,71751.0,53333,266.66,8249,71751
100000,93,89699.0,66666,333.33,10301,89699
200000,93,179390.0,133333,666.66,20610,179390
400000,93,358959.0,200000,1000.0,41041,358959
600000,93,539089.0,200000,1000.0,60911,539089
800000,93,719307.0,200000,1000.0,80693,719307
1000000,93,899425.0,200000,1000.0,100575,899425
2,94,2.0,1,0.01,0,2
3,94,3.0,2,0.01,0,3
100,94,89.0,66,0.33,11,89
200,94,182.0,133,0.67,18,182
2000,94,1801.0,1333,6.66,199,1801
10000,94,9005.0,6666,33.33,995,9005
20000,94,17941.0,13333,66.67,2059,17941
40000,94,35770.0,26666,133.33,4230,35770
60000,94,53736.0,40000,200.0,6264,53736
80000,94,71578.0,53333,266.66,8422,71578
100000,94,89575.0,66666,333.33,10425,89575
200000,94,179343.0,133333,666.66,20657,179343
400000,94,358881.0,200000,1000.0,41119,358881
600000,94,538886.0,200000,1000.0,61114,538886
800000,94,718750.0,200000,1000.0,81250,718750
1000000,94,898499.0,200000,1000.0,101501,898499
2,95,2.0,1,0.01,0,2
3,95,3.0,2,0.01,0,3
100,95,91.0,66,0.33,9,91
200,95,174.0,133,0.67,26,174
2000,95,1781.0,1333,6.66,219,1781
10000,95,8959.0,6666,33.33,1041,8959
20000,95,17878.0,13333,66.67,2122,17878
40000,95,35825.0,26666,133.33,4175,35825
60000,95,53749.0,40000,200.0,6251,53749
80000,95,71669.0,53333,266.66,8331,71669
100000,95,89646.0,66666,333.33,10354,89646
200000,95,179230.0,133333,666.66,20770,179230
400000,95,359022.0,200000,1000.0,40978,359022
600000,95,538852.0,200000,1000.0,61148,538852
800000,95,718940.0,200000,1000.0,81060,718940
1000000,95,899088.0,200000,1000.0,100912,899088
2,96,2.0,1,0.01,0,2
3,96,3.0,2,0.01,0,3
100,96,88.0,66,0.33,12,88
200,96,178.0,133,0.67,22,178
2000,96,1789.0,1333,6.66,211,1789
10000,96,8941.0,6666,33.33,1059,8941
20000,96,17890.0,13333,66.67,2110,17890
40000,96,35846.0,26666,133.33,4154,35846
60000,96,53808.0,40000,200.0,6192,53808
80000,96,71778.0,53333,266.66,8222,71778
100000,96,89616.0,66666,333.33,10384,89616
200000,96,179354.0,133333,666.66,20646,179354
400000,96,358923.0,200000,1000.0,41077,358923
600000,96,538991.0,200000,1000.0,61009,538991
800000,96,718966.0,200000,1000.0,81034,718966
1000000,96,898902.0,200000,1000.0,101098,898902
2,97,2.0,1,0.01,0,2
3,97,3.0,2,0.01,0,3
100,97,94.0,66,0.33,6,94
200,97,177.0,133,0.67,23,177
2000,97,1805.0,1333,6.66,195,1805
10000,97,8960.0,6666,33.33,1040,8960
20000,97,17906.0,13333,66.67,2094,17906
40000,97,35871.0,26666,133.33,4129,35871
60000,97,53812.0,40000,200.0,6188,53812
80000,97,71698.0,53333,266.66,8302,71698
100000,97,89628.0,66666,333.33,10372,89628
200000,97,179196.0,133333,666.66,20804,179196
400000,97,359142.0,200000,1000.0,40858,359142
600000,97,539210.0,200000,1000.0,60790,539210
800000,97,719044.0,200000,1000.0,80956,719044
1000000,97,898904.0,200000,1000.0,101096,898904
2,98,2.0,1,0.01,0,2
3,98,3.0,2,0.01,0,3
100,98,94.0,66,0.33,6,94
200,98,182.0,133,0.67,18,182
2000,98,1785.0,1333,6.66,215,1785
10000,98,8937.0,6666,33.33,1063,8937
20000,98,17881.0,13333,66.67,2119,17881
40000,98,35884.0,26666,133.33,4116,35884
60000,98,53757.0,40000,200.0,6243,53757
80000,98,71755.0,53333,266.66,8245,71755
100000,98,89629.0,66666,333.33,10371,89629
200000,98,179284.0,133333,666.66,20716,179284
400000,98,358957.0,200000,1000.0,41043,358957
600000,98,539124.0,200000,1000.0,60876,539124
800000,98,719090.0,200000,1000.0,80910,719090
1000000,98,899145.0,200000,1000.0,100855,899145
2,99,1.0,1,0.01,1,1
3,99,2.0,2,0.01,1,2
100,99,86.0,66,0.33,14,86
200,99,176.0,133,0.67,24,176
2000,99,1788.0,1333,6.66,212,1788
10000,99,9024.0,6666,33.33,976,9024
20000,99,17946.0,13333,66.67,2054,17946
40000,99,35924.0,26666,133.33,4076,35924
60000,99,53915.0,40000,200.0,6085,53915
80000,99,71821.0,53333,266.66,8179,71821
100000,99,89753.0,66666,333.33,10247,89753
200000,99,179341.0,133333,666.66,20659,179341
400000,99,358751.0,200000,1000.0,41249,358751
600000,99,538568.0,200000,1000.0,61432,538568
800000,99,718820.0,200000,1000.0,81180,718820
1000000,99,898882.0,200000,1000.0,101118,898882
2,100,2.0,1,0.01,0,2
3,100,3.0,2,0.01,0,3
100,100,95.0,66,0.33,5,95
200,100,183.0,133,0.67,17,183
2000,100,1792.0,1333,6.66,208,1792
10000,100,8973.0,6666,33.33,1027,8973
20000,100,17899.0,13333,66.67,2101,17899
40000,100,35932.0,26666,133.33,4068,35932
60000,100,53852.0,40000,200.0,6148,53852
80000,100,71760.0,53333,266.66,8240,71760
100000,100,89633.0,66666,333.33,10367,89633
200000,100,179265.0,133333,666.66,20735,179265
400000,100,358678.0,200000,1000.0,41322,358678
600000,100,538625.0,200000,1000.0,61375,538625
800000,100,718630.0,200000,1000.0,81370,718630
1000000,100,898548.0,200000,1000.0,101452,898548
