Timestep,Iteration,Total Reward,Suboptimal Arms,Total Regret,Zeros Count,Ones Count
2,1,2.0,1,0.04,0,2
3,1,2.0,2,0.08,1,2
100,1,84.0,66,2.64,16,84
200,1,169.0,133,5.32,31,169
2000,1,1708.0,1333,53.32,292,1708
10000,1,8780.0,2000,80.0,1220,8780
20000,1,17695.0,2000,80.0,2305,17695
40000,1,35502.0,2000,80.0,4498,35502
60000,1,53290.0,2000,80.0,6710,53290
80000,1,71136.0,2000,80.0,8864,71136
100000,1,88959.0,2000,80.0,11041,88959
200000,1,177949.0,2000,80.0,22051,177949
400000,1,355853.0,2000,80.0,44147,355853
600000,1,533872.0,2000,80.0,66128,533872
800000,1,711939.0,2000,80.0,88061,711939
1000000,1,889831.0,2000,80.0,110169,889831
2,2,2.0,1,0.04,0,2
3,2,3.0,2,0.08,0,3
100,2,87.0,66,2.64,13,87
200,2,175.0,133,5.32,25,175
2000,2,1733.0,1333,53.32,267,1733
10000,2,8801.0,2000,80.0,1199,8801
20000,2,17696.0,2000,80.0,2304,17696
40000,2,35486.0,2000,80.0,4514,35486
60000,2,53261.0,2000,80.0,6739,53261
80000,2,71177.0,2000,80.0,8823,71177
100000,2,89005.0,2000,80.0,10995,89005
200000,2,177964.0,2000,80.0,22036,177964
400000,2,355831.0,2000,80.0,44169,355831
600000,2,533720.0,2000,80.0,66280,533720
800000,2,711879.0,2000,80.0,88121,711879
1000000,2,889992.0,2000,80.0,110008,889992
2,3,2.0,1,0.04,0,2
3,3,2.0,2,0.08,1,2
100,3,82.0,66,2.64,18,82
200,3,169.0,133,5.32,31,169
2000,3,1732.0,1333,53.32,268,1732
10000,3,8803.0,2000,80.0,1197,8803
20000,3,17691.0,2000,80.0,2309,17691
40000,3,35466.0,2000,80.0,4534,35466
60000,3,53238.0,2000,80.0,6762,53238
80000,3,71038.0,2000,80.0,8962,71038
100000,3,88784.0,2000,80.0,11216,88784
200000,3,177851.0,2000,80.0,22149,177851
400000,3,355834.0,2000,80.0,44166,355834
600000,3,533878.0,2000,80.0,66122,533878
800000,3,711935.0,2000,80.0,88065,711935
1000000,3,889825.0,2000,80.0,110175,889825
2,4,1.0,1,0.04,1,1
3,4,2.0,2,0.08,1,2
100,4,87.0,66,2.64,13,87
200,4,177.0,133,5.32,23,177
2000,4,1714.0,1333,53.32,286,1714
10000,4,8777.0,2000,80.0,1223,8777
20000,4,17665.0,2000,80.0,2335,17665
40000,4,35489.0,2000,80.0,4511,35489
60000,4,53236.0,2000,80.0,6764,53236
80000,4,71050.0,2000,80.0,8950,71050
100000,4,88906.0,2000,80.0,11094,88906
200000,4,177695.0,2000,80.0,22305,177695
400000,4,355922.0,2000,80.0,44078,355922
600000,4,533664.0,2000,80.0,66336,533664
800000,4,711858.0,2000,80.0,88142,711858
1000000,4,889746.0,2000,80.0,110254,889746
2,5,1.0,1,0.04,1,1
3,5,2.0,2,0.08,1,2
100,5,84.0,66,2.64,16,84
200,5,166.0,133,5.32,34,166
2000,5,1724.0,1333,53.32,276,1724
10000,5,8789.0,2000,80.0,1211,8789
20000,5,17655.0,2000,80.0,2345,17655
40000,5,35509.0,2000,80.0,4491,35509
60000,5,53324.0,2000,80.0,6676,53324
80000,5,71194.0,2000,80.0,8806,71194
100000,5,88999.0,2000,80.0,11001,88999
200000,5,178005.0,2000,80.0,21995,178005
400000,5,356202.0,2000,80.0,43798,356202
600000,5,534228.0,2000,80.0,65772,534228
800000,5,712242.0,2000,80.0,87758,712242
1000000,5,890370.0,2000,80.0,109630,890370
2,6,2.0,1,0.04,0,2
3,6,3.0,2,0.08,0,3
100,6,86.0,66,2.64,14,86
200,6,171.0,133,5.32,29,171
2000,6,1731.0,1333,53.32,269,1731
10000,6,8824.0,2000,80.0,1176,8824
20000,6,17754.0,2000,80.0,2246,17754
40000,6,35544.0,2000,80.0,4456,35544
60000,6,53302.0,2000,80.0,6698,53302
80000,6,71095.0,2000,80.0,8905,71095
100000,6,88888.0,2000,80.0,11112,88888
200000,6,178072.0,2000,80.0,21928,178072
400000,6,356102.0,2000,80.0,43898,356102
600000,6,534164.0,2000,80.0,65836,534164
800000,6,711992.0,2000,80.0,88008,711992
1000000,6,890042.0,2000,80.0,109958,890042
2,7,2.0,1,0.04,0,2
3,7,3.0,2,0.08,0,3
100,7,86.0,66,2.64,14,86
200,7,177.0,133,5.32,23,177
2000,7,1733.0,1333,53.32,267,1733
10000,7,8845.0,2000,80.0,1155,8845
20000,7,17769.0,2000,80.0,2231,17769
40000,7,35625.0,2000,80.0,4375,35625
60000,7,53410.0,2000,80.0,6590,53410
80000,7,71203.0,2000,80.0,8797,71203
100000,7,89087.0,2000,80.0,10913,89087
200000,7,178163.0,2000,80.0,21837,178163
400000,7,356054.0,2000,80.0,43946,356054
600000,7,534044.0,2000,80.0,65956,534044
800000,7,711997.0,2000,80.0,88003,711997
1000000,7,889895.0,2000,80.0,110105,889895
2,8,2.0,1,0.04,0,2
3,8,3.0,2,0.08,0,3
100,8,92.0,66,2.64,8,92
200,8,178.0,133,5.32,22,178
2000,8,1744.0,1333,53.32,256,1744
10000,8,8801.0,2000,80.0,1199,8801
20000,8,17770.0,2000,80.0,2230,17770
40000,8,35617.0,2000,80.0,4383,35617
60000,8,53498.0,2000,80.0,6502,53498
80000,8,71306.0,2000,80.0,8694,71306
100000,8,89140.0,2000,80.0,10860,89140
200000,8,178001.0,2000,80.0,21999,178001
400000,8,355754.0,2000,80.0,44246,355754
600000,8,533669.0,2000,80.0,66331,533669
800000,8,711680.0,2000,80.0,88320,711680
1000000,8,889552.0,2000,80.0,110448,889552
2,9,2.0,1,0.04,0,2
3,9,2.0,2,0.08,1,2
100,9,89.0,66,2.64,11,89
200,9,175.0,133,5.32,25,175
2000,9,1748.0,1333,53.32,252,1748
10000,9,8904.0,2000,80.0,1096,8904
20000,9,17822.0,2000,80.0,2178,17822
40000,9,35639.0,2000,80.0,4361,35639
60000,9,53495.0,2000,80.0,6505,53495
80000,9,71351.0,2000,80.0,8649,71351
100000,9,89153.0,2000,80.0,10847,89153
200000,9,178095.0,2000,80.0,21905,178095
400000,9,356177.0,2000,80.0,43823,356177
600000,9,533833.0,2000,80.0,66167,533833
800000,9,711707.0,2000,80.0,88293,711707
1000000,9,889607.0,2000,80.0,110393,889607
2,10,2.0,1,0.04,0,2
3,10,2.0,2,0.08,1,2
100,10,87.0,66,2.64,13,87
200,10,172.0,133,5.32,28,172
2000,10,1699.0,1333,53.32,301,1699
10000,10,8768.0,2000,80.0,1232,8768
20000,10,17716.0,2000,80.0,2284,17716
40000,10,35510.0,2000,80.0,4490,35510
60000,10,53291.0,2000,80.0,6709,53291
80000,10,71049.0,2000,80.0,8951,71049
100000,10,88884.0,2000,80.0,11116,88884
200000,10,178031.0,2000,80.0,21969,178031
400000,10,355897.0,2000,80.0,44103,355897
600000,10,533850.0,2000,80.0,66150,533850
800000,10,711549.0,2000,80.0,88451,711549
1000000,10,889559.0,2000,80.0,110441,889559
2,11,2.0,1,0.04,0,2
3,11,3.0,2,0.08,0,3
100,11,85.0,66,2.64,15,85
200,11,169.0,133,5.32,31,169
2000,11,1709.0,1333,53.32,291,1709
10000,11,8814.0,2000,80.0,1186,8814
20000,11,17732.0,2000,80.0,2268,17732
40000,11,35487.0,2000,80.0,4513,35487
60000,11,53314.0,2000,80.0,6686,53314
80000,11,71150.0,2000,80.0,8850,71150
100000,11,88929.0,2000,80.0,11071,88929
200000,11,177860.0,2000,80.0,22140,177860
400000,11,356001.0,2000,80.0,43999,356001
600000,11,534132.0,2000,80.0,65868,534132
800000,11,712019.0,2000,80.0,87981,712019
1000000,11,890024.0,2000,80.0,109976,890024
2,12,2.0,1,0.04,0,2
3,12,3.0,2,0.08,0,3
100,12,84.0,66,2.64,16,84
200,12,169.0,133,5.32,31,169
2000,12,1726.0,1333,53.32,274,1726
10000,12,8766.0,2000,80.0,1234,8766
20000,12,17693.0,2000,80.0,2307,17693
40000,12,35531.0,2000,80.0,4469,35531
60000,12,53325.0,2000,80.0,6675,53325
80000,12,71095.0,2000,80.0,8905,71095
100000,12,88898.0,2000,80.0,11102,88898
200000,12,177896.0,2000,80.0,22104,177896
400000,12,355994.0,2000,80.0,44006,355994
600000,12,533983.0,2000,80.0,66017,533983
800000,12,712061.0,2000,80.0,87939,712061
1000000,12,890176.0,2000,80.0,109824,890176
2,13,1.0,1,0.04,1,1
3,13,2.0,2,0.08,1,2
100,13,78.0,66,2.64,22,78
200,13,167.0,133,5.32,33,167
2000,13,1719.0,1333,53.32,281,1719
10000,13,8793.0,2000,80.0,1207,8793
20000,13,17663.0,2000,80.0,2337,17663
40000,13,35488.0,2000,80.0,4512,35488
60000,13,53355.0,2000,80.0,6645,53355
80000,13,71187.0,2000,80.0,8813,71187
100000,13,88889.0,2000,80.0,11111,88889
200000,13,177823.0,2000,80.0,22177,177823
400000,13,355890.0,2000,80.0,44110,355890
600000,13,533982.0,2000,80.0,66018,533982
800000,13,712020.0,2000,80.0,87980,712020
1000000,13,890185.0,2000,80.0,109815,890185
2,14,1.0,1,0.04,1,1
3,14,2.0,2,0.08,1,2
100,14,93.0,66,2.64,7,93
200,14,180.0,133,5.32,20,180
2000,14,1719.0,1333,53.32,281,1719
10000,14,8818.0,2000,80.0,1182,8818
20000,14,17696.0,2000,80.0,2304,17696
40000,14,35482.0,2000,80.0,4518,35482
60000,14,53211.0,2000,80.0,6789,53211
80000,14,70974.0,2000,80.0,9026,70974
100000,14,88793.0,2000,80.0,11207,88793
200000,14,177819.0,2000,80.0,22181,177819
400000,14,355657.0,2000,80.0,44343,355657
600000,14,533538.0,2000,80.0,66462,533538
800000,14,711453.0,2000,80.0,88547,711453
1000000,14,889222.0,2000,80.0,110778,889222
2,15,1.0,1,0.04,1,1
3,15,2.0,2,0.08,1,2
100,15,86.0,66,2.64,14,86
200,15,172.0,133,5.32,28,172
2000,15,1712.0,1333,53.32,288,1712
10000,15,8837.0,2000,80.0,1163,8837
20000,15,17696.0,2000,80.0,2304,17696
40000,15,35530.0,2000,80.0,4470,35530
60000,15,53327.0,2000,80.0,6673,53327
80000,15,71036.0,2000,80.0,8964,71036
100000,15,88887.0,2000,80.0,11113,88887
200000,15,178004.0,2000,80.0,21996,178004
400000,15,356170.0,2000,80.0,43830,356170
600000,15,534227.0,2000,80.0,65773,534227
800000,15,712088.0,2000,80.0,87912,712088
1000000,15,890016.0,2000,80.0,109984,890016
2,16,2.0,1,0.04,0,2
3,16,3.0,2,0.08,0,3
100,16,91.0,66,2.64,9,91
200,16,175.0,133,5.32,25,175
2000,16,1719.0,1333,53.32,281,1719
10000,16,8869.0,2000,80.0,1131,8869
20000,16,17773.0,2000,80.0,2227,17773
40000,16,35522.0,2000,80.0,4478,35522
60000,16,53287.0,2000,80.0,6713,53287
80000,16,71119.0,2000,80.0,8881,71119
100000,16,88867.0,2000,80.0,11133,88867
200000,16,177848.0,2000,80.0,22152,177848
400000,16,355623.0,2000,80.0,44377,355623
600000,16,533388.0,2000,80.0,66612,533388
800000,16,711468.0,2000,80.0,88532,711468
1000000,16,889645.0,2000,80.0,110355,889645
2,17,2.0,1,0.04,0,2
3,17,3.0,2,0.08,0,3
100,17,90.0,66,2.64,10,90
200,17,178.0,133,5.32,22,178
2000,17,1742.0,1333,53.32,258,1742
10000,17,8846.0,2000,80.0,1154,8846
20000,17,17807.0,2000,80.0,2193,17807
40000,17,35602.0,2000,80.0,4398,35602
60000,17,53406.0,2000,80.0,6594,53406
80000,17,71173.0,2000,80.0,8827,71173
100000,17,88951.0,2000,80.0,11049,88951
200000,17,177958.0,2000,80.0,22042,177958
400000,17,355969.0,2000,80.0,44031,355969
600000,17,533962.0,2000,80.0,66038,533962
800000,17,712119.0,2000,80.0,87881,712119
1000000,17,890426.0,2000,80.0,109574,890426
2,18,2.0,1,0.04,0,2
3,18,3.0,2,0.08,0,3
100,18,85.0,66,2.64,15,85
200,18,170.0,133,5.32,30,170
2000,18,1740.0,1333,53.32,260,1740
10000,18,8883.0,2000,80.0,1117,8883
20000,18,17793.0,2000,80.0,2207,17793
40000,18,35599.0,2000,80.0,4401,35599
60000,18,53382.0,2000,80.0,6618,53382
80000,18,71265.0,2000,80.0,8735,71265
100000,18,89018.0,2000,80.0,10982,89018
200000,18,177987.0,2000,80.0,22013,177987
400000,18,355879.0,2000,80.0,44121,355879
600000,18,533911.0,2000,80.0,66089,533911
800000,18,712005.0,2000,80.0,87995,712005
1000000,18,890072.0,2000,80.0,109928,890072
2,19,1.0,1,0.04,1,1
3,19,2.0,2,0.08,1,2
100,19,78.0,66,2.64,22,78
200,19,165.0,133,5.32,35,165
2000,19,1726.0,1333,53.32,274,1726
10000,19,8807.0,2000,80.0,1193,8807
20000,19,17676.0,2000,80.0,2324,17676
40000,19,35548.0,2000,80.0,4452,35548
60000,19,53324.0,2000,80.0,6676,53324
80000,19,71088.0,2000,80.0,8912,71088
100000,19,88849.0,2000,80.0,11151,88849
200000,19,177769.0,2000,80.0,22231,177769
400000,19,356096.0,2000,80.0,43904,356096
600000,19,533997.0,2000,80.0,66003,533997
800000,19,712069.0,2000,80.0,87931,712069
1000000,19,889886.0,2000,80.0,110114,889886
2,20,2.0,1,0.04,0,2
3,20,3.0,2,0.08,0,3
100,20,88.0,66,2.64,12,88
200,20,167.0,133,5.32,33,167
2000,20,1721.0,1333,53.32,279,1721
10000,20,8787.0,2000,80.0,1213,8787
20000,20,17658.0,2000,80.0,2342,17658
40000,20,35384.0,2000,80.0,4616,35384
60000,20,53202.0,2000,80.0,6798,53202
80000,20,70945.0,2000,80.0,9055,70945
100000,20,88697.0,2000,80.0,11303,88697
200000,20,177749.0,2000,80.0,22251,177749
400000,20,355785.0,2000,80.0,44215,355785
600000,20,533924.0,2000,80.0,66076,533924
800000,20,712072.0,2000,80.0,87928,712072
1000000,20,889963.0,2000,80.0,110037,889963
2,21,1.0,1,0.04,1,1
3,21,2.0,2,0.08,1,2
100,21,85.0,66,2.64,15,85
200,21,169.0,133,5.32,31,169
2000,21,1709.0,1333,53.32,291,1709
10000,21,8806.0,2000,80.0,1194,8806
20000,21,17673.0,2000,80.0,2327,17673
40000,21,35492.0,2000,80.0,4508,35492
60000,21,53307.0,2000,80.0,6693,53307
80000,21,71084.0,2000,80.0,8916,71084
100000,21,88892.0,2000,80.0,11108,88892
200000,21,177915.0,2000,80.0,22085,177915
400000,21,355896.0,2000,80.0,44104,355896
600000,21,533987.0,2000,80.0,66013,533987
800000,21,711968.0,2000,80.0,88032,711968
1000000,21,889837.0,2000,80.0,110163,889837
2,22,2.0,1,0.04,0,2
3,22,3.0,2,0.08,0,3
100,22,84.0,66,2.64,16,84
200,22,175.0,133,5.32,25,175
2000,22,1748.0,1333,53.32,252,1748
10000,22,8858.0,2000,80.0,1142,8858
20000,22,17814.0,2000,80.0,2186,17814
40000,22,35596.0,2000,80.0,4404,35596
60000,22,53423.0,2000,80.0,6577,53423
80000,22,71143.0,2000,80.0,8857,71143
100000,22,88938.0,2000,80.0,11062,88938
200000,22,177962.0,2000,80.0,22038,177962
400000,22,355908.0,2000,80.0,44092,355908
600000,22,533866.0,2000,80.0,66134,533866
800000,22,711906.0,2000,80.0,88094,711906
1000000,22,889936.0,2000,80.0,110064,889936
2,23,1.0,1,0.04,1,1
3,23,1.0,2,0.08,2,1
100,23,85.0,66,2.64,15,85
200,23,177.0,133,5.32,23,177
2000,23,1696.0,1333,53.32,304,1696
10000,23,8802.0,2000,80.0,1198,8802
20000,23,17691.0,2000,80.0,2309,17691
40000,23,35546.0,2000,80.0,4454,35546
60000,23,53353.0,2000,80.0,6647,53353
80000,23,71158.0,2000,80.0,8842,71158
100000,23,88954.0,2000,80.0,11046,88954
200000,23,177830.0,2000,80.0,22170,177830
400000,23,355695.0,2000,80.0,44305,355695
600000,23,533582.0,2000,80.0,66418,533582
800000,23,711427.0,2000,80.0,88573,711427
1000000,23,889289.0,2000,80.0,110711,889289
2,24,2.0,1,0.04,0,2
3,24,3.0,2,0.08,0,3
100,24,92.0,66,2.64,8,92
200,24,187.0,133,5.32,13,187
2000,24,1722.0,1333,53.32,278,1722
10000,24,8836.0,2000,80.0,1164,8836
20000,24,17719.0,2000,80.0,2281,17719
40000,24,35542.0,2000,80.0,4458,35542
60000,24,53288.0,2000,80.0,6712,53288
80000,24,71117.0,2000,80.0,8883,71117
100000,24,88931.0,2000,80.0,11069,88931
200000,24,177818.0,2000,80.0,22182,177818
400000,24,355928.0,2000,80.0,44072,355928
600000,24,534064.0,2000,80.0,65936,534064
800000,24,712310.0,2000,80.0,87690,712310
1000000,24,890576.0,2000,80.0,109424,890576
2,25,1.0,1,0.04,1,1
3,25,2.0,2,0.08,1,2
100,25,92.0,66,2.64,8,92
200,25,180.0,133,5.32,20,180
2000,25,1755.0,1333,53.32,245,1755
10000,25,8809.0,2000,80.0,1191,8809
20000,25,17659.0,2000,80.0,2341,17659
40000,25,35477.0,2000,80.0,4523,35477
60000,25,53317.0,2000,80.0,6683,53317
80000,25,71056.0,2000,80.0,8944,71056
100000,25,88868.0,2000,80.0,11132,88868
200000,25,177853.0,2000,80.0,22147,177853
400000,25,355829.0,2000,80.0,44171,355829
600000,25,533973.0,2000,80.0,66027,533973
800000,25,711809.0,2000,80.0,88191,711809
1000000,25,889805.0,2000,80.0,110195,889805
2,26,2.0,1,0.04,0,2
3,26,2.0,2,0.08,1,2
100,26,78.0,66,2.64,22,78
200,26,164.0,133,5.32,36,164
2000,26,1726.0,1333,53.32,274,1726
10000,26,8811.0,2000,80.0,1189,8811
20000,26,17691.0,2000,80.0,2309,17691
40000,26,35474.0,2000,80.0,4526,35474
60000,26,53300.0,2000,80.0,6700,53300
80000,26,71126.0,2000,80.0,8874,71126
100000,26,88960.0,2000,80.0,11040,88960
200000,26,177972.0,2000,80.0,22028,177972
400000,26,355854.0,2000,80.0,44146,355854
600000,26,534034.0,2000,80.0,65966,534034
800000,26,712165.0,2000,80.0,87835,712165
1000000,26,890223.0,2000,80.0,109777,890223
2,27,1.0,1,0.04,1,1
3,27,2.0,2,0.08,1,2
100,27,83.0,66,2.64,17,83
200,27,175.0,133,5.32,25,175
2000,27,1734.0,1333,53.32,266,1734
10000,27,8790.0,2000,80.0,1210,8790
20000,27,17675.0,2000,80.0,2325,17675
40000,27,35463.0,2000,80.0,4537,35463
60000,27,53280.0,2000,80.0,6720,53280
80000,27,71056.0,2000,80.0,8944,71056
100000,27,88816.0,2000,80.0,11184,88816
200000,27,177886.0,2000,80.0,22114,177886
400000,27,355765.0,2000,80.0,44235,355765
600000,27,533836.0,2000,80.0,66164,533836
800000,27,712003.0,2000,80.0,87997,712003
1000000,27,890131.0,2000,80.0,109869,890131
2,28,2.0,1,0.04,0,2
3,28,3.0,2,0.08,0,3
100,28,87.0,66,2.64,13,87
200,28,172.0,133,5.32,28,172
2000,28,1725.0,1333,53.32,275,1725
10000,28,8812.0,2000,80.0,1188,8812
20000,28,17765.0,2000,80.0,2235,17765
40000,28,35618.0,2000,80.0,4382,35618
60000,28,53305.0,2000,80.0,6695,53305
80000,28,71076.0,2000,80.0,8924,71076
100000,28,88853.0,2000,80.0,11147,88853
200000,28,177789.0,2000,80.0,22211,177789
400000,28,356023.0,2000,80.0,43977,356023
600000,28,534065.0,2000,80.0,65935,534065
800000,28,712082.0,2000,80.0,87918,712082
1000000,28,890021.0,2000,80.0,109979,890021
2,29,2.0,1,0.04,0,2
3,29,3.0,2,0.08,0,3
100,29,90.0,66,2.64,10,90
200,29,170.0,133,5.32,30,170
2000,29,1737.0,1333,53.32,263,1737
10000,29,8813.0,2000,80.0,1187,8813
20000,29,17741.0,2000,80.0,2259,17741
40000,29,35589.0,2000,80.0,4411,35589
60000,29,53384.0,2000,80.0,6616,53384
80000,29,71201.0,2000,80.0,8799,71201
100000,29,88993.0,2000,80.0,11007,88993
200000,29,177962.0,2000,80.0,22038,177962
400000,29,355743.0,2000,80.0,44257,355743
600000,29,533743.0,2000,80.0,66257,533743
800000,29,711552.0,2000,80.0,88448,711552
1000000,29,889400.0,2000,80.0,110600,889400
2,30,2.0,1,0.04,0,2
3,30,3.0,2,0.08,0,3
100,30,88.0,66,2.64,12,88
200,30,176.0,133,5.32,24,176
2000,30,1702.0,1333,53.32,298,1702
10000,30,8791.0,2000,80.0,1209,8791
20000,30,17644.0,2000,80.0,2356,17644
40000,30,35463.0,2000,80.0,4537,35463
60000,30,53272.0,2000,80.0,6728,53272
80000,30,71067.0,2000,80.0,8933,71067
100000,30,88878.0,2000,80.0,11122,88878
200000,30,177947.0,2000,80.0,22053,177947
400000,30,355919.0,2000,80.0,44081,355919
600000,30,533966.0,2000,80.0,66034,533966
800000,30,712025.0,2000,80.0,87975,712025
1000000,30,890198.0,2000,80.0,109802,890198
2,31,2.0,1,0.04,0,2
3,31,3.0,2,0.08,0,3
100,31,93.0,66,2.64,7,93
200,31,179.0,133,5.32,21,179
2000,31,1725.0,1333,53.32,275,1725
10000,31,8840.0,2000,80.0,1160,8840
20000,31,17759.0,2000,80.0,2241,17759
40000,31,35621.0,2000,80.0,4379,35621
60000,31,53438.0,2000,80.0,6562,53438
80000,31,71283.0,2000,80.0,8717,71283
100000,31,89092.0,2000,80.0,10908,89092
200000,31,178141.0,2000,80.0,21859,178141
400000,31,356188.0,2000,80.0,43812,356188
600000,31,534435.0,2000,80.0,65565,534435
800000,31,712381.0,2000,80.0,87619,712381
1000000,31,890416.0,2000,80.0,109584,890416
2,32,2.0,1,0.04,0,2
3,32,3.0,2,0.08,0,3
100,32,89.0,66,2.64,11,89
200,32,169.0,133,5.32,31,169
2000,32,1723.0,1333,53.32,277,1723
10000,32,8838.0,2000,80.0,1162,8838
20000,32,17753.0,2000,80.0,2247,17753
40000,32,35632.0,2000,80.0,4368,35632
60000,32,53460.0,2000,80.0,6540,53460
80000,32,71284.0,2000,80.0,8716,71284
100000,32,89087.0,2000,80.0,10913,89087
200000,32,178054.0,2000,80.0,21946,178054
400000,32,356021.0,2000,80.0,43979,356021
600000,32,533896.0,2000,80.0,66104,533896
800000,32,711942.0,2000,80.0,88058,711942
1000000,32,889912.0,2000,80.0,110088,889912
2,33,2.0,1,0.04,0,2
3,33,3.0,2,0.08,0,3
100,33,88.0,66,2.64,12,88
200,33,175.0,133,5.32,25,175
2000,33,1731.0,1333,53.32,269,1731
10000,33,8801.0,2000,80.0,1199,8801
20000,33,17749.0,2000,80.0,2251,17749
40000,33,35571.0,2000,80.0,4429,35571
60000,33,53380.0,2000,80.0,6620,53380
80000,33,71223.0,2000,80.0,8777,71223
100000,33,89035.0,2000,80.0,10965,89035
200000,33,178083.0,2000,80.0,21917,178083
400000,33,356044.0,2000,80.0,43956,356044
600000,33,534100.0,2000,80.0,65900,534100
800000,33,712155.0,2000,80.0,87845,712155
1000000,33,890356.0,2000,80.0,109644,890356
2,34,2.0,1,0.04,0,2
3,34,3.0,2,0.08,0,3
100,34,87.0,66,2.64,13,87
200,34,177.0,133,5.32,23,177
2000,34,1753.0,1333,53.32,247,1753
10000,34,8826.0,2000,80.0,1174,8826
20000,34,17716.0,2000,80.0,2284,17716
40000,34,35485.0,2000,80.0,4515,35485
60000,34,53250.0,2000,80.0,6750,53250
80000,34,71059.0,2000,80.0,8941,71059
100000,34,88799.0,2000,80.0,11201,88799
200000,34,177773.0,2000,80.0,22227,177773
400000,34,355649.0,2000,80.0,44351,355649
600000,34,533717.0,2000,80.0,66283,533717
800000,34,711823.0,2000,80.0,88177,711823
1000000,34,889696.0,2000,80.0,110304,889696
2,35,2.0,1,0.04,0,2
3,35,3.0,2,0.08,0,3
100,35,90.0,66,2.64,10,90
200,35,173.0,133,5.32,27,173
2000,35,1766.0,1333,53.32,234,1766
10000,35,8792.0,2000,80.0,1208,8792
20000,35,17647.0,2000,80.0,2353,17647
40000,35,35486.0,2000,80.0,4514,35486
60000,35,53190.0,2000,80.0,6810,53190
80000,35,70947.0,2000,80.0,9053,70947
100000,35,88731.0,2000,80.0,11269,88731
200000,35,177654.0,2000,80.0,22346,177654
400000,35,355701.0,2000,80.0,44299,355701
600000,35,533646.0,2000,80.0,66354,533646
800000,35,711666.0,2000,80.0,88334,711666
1000000,35,889819.0,2000,80.0,110181,889819
2,36,1.0,1,0.04,1,1
3,36,2.0,2,0.08,1,2
100,36,87.0,66,2.64,13,87
200,36,173.0,133,5.32,27,173
2000,36,1725.0,1333,53.32,275,1725
10000,36,8847.0,2000,80.0,1153,8847
20000,36,17748.0,2000,80.0,2252,17748
40000,36,35582.0,2000,80.0,4418,35582
60000,36,53413.0,2000,80.0,6587,53413
80000,36,71280.0,2000,80.0,8720,71280
100000,36,89052.0,2000,80.0,10948,89052
200000,36,177962.0,2000,80.0,22038,177962
400000,36,355785.0,2000,80.0,44215,355785
600000,36,533690.0,2000,80.0,66310,533690
800000,36,711595.0,2000,80.0,88405,711595
1000000,36,889431.0,2000,80.0,110569,889431
2,37,2.0,1,0.04,0,2
3,37,3.0,2,0.08,0,3
100,37,88.0,66,2.64,12,88
200,37,178.0,133,5.32,22,178
2000,37,1743.0,1333,53.32,257,1743
10000,37,8800.0,2000,80.0,1200,8800
20000,37,17698.0,2000,80.0,2302,17698
40000,37,35572.0,2000,80.0,4428,35572
60000,37,53355.0,2000,80.0,6645,53355
80000,37,71238.0,2000,80.0,8762,71238
100000,37,89056.0,2000,80.0,10944,89056
200000,37,178076.0,2000,80.0,21924,178076
400000,37,355986.0,2000,80.0,44014,355986
600000,37,534226.0,2000,80.0,65774,534226
800000,37,712477.0,2000,80.0,87523,712477
1000000,37,890518.0,2000,80.0,109482,890518
2,38,2.0,1,0.04,0,2
3,38,3.0,2,0.08,0,3
100,38,88.0,66,2.64,12,88
200,38,179.0,133,5.32,21,179
2000,38,1730.0,1333,53.32,270,1730
10000,38,8803.0,2000,80.0,1197,8803
20000,38,17687.0,2000,80.0,2313,17687
40000,38,35477.0,2000,80.0,4523,35477
60000,38,53347.0,2000,80.0,6653,53347
80000,38,71162.0,2000,80.0,8838,71162
100000,38,88980.0,2000,80.0,11020,88980
200000,38,178024.0,2000,80.0,21976,178024
400000,38,355958.0,2000,80.0,44042,355958
600000,38,533971.0,2000,80.0,66029,533971
800000,38,711895.0,2000,80.0,88105,711895
1000000,38,889793.0,2000,80.0,110207,889793
2,39,2.0,1,0.04,0,2
3,39,3.0,2,0.08,0,3
100,39,84.0,66,2.64,16,84
200,39,173.0,133,5.32,27,173
2000,39,1743.0,1333,53.32,257,1743
10000,39,8844.0,2000,80.0,1156,8844
20000,39,17747.0,2000,80.0,2253,17747
40000,39,35647.0,2000,80.0,4353,35647
60000,39,53520.0,2000,80.0,6480,53520
80000,39,71289.0,2000,80.0,8711,71289
100000,39,89111.0,2000,80.0,10889,89111
200000,39,178181.0,2000,80.0,21819,178181
400000,39,356380.0,2000,80.0,43620,356380
600000,39,534049.0,2000,80.0,65951,534049
800000,39,712088.0,2000,80.0,87912,712088
1000000,39,890023.0,2000,80.0,109977,890023
2,40,2.0,1,0.04,0,2
3,40,3.0,2,0.08,0,3
100,40,78.0,66,2.64,22,78
200,40,167.0,133,5.32,33,167
2000,40,1707.0,1333,53.32,293,1707
10000,40,8814.0,2000,80.0,1186,8814
20000,40,17762.0,2000,80.0,2238,17762
40000,40,35491.0,2000,80.0,4509,35491
60000,40,53276.0,2000,80.0,6724,53276
80000,40,71062.0,2000,80.0,8938,71062
100000,40,88814.0,2000,80.0,11186,88814
200000,40,177785.0,2000,80.0,22215,177785
400000,40,355597.0,2000,80.0,44403,355597
600000,40,533614.0,2000,80.0,66386,533614
800000,40,711658.0,2000,80.0,88342,711658
1000000,40,889649.0,2000,80.0,110351,889649
2,41,2.0,1,0.04,0,2
3,41,3.0,2,0.08,0,3
100,41,87.0,66,2.64,13,87
200,41,173.0,133,5.32,27,173
2000,41,1737.0,1333,53.32,263,1737
10000,41,8840.0,2000,80.0,1160,8840
20000,41,17744.0,2000,80.0,2256,17744
40000,41,35537.0,2000,80.0,4463,35537
60000,41,53291.0,2000,80.0,6709,53291
80000,41,71047.0,2000,80.0,8953,71047
100000,41,88838.0,2000,80.0,11162,88838
200000,41,177942.0,2000,80.0,22058,177942
400000,41,355966.0,2000,80.0,44034,355966
600000,41,533965.0,2000,80.0,66035,533965
800000,41,711647.0,2000,80.0,88353,711647
1000000,41,889646.0,2000,80.0,110354,889646
2,42,2.0,1,0.04,0,2
3,42,3.0,2,0.08,0,3
100,42,87.0,66,2.64,13,87
200,42,178.0,133,5.32,22,178
2000,42,1723.0,1333,53.32,277,1723
10000,42,8852.0,2000,80.0,1148,8852
20000,42,17702.0,2000,80.0,2298,17702
40000,42,35542.0,2000,80.0,4458,35542
60000,42,53327.0,2000,80.0,6673,53327
80000,42,71125.0,2000,80.0,8875,71125
100000,42,88839.0,2000,80.0,11161,88839
200000,42,177806.0,2000,80.0,22194,177806
400000,42,356022.0,2000,80.0,43978,356022
600000,42,533949.0,2000,80.0,66051,533949
800000,42,711996.0,2000,80.0,88004,711996
1000000,42,890001.0,2000,80.0,109999,890001
2,43,2.0,1,0.04,0,2
3,43,3.0,2,0.08,0,3
100,43,87.0,66,2.64,13,87
200,43,175.0,133,5.32,25,175
2000,43,1725.0,1333,53.32,275,1725
10000,43,8832.0,2000,80.0,1168,8832
20000,43,17740.0,2000,80.0,2260,17740
40000,43,35505.0,2000,80.0,4495,35505
60000,43,53238.0,2000,80.0,6762,53238
80000,43,70985.0,2000,80.0,9015,70985
100000,43,88775.0,2000,80.0,11225,88775
200000,43,177699.0,2000,80.0,22301,177699
400000,43,355540.0,2000,80.0,44460,355540
600000,43,533538.0,2000,80.0,66462,533538
800000,43,711705.0,2000,80.0,88295,711705
1000000,43,889976.0,2000,80.0,110024,889976
2,44,2.0,1,0.04,0,2
3,44,3.0,2,0.08,0,3
100,44,82.0,66,2.64,18,82
200,44,169.0,133,5.32,31,169
2000,44,1700.0,1333,53.32,300,1700
10000,44,8809.0,2000,80.0,1191,8809
20000,44,17691.0,2000,80.0,2309,17691
40000,44,35455.0,2000,80.0,4545,35455
60000,44,53301.0,2000,80.0,6699,53301
80000,44,71095.0,2000,80.0,8905,71095
100000,44,88842.0,2000,80.0,11158,88842
200000,44,177863.0,2000,80.0,22137,177863
400000,44,355711.0,2000,80.0,44289,355711
600000,44,534060.0,2000,80.0,65940,534060
800000,44,712043.0,2000,80.0,87957,712043
1000000,44,890095.0,2000,80.0,109905,890095
2,45,2.0,1,0.04,0,2
3,45,3.0,2,0.08,0,3
100,45,96.0,66,2.64,4,96
200,45,180.0,133,5.32,20,180
2000,45,1747.0,1333,53.32,253,1747
10000,45,8788.0,2000,80.0,1212,8788
20000,45,17734.0,2000,80.0,2266,17734
40000,45,35548.0,2000,80.0,4452,35548
60000,45,53332.0,2000,80.0,6668,53332
80000,45,71051.0,2000,80.0,8949,71051
100000,45,88913.0,2000,80.0,11087,88913
200000,45,177982.0,2000,80.0,22018,177982
400000,45,355811.0,2000,80.0,44189,355811
600000,45,533782.0,2000,80.0,66218,533782
800000,45,711751.0,2000,80.0,88249,711751
1000000,45,889957.0,2000,80.0,110043,889957
2,46,1.0,1,0.04,1,1
3,46,2.0,2,0.08,1,2
100,46,91.0,66,2.64,9,91
200,46,176.0,133,5.32,24,176
2000,46,1756.0,1333,53.32,244,1756
10000,46,8860.0,2000,80.0,1140,8860
20000,46,17778.0,2000,80.0,2222,17778
40000,46,35585.0,2000,80.0,4415,35585
60000,46,53395.0,2000,80.0,6605,53395
80000,46,71225.0,2000,80.0,8775,71225
100000,46,89039.0,2000,80.0,10961,89039
200000,46,178064.0,2000,80.0,21936,178064
400000,46,355956.0,2000,80.0,44044,355956
600000,46,534123.0,2000,80.0,65877,534123
800000,46,712009.0,2000,80.0,87991,712009
1000000,46,889724.0,2000,80.0,110276,889724
2,47,2.0,1,0.04,0,2
3,47,3.0,2,0.08,0,3
100,47,85.0,66,2.64,15,85
200,47,177.0,133,5.32,23,177
2000,47,1731.0,1333,53.32,269,1731
10000,47,8809.0,2000,80.0,1191,8809
20000,47,17656.0,2000,80.0,2344,17656
40000,47,35468.0,2000,80.0,4532,35468
60000,47,53287.0,2000,80.0,6713,53287
80000,47,71162.0,2000,80.0,8838,71162
100000,47,88962.0,2000,80.0,11038,88962
200000,47,178152.0,2000,80.0,21848,178152
400000,47,356361.0,2000,80.0,43639,356361
600000,47,534152.0,2000,80.0,65848,534152
800000,47,712078.0,2000,80.0,87922,712078
1000000,47,889929.0,2000,80.0,110071,889929
2,48,2.0,1,0.04,0,2
3,48,3.0,2,0.08,0,3
100,48,87.0,66,2.64,13,87
200,48,171.0,133,5.32,29,171
2000,48,1717.0,1333,53.32,283,1717
10000,48,8778.0,2000,80.0,1222,8778
20000,48,17635.0,2000,80.0,2365,17635
40000,48,35485.0,2000,80.0,4515,35485
60000,48,53266.0,2000,80.0,6734,53266
80000,48,71032.0,2000,80.0,8968,71032
100000,48,88878.0,2000,80.0,11122,88878
200000,48,177797.0,2000,80.0,22203,177797
400000,48,355673.0,2000,80.0,44327,355673
600000,48,533557.0,2000,80.0,66443,533557
800000,48,711577.0,2000,80.0,88423,711577
1000000,48,889412.0,2000,80.0,110588,889412
2,49,1.0,1,0.04,1,1
3,49,2.0,2,0.08,1,2
100,49,87.0,66,2.64,13,87
200,49,175.0,133,5.32,25,175
2000,49,1756.0,1333,53.32,244,1756
10000,49,8835.0,2000,80.0,1165,8835
20000,49,17761.0,2000,80.0,2239,17761
40000,49,35596.0,2000,80.0,4404,35596
60000,49,53377.0,2000,80.0,6623,53377
80000,49,71222.0,2000,80.0,8778,71222
100000,49,88999.0,2000,80.0,11001,88999
200000,49,178093.0,2000,80.0,21907,178093
400000,49,356002.0,2000,80.0,43998,356002
600000,49,533680.0,2000,80.0,66320,533680
800000,49,711805.0,2000,80.0,88195,711805
1000000,49,889845.0,2000,80.0,110155,889845
2,50,2.0,1,0.04,0,2
3,50,2.0,2,0.08,1,2
100,50,88.0,66,2.64,12,88
200,50,173.0,133,5.32,27,173
2000,50,1724.0,1333,53.32,276,1724
10000,50,8828.0,2000,80.0,1172,8828
20000,50,17755.0,2000,80.0,2245,17755
40000,50,35547.0,2000,80.0,4453,35547
60000,50,53297.0,2000,80.0,6703,53297
80000,50,71119.0,2000,80.0,8881,71119
100000,50,88941.0,2000,80.0,11059,88941
200000,50,177948.0,2000,80.0,22052,177948
400000,50,355980.0,2000,80.0,44020,355980
600000,50,533874.0,2000,80.0,66126,533874
800000,50,711853.0,2000,80.0,88147,711853
1000000,50,890114.0,2000,80.0,109886,890114
2,51,2.0,1,0.04,0,2
3,51,3.0,2,0.08,0,3
100,51,80.0,66,2.64,20,80
200,51,168.0,133,5.32,32,168
2000,51,1747.0,1333,53.32,253,1747
10000,51,8810.0,2000,80.0,1190,8810
20000,51,17693.0,2000,80.0,2307,17693
40000,51,35462.0,2000,80.0,4538,35462
60000,51,53198.0,2000,80.0,6802,53198
80000,51,71090.0,2000,80.0,8910,71090
100000,51,88894.0,2000,80.0,11106,88894
200000,51,178031.0,2000,80.0,21969,178031
400000,51,355982.0,2000,80.0,44018,355982
600000,51,533986.0,2000,80.0,66014,533986
800000,51,712299.0,2000,80.0,87701,712299
1000000,51,890420.0,2000,80.0,109580,890420
2,52,2.0,1,0.04,0,2
3,52,3.0,2,0.08,0,3
100,52,89.0,66,2.64,11,89
200,52,178.0,133,5.32,22,178
2000,52,1718.0,1333,53.32,282,1718
10000,52,8807.0,2000,80.0,1193,8807
20000,52,17701.0,2000,80.0,2299,17701
40000,52,35574.0,2000,80.0,4426,35574
60000,52,53362.0,2000,80.0,6638,53362
80000,52,71168.0,2000,80.0,8832,71168
100000,52,88877.0,2000,80.0,11123,88877
200000,52,177952.0,2000,80.0,22048,177952
400000,52,355811.0,2000,80.0,44189,355811
600000,52,533894.0,2000,80.0,66106,533894
800000,52,711929.0,2000,80.0,88071,711929
1000000,52,890011.0,2000,80.0,109989,890011
2,53,1.0,1,0.04,1,1
3,53,1.0,2,0.08,2,1
100,53,83.0,66,2.64,17,83
200,53,170.0,133,5.32,30,170
2000,53,1730.0,1333,53.32,270,1730
10000,53,8788.0,2000,80.0,1212,8788
20000,53,17662.0,2000,80.0,2338,17662
40000,53,35527.0,2000,80.0,4473,35527
60000,53,53317.0,2000,80.0,6683,53317
80000,53,71088.0,2000,80.0,8912,71088
100000,53,88901.0,2000,80.0,11099,88901
200000,53,177784.0,2000,80.0,22216,177784
400000,53,355791.0,2000,80.0,44209,355791
600000,53,533754.0,2000,80.0,66246,533754
800000,53,711908.0,2000,80.0,88092,711908
1000000,53,889905.0,2000,80.0,110095,889905
2,54,2.0,1,0.04,0,2
3,54,3.0,2,0.08,0,3
100,54,83.0,66,2.64,17,83
200,54,167.0,133,5.32,33,167
2000,54,1687.0,1333,53.32,313,1687
10000,54,8773.0,2000,80.0,1227,8773
20000,54,17654.0,2000,80.0,2346,17654
40000,54,35450.0,2000,80.0,4550,35450
60000,54,53258.0,2000,80.0,6742,53258
80000,54,71046.0,2000,80.0,8954,71046
100000,54,88842.0,2000,80.0,11158,88842
200000,54,177671.0,2000,80.0,22329,177671
400000,54,355676.0,2000,80.0,44324,355676
600000,54,533781.0,2000,80.0,66219,533781
800000,54,711676.0,2000,80.0,88324,711676
1000000,54,889699.0,2000,80.0,110301,889699
2,55,2.0,1,0.04,0,2
3,55,3.0,2,0.08,0,3
100,55,89.0,66,2.64,11,89
200,55,174.0,133,5.32,26,174
2000,55,1745.0,1333,53.32,255,1745
10000,55,8864.0,2000,80.0,1136,8864
20000,55,17816.0,2000,80.0,2184,17816
40000,55,35593.0,2000,80.0,4407,35593
60000,55,53247.0,2000,80.0,6753,53247
80000,55,71048.0,2000,80.0,8952,71048
100000,55,88882.0,2000,80.0,11118,88882
200000,55,178044.0,2000,80.0,21956,178044
400000,55,356219.0,2000,80.0,43781,356219
600000,55,534264.0,2000,80.0,65736,534264
800000,55,712255.0,2000,80.0,87745,712255
1000000,55,890103.0,2000,80.0,109897,890103
2,56,2.0,1,0.04,0,2
3,56,2.0,2,0.08,1,2
100,56,88.0,66,2.64,12,88
200,56,177.0,133,5.32,23,177
2000,56,1725.0,1333,53.32,275,1725
10000,56,8730.0,2000,80.0,1270,8730
20000,56,17653.0,2000,80.0,2347,17653
40000,56,35517.0,2000,80.0,4483,35517
60000,56,53240.0,2000,80.0,6760,53240
80000,56,71078.0,2000,80.0,8922,71078
100000,56,88904.0,2000,80.0,11096,88904
200000,56,177910.0,2000,80.0,22090,177910
400000,56,356110.0,2000,80.0,43890,356110
600000,56,533778.0,2000,80.0,66222,533778
800000,56,711724.0,2000,80.0,88276,711724
1000000,56,889999.0,2000,80.0,110001,889999
2,57,2.0,1,0.04,0,2
3,57,3.0,2,0.08,0,3
100,57,92.0,66,2.64,8,92
200,57,180.0,133,5.32,20,180
2000,57,1750.0,1333,53.32,250,1750
10000,57,8864.0,2000,80.0,1136,8864
20000,57,17722.0,2000,80.0,2278,17722
40000,57,35516.0,2000,80.0,4484,35516
60000,57,53367.0,2000,80.0,6633,53367
80000,57,71162.0,2000,80.0,8838,71162
100000,57,89016.0,2000,80.0,10984,89016
200000,57,178026.0,2000,80.0,21974,178026
400000,57,355800.0,2000,80.0,44200,355800
600000,57,533664.0,2000,80.0,66336,533664
800000,57,711645.0,2000,80.0,88355,711645
1000000,57,889515.0,2000,80.0,110485,889515
2,58,2.0,1,0.04,0,2
3,58,3.0,2,0.08,0,3
100,58,84.0,66,2.64,16,84
200,58,177.0,133,5.32,23,177
2000,58,1749.0,1333,53.32,251,1749
10000,58,8821.0,2000,80.0,1179,8821
20000,58,17698.0,2000,80.0,2302,17698
40000,58,35415.0,2000,80.0,4585,35415
60000,58,53240.0,2000,80.0,6760,53240
80000,58,71033.0,2000,80.0,8967,71033
100000,58,88834.0,2000,80.0,11166,88834
200000,58,177871.0,2000,80.0,22129,177871
400000,58,355877.0,2000,80.0,44123,355877
600000,58,534094.0,2000,80.0,65906,534094
800000,58,712078.0,2000,80.0,87922,712078
1000000,58,889966.0,2000,80.0,110034,889966
2,59,2.0,1,0.04,0,2
3,59,3.0,2,0.08,0,3
100,59,85.0,66,2.64,15,85
200,59,172.0,133,5.32,28,172
2000,59,1726.0,1333,53.32,274,1726
10000,59,8841.0,2000,80.0,1159,8841
20000,59,17712.0,2000,80.0,2288,17712
40000,59,35494.0,2000,80.0,4506,35494
60000,59,53273.0,2000,80.0,6727,53273
80000,59,71072.0,2000,80.0,8928,71072
100000,59,88868.0,2000,80.0,11132,88868
200000,59,177785.0,2000,80.0,22215,177785
400000,59,355751.0,2000,80.0,44249,355751
600000,59,533654.0,2000,80.0,66346,533654
800000,59,711569.0,2000,80.0,88431,711569
1000000,59,889620.0,2000,80.0,110380,889620
2,60,2.0,1,0.04,0,2
3,60,3.0,2,0.08,0,3
100,60,86.0,66,2.64,14,86
200,60,173.0,133,5.32,27,173
2000,60,1716.0,1333,53.32,284,1716
10000,60,8839.0,2000,80.0,1161,8839
20000,60,17754.0,2000,80.0,2246,17754
40000,60,35531.0,2000,80.0,4469,35531
60000,60,53392.0,2000,80.0,6608,53392
80000,60,71208.0,2000,80.0,8792,71208
100000,60,88984.0,2000,80.0,11016,88984
200000,60,177891.0,2000,80.0,22109,177891
400000,60,355981.0,2000,80.0,44019,355981
600000,60,533977.0,2000,80.0,66023,533977
800000,60,711918.0,2000,80.0,88082,711918
1000000,60,890002.0,2000,80.0,109998,890002
2,61,2.0,1,0.04,0,2
3,61,3.0,2,0.08,0,3
100,61,88.0,66,2.64,12,88
200,61,172.0,133,5.32,28,172
2000,61,1726.0,1333,53.32,274,1726
10000,61,8864.0,2000,80.0,1136,8864
20000,61,17780.0,2000,80.0,2220,17780
40000,61,35571.0,2000,80.0,4429,35571
60000,61,53354.0,2000,80.0,6646,53354
80000,61,71149.0,2000,80.0,8851,71149
100000,61,88884.0,2000,80.0,11116,88884
200000,61,177966.0,2000,80.0,22034,177966
400000,61,355900.0,2000,80.0,44100,355900
600000,61,534023.0,2000,80.0,65977,534023
800000,61,712140.0,2000,80.0,87860,712140
1000000,61,890054.0,2000,80.0,109946,890054
2,62,1.0,1,0.04,1,1
3,62,2.0,2,0.08,1,2
100,62,88.0,66,2.64,12,88
200,62,168.0,133,5.32,32,168
2000,62,1725.0,1333,53.32,275,1725
10000,62,8782.0,2000,80.0,1218,8782
20000,62,17652.0,2000,80.0,2348,17652
40000,62,35500.0,2000,80.0,4500,35500
60000,62,53237.0,2000,80.0,6763,53237
80000,62,71040.0,2000,80.0,8960,71040
100000,62,88829.0,2000,80.0,11171,88829
200000,62,177767.0,2000,80.0,22233,177767
400000,62,355614.0,2000,80.0,44386,355614
600000,62,533498.0,2000,80.0,66502,533498
800000,62,711347.0,2000,80.0,88653,711347
1000000,62,889364.0,2000,80.0,110636,889364
2,63,2.0,1,0.04,0,2
3,63,3.0,2,0.08,0,3
100,63,89.0,66,2.64,11,89
200,63,181.0,133,5.32,19,181
2000,63,1724.0,1333,53.32,276,1724
10000,63,8826.0,2000,80.0,1174,8826
20000,63,17715.0,2000,80.0,2285,17715
40000,63,35494.0,2000,80.0,4506,35494
60000,63,53234.0,2000,80.0,6766,53234
80000,63,71047.0,2000,80.0,8953,71047
100000,63,88883.0,2000,80.0,11117,88883
200000,63,177884.0,2000,80.0,22116,177884
400000,63,355954.0,2000,80.0,44046,355954
600000,63,533968.0,2000,80.0,66032,533968
800000,63,711900.0,2000,80.0,88100,711900
1000000,63,889849.0,2000,80.0,110151,889849
2,64,2.0,1,0.04,0,2
3,64,3.0,2,0.08,0,3
100,64,86.0,66,2.64,14,86
200,64,172.0,133,5.32,28,172
2000,64,1733.0,1333,53.32,267,1733
10000,64,8797.0,2000,80.0,1203,8797
20000,64,17713.0,2000,80.0,2287,17713
40000,64,35532.0,2000,80.0,4468,35532
60000,64,53348.0,2000,80.0,6652,53348
80000,64,71177.0,2000,80.0,8823,71177
100000,64,88959.0,2000,80.0,11041,88959
200000,64,178055.0,2000,80.0,21945,178055
400000,64,356183.0,2000,80.0,43817,356183
600000,64,534099.0,2000,80.0,65901,534099
800000,64,712205.0,2000,80.0,87795,712205
1000000,64,890214.0,2000,80.0,109786,890214
2,65,2.0,1,0.04,0,2
3,65,3.0,2,0.08,0,3
100,65,81.0,66,2.64,19,81
200,65,169.0,133,5.32,31,169
2000,65,1719.0,1333,53.32,281,1719
10000,65,8847.0,2000,80.0,1153,8847
20000,65,17747.0,2000,80.0,2253,17747
40000,65,35536.0,2000,80.0,4464,35536
60000,65,53276.0,2000,80.0,6724,53276
80000,65,71052.0,2000,80.0,8948,71052
100000,65,88912.0,2000,80.0,11088,88912
200000,65,177914.0,2000,80.0,22086,177914
400000,65,355852.0,2000,80.0,44148,355852
600000,65,533711.0,2000,80.0,66289,533711
800000,65,711750.0,2000,80.0,88250,711750
1000000,65,889585.0,2000,80.0,110415,889585
2,66,2.0,1,0.04,0,2
3,66,3.0,2,0.08,0,3
100,66,89.0,66,2.64,11,89
200,66,172.0,133,5.32,28,172
2000,66,1737.0,1333,53.32,263,1737
10000,66,8875.0,2000,80.0,1125,8875
20000,66,17765.0,2000,80.0,2235,17765
40000,66,35515.0,2000,80.0,4485,35515
60000,66,53227.0,2000,80.0,6773,53227
80000,66,70928.0,2000,80.0,9072,70928
100000,66,88728.0,2000,80.0,11272,88728
200000,66,177854.0,2000,80.0,22146,177854
400000,66,355676.0,2000,80.0,44324,355676
600000,66,533679.0,2000,80.0,66321,533679
800000,66,711989.0,2000,80.0,88011,711989
1000000,66,889913.0,2000,80.0,110087,889913
2,67,1.0,1,0.04,1,1
3,67,2.0,2,0.08,1,2
100,67,84.0,66,2.64,16,84
200,67,171.0,133,5.32,29,171
2000,67,1739.0,1333,53.32,261,1739
10000,67,8809.0,2000,80.0,1191,8809
20000,67,17702.0,2000,80.0,2298,17702
40000,67,35559.0,2000,80.0,4441,35559
60000,67,53406.0,2000,80.0,6594,53406
80000,67,71205.0,2000,80.0,8795,71205
100000,67,88964.0,2000,80.0,11036,88964
200000,67,177959.0,2000,80.0,22041,177959
400000,67,356030.0,2000,80.0,43970,356030
600000,67,533908.0,2000,80.0,66092,533908
800000,67,711805.0,2000,80.0,88195,711805
1000000,67,889920.0,2000,80.0,110080,889920
2,68,1.0,1,0.04,1,1
3,68,2.0,2,0.08,1,2
100,68,84.0,66,2.64,16,84
200,68,169.0,133,5.32,31,169
2000,68,1727.0,1333,53.32,273,1727
10000,68,8785.0,2000,80.0,1215,8785
20000,68,17680.0,2000,80.0,2320,17680
40000,68,35540.0,2000,80.0,4460,35540
60000,68,53393.0,2000,80.0,6607,53393
80000,68,71235.0,2000,80.0,8765,71235
100000,68,89074.0,2000,80.0,10926,89074
200000,68,177986.0,2000,80.0,22014,177986
400000,68,356246.0,2000,80.0,43754,356246
600000,68,533920.0,2000,80.0,66080,533920
800000,68,712120.0,2000,80.0,87880,712120
1000000,68,890252.0,2000,80.0,109748,890252
2,69,2.0,1,0.04,0,2
3,69,3.0,2,0.08,0,3
100,69,88.0,66,2.64,12,88
200,69,174.0,133,5.32,26,174
2000,69,1727.0,1333,53.32,273,1727
10000,69,8819.0,2000,80.0,1181,8819
20000,69,17784.0,2000,80.0,2216,17784
40000,69,35620.0,2000,80.0,4380,35620
60000,69,53390.0,2000,80.0,6610,53390
80000,69,71157.0,2000,80.0,8843,71157
100000,69,88969.0,2000,80.0,11031,88969
200000,69,177968.0,2000,80.0,22032,177968
400000,69,355877.0,2000,80.0,44123,355877
600000,69,533956.0,2000,80.0,66044,533956
800000,69,712116.0,2000,80.0,87884,712116
1000000,69,890202.0,2000,80.0,109798,890202
2,70,2.0,1,0.04,0,2
3,70,3.0,2,0.08,0,3
100,70,88.0,66,2.64,12,88
200,70,178.0,133,5.32,22,178
2000,70,1743.0,1333,53.32,257,1743
10000,70,8874.0,2000,80.0,1126,8874
20000,70,17742.0,2000,80.0,2258,17742
40000,70,35550.0,2000,80.0,4450,35550
60000,70,53342.0,2000,80.0,6658,53342
80000,70,71137.0,2000,80.0,8863,71137
100000,70,89014.0,2000,80.0,10986,89014
200000,70,178084.0,2000,80.0,21916,178084
400000,70,356166.0,2000,80.0,43834,356166
600000,70,534152.0,2000,80.0,65848,534152
800000,70,712252.0,2000,80.0,87748,712252
1000000,70,890319.0,2000,80.0,109681,890319
2,71,2.0,1,0.04,0,2
3,71,3.0,2,0.08,0,3
100,71,88.0,66,2.64,12,88
200,71,180.0,133,5.32,20,180
2000,71,1735.0,1333,53.32,265,1735
10000,71,8884.0,2000,80.0,1116,8884
20000,71,17787.0,2000,80.0,2213,17787
40000,71,35611.0,2000,80.0,4389,35611
60000,71,53425.0,2000,80.0,6575,53425
80000,71,71212.0,2000,80.0,8788,71212
100000,71,88972.0,2000,80.0,11028,88972
200000,71,177950.0,2000,80.0,22050,177950
400000,71,356037.0,2000,80.0,43963,356037
600000,71,534019.0,2000,80.0,65981,534019
800000,71,712160.0,2000,80.0,87840,712160
1000000,71,889880.0,2000,80.0,110120,889880
2,72,2.0,1,0.04,0,2
3,72,2.0,2,0.08,1,2
100,72,87.0,66,2.64,13,87
200,72,173.0,133,5.32,27,173
2000,72,1703.0,1333,53.32,297,1703
10000,72,8757.0,2000,80.0,1243,8757
20000,72,17630.0,2000,80.0,2370,17630
40000,72,35360.0,2000,80.0,4640,35360
60000,72,53136.0,2000,80.0,6864,53136
80000,72,70973.0,2000,80.0,9027,70973
100000,72,88748.0,2000,80.0,11252,88748
200000,72,177857.0,2000,80.0,22143,177857
400000,72,355987.0,2000,80.0,44013,355987
600000,72,534191.0,2000,80.0,65809,534191
800000,72,712256.0,2000,80.0,87744,712256
1000000,72,890312.0,2000,80.0,109688,890312
2,73,2.0,1,0.04,0,2
3,73,3.0,2,0.08,0,3
100,73,89.0,66,2.64,11,89
200,73,167.0,133,5.32,33,167
2000,73,1722.0,1333,53.32,278,1722
10000,73,8771.0,2000,80.0,1229,8771
20000,73,17652.0,2000,80.0,2348,17652
40000,73,35460.0,2000,80.0,4540,35460
60000,73,53348.0,2000,80.0,6652,53348
80000,73,71133.0,2000,80.0,8867,71133
100000,73,88946.0,2000,80.0,11054,88946
200000,73,177954.0,2000,80.0,22046,177954
400000,73,356006.0,2000,80.0,43994,356006
600000,73,533868.0,2000,80.0,66132,533868
800000,73,711937.0,2000,80.0,88063,711937
1000000,73,889952.0,2000,80.0,110048,889952
2,74,2.0,1,0.04,0,2
3,74,3.0,2,0.08,0,3
100,74,81.0,66,2.64,19,81
200,74,170.0,133,5.32,30,170
2000,74,1748.0,1333,53.32,252,1748
10000,74,8848.0,2000,80.0,1152,8848
20000,74,17746.0,2000,80.0,2254,17746
40000,74,35604.0,2000,80.0,4396,35604
60000,74,53366.0,2000,80.0,6634,53366
80000,74,71205.0,2000,80.0,8795,71205
100000,74,89011.0,2000,80.0,10989,89011
200000,74,178034.0,2000,80.0,21966,178034
400000,74,356128.0,2000,80.0,43872,356128
600000,74,534134.0,2000,80.0,65866,534134
800000,74,712162.0,2000,80.0,87838,712162
1000000,74,890181.0,2000,80.0,109819,890181
2,75,2.0,1,0.04,0,2
3,75,3.0,2,0.08,0,3
100,75,83.0,66,2.64,17,83
200,75,165.0,133,5.32,35,165
2000,75,1750.0,1333,53.32,250,1750
10000,75,8898.0,2000,80.0,1102,8898
20000,75,17778.0,2000,80.0,2222,17778
40000,75,35634.0,2000,80.0,4366,35634
60000,75,53489.0,2000,80.0,6511,53489
80000,75,71368.0,2000,80.0,8632,71368
100000,75,89154.0,2000,80.0,10846,89154
200000,75,178289.0,2000,80.0,21711,178289
400000,75,356293.0,2000,80.0,43707,356293
600000,75,534416.0,2000,80.0,65584,534416
800000,75,712479.0,2000,80.0,87521,712479
1000000,75,890451.0,2000,80.0,109549,890451
2,76,2.0,1,0.04,0,2
3,76,3.0,2,0.08,0,3
100,76,86.0,66,2.64,14,86
200,76,178.0,133,5.32,22,178
2000,76,1744.0,1333,53.32,256,1744
10000,76,8857.0,2000,80.0,1143,8857
20000,76,17769.0,2000,80.0,2231,17769
40000,76,35517.0,2000,80.0,4483,35517
60000,76,53345.0,2000,80.0,6655,53345
80000,76,71090.0,2000,80.0,8910,71090
100000,76,88947.0,2000,80.0,11053,88947
200000,76,178000.0,2000,80.0,22000,178000
400000,76,356071.0,2000,80.0,43929,356071
600000,76,533733.0,2000,80.0,66267,533733
800000,76,711648.0,2000,80.0,88352,711648
1000000,76,889747.0,2000,80.0,110253,889747
2,77,2.0,1,0.04,0,2
3,77,3.0,2,0.08,0,3
100,77,80.0,66,2.64,20,80
200,77,165.0,133,5.32,35,165
2000,77,1712.0,1333,53.32,288,1712
10000,77,8779.0,2000,80.0,1221,8779
20000,77,17702.0,2000,80.0,2298,17702
40000,77,35509.0,2000,80.0,4491,35509
60000,77,53338.0,2000,80.0,6662,53338
80000,77,71150.0,2000,80.0,8850,71150
100000,77,88838.0,2000,80.0,11162,88838
200000,77,177444.0,2000,80.0,22556,177444
400000,77,355578.0,2000,80.0,44422,355578
600000,77,533508.0,2000,80.0,66492,533508
800000,77,711549.0,2000,80.0,88451,711549
1000000,77,889415.0,2000,80.0,110585,889415
2,78,1.0,1,0.04,1,1
3,78,2.0,2,0.08,1,2
100,78,87.0,66,2.64,13,87
200,78,174.0,133,5.32,26,174
2000,78,1714.0,1333,53.32,286,1714
10000,78,8835.0,2000,80.0,1165,8835
20000,78,17757.0,2000,80.0,2243,17757
40000,78,35551.0,2000,80.0,4449,35551
60000,78,53343.0,2000,80.0,6657,53343
80000,78,71180.0,2000,80.0,8820,71180
100000,78,89026.0,2000,80.0,10974,89026
200000,78,178086.0,2000,80.0,21914,178086
400000,78,355888.0,2000,80.0,44112,355888
600000,78,533963.0,2000,80.0,66037,533963
800000,78,711830.0,2000,80.0,88170,711830
1000000,78,889917.0,2000,80.0,110083,889917
2,79,2.0,1,0.04,0,2
3,79,3.0,2,0.08,0,3
100,79,86.0,66,2.64,14,86
200,79,169.0,133,5.32,31,169
2000,79,1693.0,1333,53.32,307,1693
10000,79,8781.0,2000,80.0,1219,8781
20000,79,17697.0,2000,80.0,2303,17697
40000,79,35512.0,2000,80.0,4488,35512
60000,79,53312.0,2000,80.0,6688,53312
80000,79,71189.0,2000,80.0,8811,71189
100000,79,89032.0,2000,80.0,10968,89032
200000,79,177893.0,2000,80.0,22107,177893
400000,79,356069.0,2000,80.0,43931,356069
600000,79,534088.0,2000,80.0,65912,534088
800000,79,712071.0,2000,80.0,87929,712071
1000000,79,889765.0,2000,80.0,110235,889765
2,80,1.0,1,0.04,1,1
3,80,2.0,2,0.08,1,2
100,80,89.0,66,2.64,11,89
200,80,173.0,133,5.32,27,173
2000,80,1731.0,1333,53.32,269,1731
10000,80,8830.0,2000,80.0,1170,8830
20000,80,17659.0,2000,80.0,2341,17659
40000,80,35407.0,2000,80.0,4593,35407
60000,80,53148.0,2000,80.0,6852,53148
80000,80,70973.0,2000,80.0,9027,70973
100000,80,88781.0,2000,80.0,11219,88781
200000,80,177784.0,2000,80.0,22216,177784
400000,80,355711.0,2000,80.0,44289,355711
600000,80,533796.0,2000,80.0,66204,533796
800000,80,711891.0,2000,80.0,88109,711891
1000000,80,889828.0,2000,80.0,110172,889828
2,81,2.0,1,0.04,0,2
3,81,3.0,2,0.08,0,3
100,81,90.0,66,2.64,10,90
200,81,178.0,133,5.32,22,178
2000,81,1733.0,1333,53.32,267,1733
10000,81,8790.0,2000,80.0,1210,8790
20000,81,17661.0,2000,80.0,2339,17661
40000,81,35424.0,2000,80.0,4576,35424
60000,81,53235.0,2000,80.0,6765,53235
80000,81,71048.0,2000,80.0,8952,71048
100000,81,88883.0,2000,80.0,11117,88883
200000,81,177949.0,2000,80.0,22051,177949
400000,81,355959.0,2000,80.0,44041,355959
600000,81,533873.0,2000,80.0,66127,533873
800000,81,711938.0,2000,80.0,88062,711938
1000000,81,889941.0,2000,80.0,110059,889941
2,82,1.0,1,0.04,1,1
3,82,2.0,2,0.08,1,2
100,82,83.0,66,2.64,17,83
200,82,168.0,133,5.32,32,168
2000,82,1715.0,1333,53.32,285,1715
10000,82,8797.0,2000,80.0,1203,8797
20000,82,17670.0,2000,80.0,2330,17670
40000,82,35498.0,2000,80.0,4502,35498
60000,82,53286.0,2000,80.0,6714,53286
80000,82,71064.0,2000,80.0,8936,71064
100000,82,88806.0,2000,80.0,11194,88806
200000,82,177715.0,2000,80.0,22285,177715
400000,82,355641.0,2000,80.0,44359,355641
600000,82,533768.0,2000,80.0,66232,533768
800000,82,711560.0,2000,80.0,88440,711560
1000000,82,889363.0,2000,80.0,110637,889363
2,83,2.0,1,0.04,0,2
3,83,3.0,2,0.08,0,3
100,83,86.0,66,2.64,14,86
200,83,171.0,133,5.32,29,171
2000,83,1736.0,1333,53.32,264,1736
10000,83,8825.0,2000,80.0,1175,8825
20000,83,17726.0,2000,80.0,2274,17726
40000,83,35501.0,2000,80.0,4499,35501
60000,83,53283.0,2000,80.0,6717,53283
80000,83,71032.0,2000,80.0,8968,71032
100000,83,88937.0,2000,80.0,11063,88937
200000,83,177802.0,2000,80.0,22198,177802
400000,83,355741.0,2000,80.0,44259,355741
600000,83,533942.0,2000,80.0,66058,533942
800000,83,712106.0,2000,80.0,87894,712106
1000000,83,890412.0,2000,80.0,109588,890412
2,84,2.0,1,0.04,0,2
3,84,3.0,2,0.08,0,3
100,84,84.0,66,2.64,16,84
200,84,174.0,133,5.32,26,174
2000,84,1719.0,1333,53.32,281,1719
10000,84,8801.0,2000,80.0,1199,8801
20000,84,17683.0,2000,80.0,2317,17683
40000,84,35511.0,2000,80.0,4489,35511
60000,84,53285.0,2000,80.0,6715,53285
80000,84,71083.0,2000,80.0,8917,71083
100000,84,88868.0,2000,80.0,11132,88868
200000,84,177984.0,2000,80.0,22016,177984
400000,84,355802.0,2000,80.0,44198,355802
600000,84,533562.0,2000,80.0,66438,533562
800000,84,711669.0,2000,80.0,88331,711669
1000000,84,889684.0,2000,80.0,110316,889684
2,85,2.0,1,0.04,0,2
3,85,3.0,2,0.08,0,3
100,85,94.0,66,2.64,6,94
200,85,177.0,133,5.32,23,177
2000,85,1756.0,1333,53.32,244,1756
10000,85,8851.0,2000,80.0,1149,8851
20000,85,17794.0,2000,80.0,2206,17794
40000,85,35574.0,2000,80.0,4426,35574
60000,85,53444.0,2000,80.0,6556,53444
80000,85,71258.0,2000,80.0,8742,71258
100000,85,89127.0,2000,80.0,10873,89127
200000,85,178110.0,2000,80.0,21890,178110
400000,85,356465.0,2000,80.0,43535,356465
600000,85,534341.0,2000,80.0,65659,534341
800000,85,712367.0,2000,80.0,87633,712367
1000000,85,890346.0,2000,80.0,109654,890346
2,86,2.0,1,0.04,0,2
3,86,3.0,2,0.08,0,3
100,86,87.0,66,2.64,13,87
200,86,174.0,133,5.32,26,174
2000,86,1749.0,1333,53.32,251,1749
10000,86,8792.0,2000,80.0,1208,8792
20000,86,17748.0,2000,80.0,2252,17748
40000,86,35514.0,2000,80.0,4486,35514
60000,86,53323.0,2000,80.0,6677,53323
80000,86,71110.0,2000,80.0,8890,71110
100000,86,88943.0,2000,80.0,11057,88943
200000,86,177992.0,2000,80.0,22008,177992
400000,86,355970.0,2000,80.0,44030,355970
600000,86,533660.0,2000,80.0,66340,533660
800000,86,711447.0,2000,80.0,88553,711447
1000000,86,889559.0,2000,80.0,110441,889559
2,87,2.0,1,0.04,0,2
3,87,2.0,2,0.08,1,2
100,87,92.0,66,2.64,8,92
200,87,180.0,133,5.32,20,180
2000,87,1736.0,1333,53.32,264,1736
10000,87,8804.0,2000,80.0,1196,8804
20000,87,17743.0,2000,80.0,2257,17743
40000,87,35493.0,2000,80.0,4507,35493
60000,87,53270.0,2000,80.0,6730,53270
80000,87,71097.0,2000,80.0,8903,71097
100000,87,88920.0,2000,80.0,11080,88920
200000,87,178039.0,2000,80.0,21961,178039
400000,87,355891.0,2000,80.0,44109,355891
600000,87,533768.0,2000,80.0,66232,533768
800000,87,711838.0,2000,80.0,88162,711838
1000000,87,889784.0,2000,80.0,110216,889784
2,88,2.0,1,0.04,0,2
3,88,3.0,2,0.08,0,3
100,88,95.0,66,2.64,5,95
200,88,187.0,133,5.32,13,187
2000,88,1747.0,1333,53.32,253,1747
10000,88,8808.0,2000,80.0,1192,8808
20000,88,17766.0,2000,80.0,2234,17766
40000,88,35602.0,2000,80.0,4398,35602
60000,88,53369.0,2000,80.0,6631,53369
80000,88,71151.0,2000,80.0,8849,71151
100000,88,88944.0,2000,80.0,11056,88944
200000,88,177938.0,2000,80.0,22062,177938
400000,88,355906.0,2000,80.0,44094,355906
600000,88,534007.0,2000,80.0,65993,534007
800000,88,711855.0,2000,80.0,88145,711855
1000000,88,889799.0,2000,80.0,110201,889799
2,89,2.0,1,0.04,0,2
3,89,3.0,2,0.08,0,3
100,89,88.0,66,2.64,12,88
200,89,178.0,133,5.32,22,178
2000,89,1728.0,1333,53.32,272,1728
10000,89,8858.0,2000,80.0,1142,8858
20000,89,17709.0,2000,80.0,2291,17709
40000,89,35529.0,2000,80.0,4471,35529
60000,89,53357.0,2000,80.0,6643,53357
80000,89,71179.0,2000,80.0,8821,71179
100000,89,88835.0,2000,80.0,11165,88835
200000,89,177793.0,2000,80.0,22207,177793
400000,89,355449.0,2000,80.0,44551,355449
600000,89,533370.0,2000,80.0,66630,533370
800000,89,711293.0,2000,80.0,88707,711293
1000000,89,889532.0,2000,80.0,110468,889532
2,90,2.0,1,0.04,0,2
3,90,3.0,2,0.08,0,3
100,90,84.0,66,2.64,16,84
200,90,173.0,133,5.32,27,173
2000,90,1729.0,1333,53.32,271,1729
10000,90,8821.0,2000,80.0,1179,8821
20000,90,17736.0,2000,80.0,2264,17736
40000,90,35531.0,2000,80.0,4469,35531
60000,90,53347.0,2000,80.0,6653,53347
80000,90,71118.0,2000,80.0,8882,71118
100000,90,88935.0,2000,80.0,11065,88935
200000,90,177835.0,2000,80.0,22165,177835
400000,90,355836.0,2000,80.0,44164,355836
600000,90,533685.0,2000,80.0,66315,533685
800000,90,711507.0,2000,80.0,88493,711507
1000000,90,889590.0,2000,80.0,110410,889590
2,91,2.0,1,0.04,0,2
3,91,3.0,2,0.08,0,3
100,91,89.0,66,2.64,11,89
200,91,179.0,133,5.32,21,179
2000,91,1736.0,1333,53.32,264,1736
10000,91,8803.0,2000,80.0,1197,8803
20000,91,17729.0,2000,80.0,2271,17729
40000,91,35518.0,2000,80.0,4482,35518
60000,91,53302.0,2000,80.0,6698,53302
80000,91,71107.0,2000,80.0,8893,71107
100000,91,88972.0,2000,80.0,11028,88972
200000,91,178146.0,2000,80.0,21854,178146
400000,91,356127.0,2000,80.0,43873,356127
600000,91,533862.0,2000,80.0,66138,533862
800000,91,711936.0,2000,80.0,88064,711936
1000000,91,889681.0,2000,80.0,110319,889681
2,92,2.0,1,0.04,0,2
3,92,3.0,2,0.08,0,3
100,92,87.0,66,2.64,13,87
200,92,174.0,133,5.32,26,174
2000,92,1743.0,1333,53.32,257,1743
10000,92,8872.0,2000,80.0,1128,8872
20000,92,17833.0,2000,80.0,2167,17833
40000,92,35564.0,2000,80.0,4436,35564
60000,92,53321.0,2000,80.0,6679,53321
80000,92,71085.0,2000,80.0,8915,71085
100000,92,88815.0,2000,80.0,11185,88815
200000,92,177776.0,2000,80.0,22224,177776
400000,92,355858.0,2000,80.0,44142,355858
600000,92,533986.0,2000,80.0,66014,533986
800000,92,712059.0,2000,80.0,87941,712059
1000000,92,890100.0,2000,80.0,109900,890100
2,93,2.0,1,0.04,0,2
3,93,3.0,2,0.08,0,3
100,93,89.0,66,2.64,11,89
200,93,176.0,133,5.32,24,176
2000,93,1714.0,1333,53.32,286,1714
10000,93,8806.0,2000,80.0,1194,8806
20000,93,17718.0,2000,80.0,2282,17718
40000,93,35456.0,2000,80.0,4544,35456
60000,93,53230.0,2000,80.0,6770,53230
80000,93,71042.0,2000,80.0,8958,71042
100000,93,88913.0,2000,80.0,11087,88913
200000,93,177932.0,2000,80.0,22068,177932
400000,93,355955.0,2000,80.0,44045,355955
600000,93,534014.0,2000,80.0,65986,534014
800000,93,711925.0,2000,80.0,88075,711925
1000000,93,889982.0,2000,80.0,110018,889982
2,94,1.0,1,0.04,1,1
3,94,1.0,2,0.08,2,1
100,94,85.0,66,2.64,15,85
200,94,169.0,133,5.32,31,169
2000,94,1727.0,1333,53.32,273,1727
10000,94,8805.0,2000,80.0,1195,8805
20000,94,17749.0,2000,80.0,2251,17749
40000,94,35561.0,2000,80.0,4439,35561
60000,94,53383.0,2000,80.0,6617,53383
80000,94,71180.0,2000,80.0,8820,71180
100000,94,88942.0,2000,80.0,11058,88942
200000,94,177970.0,2000,80.0,22030,177970
400000,94,355905.0,2000,80.0,44095,355905
600000,94,534156.0,2000,80.0,65844,534156
800000,94,712298.0,2000,80.0,87702,712298
1000000,94,890318.0,2000,80.0,109682,890318
2,95,1.0,1,0.04,1,1
3,95,1.0,2,0.08,2,1
100,95,81.0,66,2.64,19,81
200,95,174.0,133,5.32,26,174
2000,95,1731.0,1333,53.32,269,1731
10000,95,8824.0,2000,80.0,1176,8824
20000,95,17726.0,2000,80.0,2274,17726
40000,95,35560.0,2000,80.0,4440,35560
60000,95,53274.0,2000,80.0,6726,53274
80000,95,71059.0,2000,80.0,8941,71059
100000,95,88900.0,2000,80.0,11100,88900
200000,95,177749.0,2000,80.0,22251,177749
400000,95,355594.0,2000,80.0,44406,355594
600000,95,533630.0,2000,80.0,66370,533630
800000,95,711708.0,2000,80.0,88292,711708
1000000,95,889719.0,2000,80.0,110281,889719
2,96,1.0,1,0.04,1,1
3,96,2.0,2,0.08,1,2
100,96,91.0,66,2.64,9,91
200,96,178.0,133,5.32,22,178
2000,96,1735.0,1333,53.32,265,1735
10000,96,8777.0,2000,80.0,1223,8777
20000,96,17690.0,2000,80.0,2310,17690
40000,96,35444.0,2000,80.0,4556,35444
60000,96,53203.0,2000,80.0,6797,53203
80000,96,70935.0,2000,80.0,9065,70935
100000,96,88719.0,2000,80.0,11281,88719
200000,96,177883.0,2000,80.0,22117,177883
400000,96,356069.0,2000,80.0,43931,356069
600000,96,533997.0,2000,80.0,66003,533997
800000,96,711844.0,2000,80.0,88156,711844
1000000,96,889604.0,2000,80.0,110396,889604
2,97,1.0,1,0.04,1,1
3,97,2.0,2,0.08,1,2
100,97,86.0,66,2.64,14,86
200,97,175.0,133,5.32,25,175
2000,97,1744.0,1333,53.32,256,1744
10000,97,8857.0,2000,80.0,1143,8857
20000,97,17766.0,2000,80.0,2234,17766
40000,97,35607.0,2000,80.0,4393,35607
60000,97,53420.0,2000,80.0,6580,53420
80000,97,71218.0,2000,80.0,8782,71218
100000,97,88955.0,2000,80.0,11045,88955
200000,97,178060.0,2000,80.0,21940,178060
400000,97,356015.0,2000,80.0,43985,356015
600000,97,533855.0,2000,80.0,66145,533855
800000,97,711961.0,2000,80.0,88039,711961
1000000,97,890020.0,2000,80.0,109980,890020
2,98,2.0,1,0.04,0,2
3,98,3.0,2,0.08,0,3
100,98,86.0,66,2.64,14,86
200,98,170.0,133,5.32,30,170
2000,98,1728.0,1333,53.32,272,1728
10000,98,8801.0,2000,80.0,1199,8801
20000,98,17712.0,2000,80.0,2288,17712
40000,98,35471.0,2000,80.0,4529,35471
60000,98,53218.0,2000,80.0,6782,53218
80000,98,71065.0,2000,80.0,8935,71065
100000,98,88861.0,2000,80.0,11139,88861
200000,98,177874.0,2000,80.0,22126,177874
400000,98,355580.0,2000,80.0,44420,355580
600000,98,533544.0,2000,80.0,66456,533544
800000,98,711469.0,2000,80.0,88531,711469
1000000,98,889611.0,2000,80.0,110389,889611
2,99,2.0,1,0.04,0,2
3,99,3.0,2,0.08,0,3
100,99,90.0,66,2.64,10,90
200,99,175.0,133,5.32,25,175
2000,99,1722.0,1333,53.32,278,1722
10000,99,8795.0,2000,80.0,1205,8795
20000,99,17759.0,2000,80.0,2241,17759
40000,99,35616.0,2000,80.0,4384,35616
60000,99,53403.0,2000,80.0,6597,53403
80000,99,71286.0,2000,80.0,8714,71286
100000,99,89047.0,2000,80.0,10953,89047
200000,99,177946.0,2000,80.0,22054,177946
400000,99,355970.0,2000,80.0,44030,355970
600000,99,533896.0,2000,80.0,66104,533896
800000,99,711762.0,2000,80.0,88238,711762
1000000,99,889684.0,2000,80.0,110316,889684
2,100,2.0,1,0.04,0,2
3,100,2.0,2,0.08,1,2
100,100,88.0,66,2.64,12,88
200,100,171.0,133,5.32,29,171
2000,100,1721.0,1333,53.32,279,1721
10000,100,8796.0,2000,80.0,1204,8796
20000,100,17695.0,2000,80.0,2305,17695
40000,100,35495.0,2000,80.0,4505,35495
60000,100,53293.0,2000,80.0,6707,53293
80000,100,71111.0,2000,80.0,8889,71111
100000,100,88953.0,2000,80.0,11047,88953
200000,100,177923.0,2000,80.0,22077,177923
400000,100,355813.0,2000,80.0,44187,355813
600000,100,533950.0,2000,80.0,66050,533950
800000,100,711898.0,2000,80.0,88102,711898
1000000,100,890217.0,2000,80.0,109783,890217
